date,company,positive,neutral,negative,total,neg_pct
2025-09-27,3M,32,60,8,100,0.080000
2025-09-27,A O Smith,23,76,1,100,0.010000
2025-09-27,A-Mark Precious Metals,89,11,0,100,0.000000
2025-09-27,ABM Industries,27,52,21,100,0.210000
2025-09-27,ADT,34,45,21,100,0.210000
2025-09-27,AECOM,43,47,10,100,0.100000
2025-09-27,AES,38,48,14,100,0.140000
2025-09-27,AGCO,36,57,7,100,0.070000
2025-09-27,AGNC Investment,30,51,19,100,0.190000
2025-09-27,AIG,28,61,11,100,0.110000
2025-09-27,AMC Entertainment,82,13,5,100,0.050000
2025-09-27,AMC Networks,27,55,18,100,0.180000
2025-09-27,AMN Healthcare Services,20,59,21,100,0.210000
2025-09-27,APA,35,49,16,100,0.160000
2025-09-27,APi Group,35,54,11,100,0.110000
2025-09-27,ARKO,27,65,8,100,0.080000
2025-09-27,ASGN,27,59,14,100,0.140000
2025-09-27,AT&T,28,52,16,96,0.166667
2025-09-27,ATI Inc,34,62,4,100,0.040000
2025-09-27,AbbVie,47,40,13,100,0.130000
2025-09-27,Abbott Laboratories,53,41,6,100,0.060000
2025-09-27,Abercrombie & Fitch,34,62,4,100,0.040000
2025-09-27,Academy Sports and Outdoors,29,62,9,100,0.090000
2025-09-27,Acadia Healthcare,17,65,18,100,0.180000
2025-09-27,Ace Hardware,27,60,13,100,0.130000
2025-09-27,Acuity Inc,35,35,8,78,0.102564
2025-09-27,Adams Resources & Energy,16,4,1,21,0.047619
2025-09-27,AdaptHealth,33,54,13,100,0.130000
2025-09-27,Adobe,45,43,6,94,0.063830
2025-09-27,Advance Auto Parts,22,57,21,100,0.210000
2025-09-27,Advanced Drainage Systems,82,12,6,100,0.060000
2025-09-27,Advanced Micro Devices,84,8,12,104,0.115385
2025-09-27,Advantage Solutions,76,18,6,100,0.060000
2025-09-27,Aflac,39,35,26,100,0.260000
2025-09-27,Agilent Technologies,32,61,7,100,0.070000
2025-09-27,Agilon Health,27,55,18,100,0.180000
2025-09-27,Air Lease,29,63,8,100,0.080000
2025-09-27,Air Products & Chemicals,25,64,11,100,0.110000
2025-09-27,Airbnb,29,58,13,100,0.130000
2025-09-27,Akamai Technologies,44,44,12,100,0.120000
2025-09-27,Alaska Air,32,65,3,100,0.030000
2025-09-27,Albemarle Corporation,30,57,13,100,0.130000
2025-09-27,Albertsons,37,48,15,100,0.150000
2025-09-27,Alcoa Corporation,23,59,18,100,0.180000
2025-09-27,Alexandria Real Estate Equities,41,52,7,100,0.070000
2025-09-27,Alight Solutions,26,64,10,100,0.100000
2025-09-27,Align Technology,15,59,26,100,0.260000
2025-09-27,Allegiant Travel Company,22,69,9,100,0.090000
2025-09-27,Alliance Resource Partners,33,47,20,100,0.200000
2025-09-27,Alliant Energy,80,14,6,100,0.060000
2025-09-27,Allison Transmission,28,56,16,100,0.160000
2025-09-27,Allstate,60,29,11,100,0.110000
2025-09-27,Ally Financial,38,56,6,100,0.060000
2025-09-27,Alpha Metallurgical Resources,36,48,16,100,0.160000
2025-09-27,Alphabet,30,49,21,100,0.210000
2025-09-27,Altice USA,32,50,18,100,0.180000
2025-09-27,Altria,50,42,8,100,0.080000
2025-09-27,Amazon,27,62,15,104,0.144231
2025-09-27,Ameren,37,44,19,100,0.190000
2025-09-27,American Airlines,14,28,60,102,0.588235
2025-09-27,American Axle & Manufacturing,32,55,13,100,0.130000
2025-09-27,American Eagle Outfitters,34,53,13,100,0.130000
2025-09-27,American Electric Power,39,53,8,100,0.080000
2025-09-27,American Express,44,43,5,92,0.054348
2025-09-27,American Family Insurance,48,41,11,100,0.110000
2025-09-27,American Financial Group,27,58,15,100,0.150000
2025-09-27,American Tower,48,42,10,100,0.100000
2025-09-27,American Water Works,45,49,6,100,0.060000
2025-09-27,Americold Realty Trust,72,23,5,100,0.050000
2025-09-27,Ameriprise Financial,48,42,10,100,0.100000
2025-09-27,Ametek,30,61,9,100,0.090000
2025-09-27,Amgen,29,58,13,100,0.130000
2025-09-27,Amica Mutual Insurance,24,66,6,96,0.062500
2025-09-27,Amkor Technology,35,58,7,100,0.070000
2025-09-27,Amphenol,29,67,4,100,0.040000
2025-09-27,Analog Devices,39,53,8,100,0.080000
2025-09-27,Antero Resources,39,53,8,100,0.080000
2025-09-27,Anywhere Real Estate Inc,36,60,4,100,0.040000
2025-09-27,Apollo Global Management,33,61,6,100,0.060000
2025-09-27,AppLovin,32,59,9,100,0.090000
2025-09-27,Apple,43,52,15,110,0.136364
2025-09-27,Applied Industrial Technologies,30,66,4,100,0.040000
2025-09-27,Applied Materials,22,52,26,100,0.260000
2025-09-27,AptarGroup,30,63,7,100,0.070000
2025-09-27,Aramark,45,47,8,100,0.080000
2025-09-27,ArcBest,26,63,11,100,0.110000
2025-09-27,Arch Resources,62,26,12,100,0.120000
2025-09-27,Archer Daniels Midland,42,45,13,100,0.130000
2025-09-27,Ares Management,35,62,3,100,0.030000
2025-09-27,Arista Networks,33,57,10,100,0.100000
2025-09-27,Arrow Electronics,24,67,9,100,0.090000
2025-09-27,Arthur J Gallagher,36,60,4,100,0.040000
2025-09-27,Asbury Automotive Group,28,60,12,100,0.120000
2025-09-27,Assurant,40,49,11,100,0.110000
2025-09-27,Atkore,26,57,17,100,0.170000
2025-09-27,Atlassian,24,54,22,100,0.220000
2025-09-27,Atmos Energy,88,10,2,100,0.020000
2025-09-27,Auto-Owners Insurance,31,59,10,100,0.100000
2025-09-27,AutoNation,27,58,15,100,0.150000
2025-09-27,AutoZone,26,53,21,100,0.210000
2025-09-27,Autodesk,27,72,1,100,0.010000
2025-09-27,Autoliv,47,46,7,100,0.070000
2025-09-27,Automatic Data Processing,39,54,7,100,0.070000
2025-09-27,AvalonBay Communities,34,60,6,100,0.060000
2025-09-27,Avantor,30,51,19,100,0.190000
2025-09-27,Avery Dennison,23,70,7,100,0.070000
2025-09-27,Avient,28,62,10,100,0.100000
2025-09-27,Avis Budget,19,61,20,100,0.200000
2025-09-27,Avnet,20,70,10,100,0.100000
2025-09-27,BJ's Wholesale Club,30,56,14,100,0.140000
2025-09-27,BOK Financial,39,51,10,100,0.100000
2025-09-27,BWX Technologies,43,53,4,100,0.040000
2025-09-27,Baker Hughes,44,48,8,100,0.080000
2025-09-27,Ball Corporation,30,66,4,100,0.040000
2025-09-27,Bank of America,39,52,9,100,0.090000
2025-09-27,Bank of New York Mellon,48,47,5,100,0.050000
2025-09-27,Bath & Body Works,36,49,15,100,0.150000
2025-09-27,Baxter International,24,58,18,100,0.180000
2025-09-27,Becton Dickinson,45,48,7,100,0.070000
2025-09-27,Belden,31,57,12,100,0.120000
2025-09-27,Benchmark Electronics,22,69,9,100,0.090000
2025-09-27,Berkshire Hathaway,27,48,25,100,0.250000
2025-09-27,Berry Global,22,62,16,100,0.160000
2025-09-27,Best Buy,90,8,2,100,0.020000
2025-09-27,Bio-Rad Laboratories,22,65,13,100,0.130000
2025-09-27,Biogen,30,63,7,100,0.070000
2025-09-27,BlackRock,37,47,16,100,0.160000
2025-09-27,Blackstone,35,52,13,100,0.130000
2025-09-27,Bloomin Brands,12,69,19,100,0.190000
2025-09-27,BlueLinx,24,67,9,100,0.090000
2025-09-27,Boeing,29,59,15,103,0.145631
2025-09-27,Boise Cascade,15,50,35,100,0.350000
2025-09-27,Booking Holdings,35,52,13,100,0.130000
2025-09-27,Booz Allen Hamilton,26,54,20,100,0.200000
2025-09-27,BorgWarner,55,39,6,100,0.060000
2025-09-27,Boston Properties,21,71,8,100,0.080000
2025-09-27,Boston Scientific,42,51,7,100,0.070000
2025-09-27,Boyd Gaming,24,54,22,100,0.220000
2025-09-27,Bread Financial,46,50,4,100,0.040000
2025-09-27,BrightSpring Health Services,29,60,11,100,0.110000
2025-09-27,BrightView Holdings,25,65,10,100,0.100000
2025-09-27,Brighthouse Financial,35,58,7,100,0.070000
2025-09-27,Brinker International,45,49,6,100,0.060000
2025-09-27,Brinks Company,13,4,6,23,0.260870
2025-09-27,Bristol-Myers Squibb,27,55,18,100,0.180000
2025-09-27,Broadcom,34,56,10,100,0.100000
2025-09-27,Broadridge Financial Solutions,59,40,1,100,0.010000
2025-09-27,Brookdale Senior Living,31,53,16,100,0.160000
2025-09-27,Brown & Brown,29,56,15,100,0.150000
2025-09-27,Brown-Forman,18,64,18,100,0.180000
2025-09-27,Bruker,25,53,22,100,0.220000
2025-09-27,Brunswick Corporation,44,42,14,100,0.140000
2025-09-27,Builders FirstSource,35,57,8,100,0.080000
2025-09-27,Burlington Stores,28,65,7,100,0.070000
2025-09-27,CACI International,53,40,7,100,0.070000
2025-09-27,CBRE Group,31,67,2,100,0.020000
2025-09-27,CDW,37,57,6,100,0.060000
2025-09-27,CF Industries,32,60,8,100,0.080000
2025-09-27,CH Robinson Worldwide,36,53,11,100,0.110000
2025-09-27,CHS,39,51,10,100,0.100000
2025-09-27,CIncinnati Financial,37,54,9,100,0.090000
2025-09-27,CME Group,28,65,7,100,0.070000
2025-09-27,CMS Energy,86,9,5,100,0.050000
2025-09-27,CNO Financial Group,31,64,5,100,0.050000
2025-09-27,CNX Resources,39,55,6,100,0.060000
2025-09-27,CSX,32,55,13,100,0.130000
2025-09-27,CVS Health,44,45,11,100,0.110000
2025-09-27,Cabot Corporation,34,60,6,100,0.060000
2025-09-27,Cadence,28,58,14,100,0.140000
2025-09-27,Caesars Entertainment,76,19,5,100,0.050000
2025-09-27,Cal-Maine Foods,54,41,5,100,0.050000
2025-09-27,Caleres Inc,29,58,13,100,0.130000
2025-09-27,California Resources,45,48,7,100,0.070000
2025-09-27,Calumet Inc,31,43,14,88,0.159091
2025-09-27,Campbell Soup,34,51,15,100,0.150000
2025-09-27,Camping World,23,62,15,100,0.150000
2025-09-27,Capital One,33,48,19,100,0.190000
2025-09-27,CarMax,11,41,46,98,0.469388
2025-09-27,Cardinal Health,37,51,12,100,0.120000
2025-09-27,Carlisle Companies,33,55,12,100,0.120000
2025-09-27,Carlyle Group,33,61,6,100,0.060000
2025-09-27,Carpenter Technology,32,61,7,100,0.070000
2025-09-27,Carrier Global,35,48,17,100,0.170000
2025-09-27,Carters Inc,16,25,3,44,0.068182
2025-09-27,Carvana,33,56,11,100,0.110000
2025-09-27,Caseys General Stores,32,57,11,100,0.110000
2025-09-27,Catalent,21,65,14,100,0.140000
2025-09-27,Caterpillar,24,64,12,100,0.120000
2025-09-27,Cboe Global Markets,35,60,5,100,0.050000
2025-09-27,Celanese,24,43,33,100,0.330000
2025-09-27,Cencora,55,40,5,100,0.050000
2025-09-27,Centene,31,37,32,100,0.320000
2025-09-27,CenterPoint Energy,73,15,12,100,0.120000
2025-09-27,Central Garden & Pet,23,71,6,100,0.060000
2025-09-27,Century Communities,32,62,6,100,0.060000
2025-09-27,ChampionX,37,61,2,100,0.020000
2025-09-27,Charles River Laboratories International,22,63,15,100,0.150000
2025-09-27,Charles Schwab,40,52,8,100,0.080000
2025-09-27,Chart Industries,34,57,9,100,0.090000
2025-09-27,Charter Communications,28,44,28,100,0.280000
2025-09-27,Cheesecake Factory,27,56,17,100,0.170000
2025-09-27,Chefs Warehouse,38,54,8,100,0.080000
2025-09-27,Chemours,35,44,21,100,0.210000
2025-09-27,Cheniere Energy,90,9,1,100,0.010000
2025-09-27,Chevron,32,44,24,100,0.240000
2025-09-27,Chewy,39,48,13,100,0.130000
2025-09-27,Chipotle Mexican Grill,29,62,9,100,0.090000
2025-09-27,Chord Energy,92,3,5,100,0.050000
2025-09-27,Church & Dwight,29,61,10,100,0.100000
2025-09-27,Ciena,43,52,5,100,0.050000
2025-09-27,Cigna,40,47,13,100,0.130000
2025-09-27,Cinemark,25,60,15,100,0.150000
2025-09-27,Cintas,39,51,10,100,0.100000
2025-09-27,Cisco Systems,27,59,14,100,0.140000
2025-09-27,Citigroup,25,60,17,102,0.166667
2025-09-27,Citizens Financial Group,36,59,5,100,0.050000
2025-09-27,Civitas Resources,28,43,29,100,0.290000
2025-09-27,Clean Harbors,74,12,14,100,0.140000
2025-09-27,Clear Channel Outdoor Hldgs,8,2,0,10,0.000000
2025-09-27,Cleveland-Cliffs,22,54,24,100,0.240000
2025-09-27,Clorox,29,53,18,100,0.180000
2025-09-27,Cognizant Technology Solutions,38,51,11,100,0.110000
2025-09-27,Coherent,34,58,8,100,0.080000
2025-09-27,Coinbase Global,17,66,17,100,0.170000
2025-09-27,Colgate-Palmolive,43,43,14,100,0.140000
2025-09-27,Columbia Banking System,32,64,4,100,0.040000
2025-09-27,Columbia Sportswear,26,50,24,100,0.240000
2025-09-27,Comcast,30,46,24,100,0.240000
2025-09-27,Comerica,44,44,12,100,0.120000
2025-09-27,Comfort Systems USA,94,5,1,100,0.010000
2025-09-27,CommScope,21,77,2,100,0.020000
2025-09-27,Commercial Metals,32,53,15,100,0.150000
2025-09-27,Community Health Systems,26,53,21,100,0.210000
2025-09-27,Compass Group,29,49,22,100,0.220000
2025-09-27,Conagra Brands,33,51,16,100,0.160000
2025-09-27,Concentrix,24,55,21,100,0.210000
2025-09-27,Conduent,29,49,22,100,0.220000
2025-09-27,ConocoPhillips,44,42,14,100,0.140000
2025-09-27,Consol Energy,76,17,7,100,0.070000
2025-09-27,Consolidated Edison,36,52,12,100,0.120000
2025-09-27,Constellation Brands,16,48,36,100,0.360000
2025-09-27,Constellation Energy,79,14,7,100,0.070000
2025-09-27,Continental Resources,33,52,15,100,0.150000
2025-09-27,Cooper Cos,3,20,6,29,0.206897
2025-09-27,Cooper-Standard,28,66,6,100,0.060000
2025-09-27,Copart,46,41,13,100,0.130000
2025-09-27,Core & Main,27,54,19,100,0.190000
2025-09-27,Corebridge Financial,36,53,11,100,0.110000
2025-09-27,Cornerstone Building Brands,25,62,13,100,0.130000
2025-09-27,Corning,37,51,12,100,0.120000
2025-09-27,Corpay,25,72,2,99,0.020202
2025-09-27,Corteva,31,58,11,100,0.110000
2025-09-27,Costco,30,54,16,100,0.160000
2025-09-27,Coterra Energy,79,14,7,100,0.070000
2025-09-27,Coty,26,51,23,100,0.230000
2025-09-27,Country Financial,26,57,17,100,0.170000
2025-09-27,Coupang,34,56,10,100,0.100000
2025-09-27,Cracker Barrel Old Country Store,16,63,21,100,0.210000
2025-09-27,Crocs,31,59,10,100,0.100000
2025-09-27,CrossAmerica Partners,23,73,4,100,0.040000
2025-09-27,CrowdStrike,36,45,19,100,0.190000
2025-09-27,Crown Castle,40,54,6,100,0.060000
2025-09-27,Crown Holdings,32,62,6,100,0.060000
2025-09-27,Cullen Frost Bankers,43,51,6,100,0.060000
2025-09-27,Cummins Inc,57,39,4,100,0.040000
2025-09-27,Curtiss-Wright,45,52,3,100,0.030000
2025-09-27,DR Horton,24,65,11,100,0.110000
2025-09-27,DTE Energy,71,17,12,100,0.120000
2025-09-27,DXC Technology,29,67,4,100,0.040000
2025-09-27,DaVita,30,46,24,100,0.240000
2025-09-27,Dana Incorporated,35,55,10,100,0.100000
2025-09-27,Danaher,53,39,8,100,0.080000
2025-09-27,Darden Restaurants,34,44,22,100,0.220000
2025-09-27,Darling Ingredients,89,7,4,100,0.040000
2025-09-27,Deckers Outdoor,33,50,17,100,0.170000
2025-09-27,Deere,29,54,17,100,0.170000
2025-09-27,Delek US,41,46,13,100,0.130000
2025-09-27,Dell Technologies,41,54,5,100,0.050000
2025-09-27,Delta Air Lines,18,53,29,100,0.290000
2025-09-27,Dentsply Sirona,29,65,6,100,0.060000
2025-09-27,Designer Brands,16,66,18,100,0.180000
2025-09-27,Devon Energy,91,4,5,100,0.050000
2025-09-27,DexCom,17,67,16,100,0.160000
2025-09-27,Diamondback Energy,86,7,7,100,0.070000
2025-09-27,Dicks Sporting Goods,28,65,7,100,0.070000
2025-09-27,Diebold Nixdorf,33,63,4,100,0.040000
2025-09-27,Digital Realty Trust,82,18,0,100,0.000000
2025-09-27,Dillards,26,56,18,100,0.180000
2025-09-27,Discover Financial,32,52,16,100,0.160000
2025-09-27,DocuSign,41,44,15,100,0.150000
2025-09-27,Dollar General,22,53,25,100,0.250000
2025-09-27,Dollar Tree,35,50,15,100,0.150000
2025-09-27,Dominion Energy,65,26,9,100,0.090000
2025-09-27,Dominos Pizza Inc,16,24,8,48,0.166667
2025-09-27,Domtar,28,63,9,100,0.090000
2025-09-27,Donaldson Company,42,50,8,100,0.080000
2025-09-27,DoorDash,40,43,17,100,0.170000
2025-09-27,Dover Corporation,48,51,1,100,0.010000
2025-09-27,DraftKings,56,40,4,100,0.040000
2025-09-27,Dream Finders Homes,83,12,5,100,0.050000
2025-09-27,Dropbox,32,63,5,100,0.050000
2025-09-27,DuPont,27,62,11,100,0.110000
2025-09-27,Duke Energy,77,12,11,100,0.110000
2025-09-27,Dycom Industries,33,60,7,100,0.070000
2025-09-27,EMCOR Group,30,65,5,100,0.050000
2025-09-27,EOG Resources,43,46,11,100,0.110000
2025-09-27,EPAM Systems,33,59,8,100,0.080000
2025-09-27,EQT,35,57,8,100,0.080000
2025-09-27,ESAB,35,51,14,100,0.140000
2025-09-27,East West Bancorp,39,55,6,100,0.060000
2025-09-27,Eastman Chemical,22,48,30,100,0.300000
2025-09-27,Ebay,28,64,8,100,0.080000
2025-09-27,EchoStar,18,70,12,100,0.120000
2025-09-27,Ecolab,46,50,4,100,0.040000
2025-09-27,Edison International,24,53,23,100,0.230000
2025-09-27,Edward Jones,37,55,8,100,0.080000
2025-09-27,Edwards Lifesciences,43,35,22,100,0.220000
2025-09-27,Elanco Animal Health,38,57,5,100,0.050000
2025-09-27,Electronic Arts,15,71,6,92,0.065217
2025-09-27,Elevance Health,42,38,20,100,0.200000
2025-09-27,Eli Lilly,17,63,20,100,0.200000
2025-09-27,Emerson Electric,46,48,6,100,0.060000
2025-09-27,EnLink Midstream,42,51,7,100,0.070000
2025-09-27,Encompass Health,27,64,9,100,0.090000
2025-09-27,Endeavor Group,15,72,13,100,0.130000
2025-09-27,Endeavor Group Holdings,20,70,10,100,0.100000
2025-09-27,EnerSys,38,51,11,100,0.110000
2025-09-27,Energizer Holdings,86,11,3,100,0.030000
2025-09-27,Energy Transfer,81,10,9,100,0.090000
2025-09-27,Ensign Group,40,55,5,100,0.050000
2025-09-27,Entegris,30,56,14,100,0.140000
2025-09-27,Entergy,40,53,7,100,0.070000
2025-09-27,Enterprise Products Partners,42,40,18,100,0.180000
2025-09-27,Envista,24,63,13,100,0.130000
2025-09-27,Equifax,41,26,32,99,0.323232
2025-09-27,Equinix,40,55,5,100,0.050000
2025-09-27,Equitable Holdings,37,49,14,100,0.140000
2025-09-27,Equity Residential,33,58,9,100,0.090000
2025-09-27,Erie Insurance,26,56,18,100,0.180000
2025-09-27,Estée Lauder,28,57,15,100,0.150000
2025-09-27,Etsy,26,49,25,100,0.250000
2025-09-27,Euronet Worldwide,28,61,11,100,0.110000
2025-09-27,Evergy,45,40,7,92,0.076087
2025-09-27,Eversource Energy,72,15,13,100,0.130000
2025-09-27,Exact Sciences,31,44,25,100,0.250000
2025-09-27,Exelon,38,53,9,100,0.090000
2025-09-27,Expand Energy Corporation,95,3,2,100,0.020000
2025-09-27,Expedia,48,40,12,100,0.120000
2025-09-27,Expeditors International of Washington,30,64,6,100,0.060000
2025-09-27,Extra Space Storage,19,65,16,100,0.160000
2025-09-27,Exxon Mobil,39,53,8,100,0.080000
2025-09-27,F5,41,50,9,100,0.090000
2025-09-27,FM Global,33,43,24,100,0.240000
2025-09-27,FMC Corporation,39,46,15,100,0.150000
2025-09-27,FTI Consulting,32,53,15,100,0.150000
2025-09-27,Fannie Mae,16,65,19,100,0.190000
2025-09-27,Farmers Insurance Exchange,20,51,29,100,0.290000
2025-09-27,Fastenal,57,42,1,100,0.010000
2025-09-27,FedEx,32,49,19,100,0.190000
2025-09-27,Federated Mutual Insurance,19,21,8,48,0.166667
2025-09-27,Ferguson Enterprises,35,57,8,100,0.080000
2025-09-27,Fidelity National Financial,34,54,12,100,0.120000
2025-09-27,Fidelity National Information Services,44,42,14,100,0.140000
2025-09-27,Fifth Third Bancorp,48,46,6,100,0.060000
2025-09-27,First American Financial,31,53,16,100,0.160000
2025-09-27,First Citizens BancShares,40,54,6,100,0.060000
2025-09-27,First Horizon,43,56,1,100,0.010000
2025-09-27,First National of Nebraska,16,36,2,54,0.037037
2025-09-27,First Solar,37,57,6,100,0.060000
2025-09-27,FirstCash,29,55,16,100,0.160000
2025-09-27,FirstEnergy,46,33,21,100,0.210000
2025-09-27,Fiserv,32,55,13,100,0.130000
2025-09-27,Five Below,29,59,12,100,0.120000
2025-09-27,Flagstar Financial,27,55,18,100,0.180000
2025-09-27,Floor & Decor,35,53,12,100,0.120000
2025-09-27,Flowers Foods,21,57,22,100,0.220000
2025-09-27,Flowserve,27,66,7,100,0.070000
2025-09-27,Fluor,31,43,26,100,0.260000
2025-09-27,Foot Locker,10,75,15,100,0.150000
2025-09-27,Ford Motor,29,53,20,102,0.196078
2025-09-27,Fortinet,25,36,39,100,0.390000
2025-09-27,Fortive,19,58,23,100,0.230000
2025-09-27,Fortune Brands Innovations,27,62,11,100,0.110000
2025-09-27,Franklin Resources,36,51,13,100,0.130000
2025-09-27,Freddie Mac,22,70,8,100,0.080000
2025-09-27,Freeport-McMoRan,12,51,37,100,0.370000
2025-09-27,Frontier Airlines,28,58,14,100,0.140000
2025-09-27,Frontier Communications,41,49,10,100,0.100000
2025-09-27,G-III Apparel Group,30,54,16,100,0.160000
2025-09-27,GE HealthCare Technologies,32,61,7,100,0.070000
2025-09-27,GE Vernova,49,50,1,100,0.010000
2025-09-27,GMS,26,65,9,100,0.090000
2025-09-27,GXO Logistics,32,58,10,100,0.100000
2025-09-27,GameStop,25,58,17,100,0.170000
2025-09-27,Gannett,29,57,14,100,0.140000
2025-09-27,Garrett Motion Inc,37,57,6,100,0.060000
2025-09-27,Gartner,25,64,11,100,0.110000
2025-09-27,Gen Digital,47,46,7,100,0.070000
2025-09-27,Generac,32,53,15,100,0.150000
2025-09-27,General Dynamics,94,3,3,100,0.030000
2025-09-27,General Mills,37,52,11,100,0.110000
2025-09-27,General Motors,34,56,12,102,0.117647
2025-09-27,Genesis Energy,78,16,6,100,0.060000
2025-09-27,Genuine Parts,40,57,3,100,0.030000
2025-09-27,Genworth Financial,51,43,6,100,0.060000
2025-09-27,Gilead Sciences,35,58,7,100,0.070000
2025-09-27,Global Partners,42,42,16,100,0.160000
2025-09-27,Global Payments,40,55,5,100,0.050000
2025-09-27,Globe Life,35,55,10,100,0.100000
2025-09-27,GoDaddy,36,55,9,100,0.090000
2025-09-27,Goldman Sachs,23,59,19,101,0.188119
2025-09-27,Goodyear Tire & Rubber,23,65,12,100,0.120000
2025-09-27,Graham Holdings Company,29,64,7,100,0.070000
2025-09-27,Granite Construction,40,55,5,100,0.050000
2025-09-27,Graphic Packaging,14,68,18,100,0.180000
2025-09-27,Gray Television,21,63,16,100,0.160000
2025-09-27,Graybar Electric,14,26,5,45,0.111111
2025-09-27,Green Plains Inc,33,52,15,100,0.150000
2025-09-27,Greif,21,74,5,100,0.050000
2025-09-27,Griffon Corporation,35,57,8,100,0.080000
2025-09-27,Grocery Outlet Holding,32,58,10,100,0.100000
2025-09-27,Group 1 Automotive,24,69,7,100,0.070000
2025-09-27,Guardian Life insurance,48,50,2,100,0.020000
2025-09-27,Guess Inc,30,60,10,100,0.100000
2025-09-27,GuideWell Mutual,20,25,0,45,0.000000
2025-09-27,HB Fuller,19,72,9,100,0.090000
2025-09-27,HCA Healthcare,38,53,9,100,0.090000
2025-09-27,HEICO,32,56,12,100,0.120000
2025-09-27,HF SInclair,24,59,17,100,0.170000
2025-09-27,HP,23,62,15,100,0.150000
2025-09-27,Halliburton,22,51,27,100,0.270000
2025-09-27,Hanesbrands,23,70,7,100,0.070000
2025-09-27,Hanover Insurance Group,37,49,14,100,0.140000
2025-09-27,Harley-Davidson,22,62,16,100,0.160000
2025-09-27,Hasbro,31,46,23,100,0.230000
2025-09-27,Hawaiian Airlines Inc,36,61,3,100,0.030000
2025-09-27,Hawaiian Electric Industries,33,54,13,100,0.130000
2025-09-27,Helmerich & Payne,16,64,20,100,0.200000
2025-09-27,Henry Schein,26,64,10,100,0.100000
2025-09-27,Herc Rentals,32,55,13,100,0.130000
2025-09-27,Hershey,38,48,14,100,0.140000
2025-09-27,Hertz,16,65,19,100,0.190000
2025-09-27,Hewlett Packard Enterprise,19,80,1,100,0.010000
2025-09-27,Hillenbrand,26,66,8,100,0.080000
2025-09-27,Hilton Grand Vacations,90,9,1,100,0.010000
2025-09-27,Hilton Worldwide,45,50,5,100,0.050000
2025-09-27,Hologic,27,64,9,100,0.090000
2025-09-27,Home Depot,31,52,17,100,0.170000
2025-09-27,Honeywell,48,42,10,100,0.100000
2025-09-27,Hormel Foods,29,61,10,100,0.100000
2025-09-27,Host Hotels & Resorts,24,67,9,100,0.090000
2025-09-27,Hovnanian Enterprises,32,53,15,100,0.150000
2025-09-27,Howmet Aerospace,35,58,7,100,0.070000
2025-09-27,Hub Group,21,56,23,100,0.230000
2025-09-27,Hubbell,17,65,18,100,0.180000
2025-09-27,Humana,54,31,15,100,0.150000
2025-09-27,Huntington Bancshares,36,59,5,100,0.050000
2025-09-27,Huntington Ingalls Industries,35,49,16,100,0.160000
2025-09-27,Huntsman,13,52,35,100,0.350000
2025-09-27,Hyatt Hotels,36,61,3,100,0.030000
2025-09-27,Hyster-Yale,22,71,7,100,0.070000
2025-09-27,IAC,32,56,12,100,0.120000
2025-09-27,IBM,39,54,7,100,0.070000
2025-09-27,IDEX,35,55,10,100,0.100000
2025-09-27,IDEXX Laboratories,56,38,6,100,0.060000
2025-09-27,IQVIA,56,37,7,100,0.070000
2025-09-27,ITT,45,48,7,100,0.070000
2025-09-27,Icahn Enterprises,28,51,21,100,0.210000
2025-09-27,Illinois Tool Works,34,56,10,100,0.100000
2025-09-27,Illumina Inc,24,64,12,100,0.120000
2025-09-27,Incyte,37,56,7,100,0.070000
2025-09-27,Ingersoll Rand,33,56,11,100,0.110000
2025-09-27,Ingles Markets,26,49,25,100,0.250000
2025-09-27,Ingram Micro,20,46,34,100,0.340000
2025-09-27,Ingredion,49,40,11,100,0.110000
2025-09-27,Insight Enterprises,25,56,19,100,0.190000
2025-09-27,Insperity,37,48,15,100,0.150000
2025-09-27,Instacart,32,59,9,100,0.090000
2025-09-27,Installed Building Products,22,65,13,100,0.130000
2025-09-27,Intel,19,63,17,99,0.171717
2025-09-27,Interactive Brokers,38,52,10,100,0.100000
2025-09-27,Intercontinental Exchange,41,56,3,100,0.030000
2025-09-27,International Flavors & Fragrances,30,54,16,100,0.160000
2025-09-27,International Paper,22,64,14,100,0.140000
2025-09-27,Interpublic Group,37,56,7,100,0.070000
2025-09-27,Intuit,51,42,7,100,0.070000
2025-09-27,Intuitive Surgical,38,48,14,100,0.140000
2025-09-27,Iron Mountain,28,57,15,100,0.150000
2025-09-27,JB Hunt Transport Services,21,61,18,100,0.180000
2025-09-27,JELD-WEN Holding,20,71,9,100,0.090000
2025-09-27,JM Smucker,35,54,11,100,0.110000
2025-09-27,JPMorgan Chase,39,52,9,100,0.090000
2025-09-27,Jabil,28,59,13,100,0.130000
2025-09-27,Jackson Financial,35,59,6,100,0.060000
2025-09-27,Jacobs Solutions,50,46,4,100,0.040000
2025-09-27,Jefferies Financial,27,64,9,100,0.090000
2025-09-27,JetBlue Airways,33,45,22,100,0.220000
2025-09-27,Johnson & Johnson,48,43,9,100,0.090000
2025-09-27,Jones Lang LaSalle,46,52,2,100,0.020000
2025-09-27,Juniper Networks,25,64,11,100,0.110000
2025-09-27,KB Home,32,59,9,100,0.090000
2025-09-27,KBR,47,39,14,100,0.140000
2025-09-27,KKR & Co,54,40,6,100,0.060000
2025-09-27,KLA,30,50,20,100,0.200000
2025-09-27,Kaiser Aluminum,26,61,13,100,0.130000
2025-09-27,Kellanova,32,53,15,100,0.150000
2025-09-27,Kelly Services Inc,29,63,8,100,0.080000
2025-09-27,Kemper Corporation,34,54,12,100,0.120000
2025-09-27,Kenvue,11,56,33,100,0.330000
2025-09-27,Keurig Dr Pepper,18,64,18,100,0.180000
2025-09-27,KeyCorp,40,50,10,100,0.100000
2025-09-27,Keysight Technologies,31,64,5,100,0.050000
2025-09-27,Kimberly-Clark,40,48,12,100,0.120000
2025-09-27,Kinder Morgan,94,4,2,100,0.020000
2025-09-27,Kirby Corporation,28,60,12,100,0.120000
2025-09-27,Knife River Corporation,25,45,9,79,0.113924
2025-09-27,Knight Swift Transportation,26,58,16,100,0.160000
2025-09-27,Kohl's,30,51,19,100,0.190000
2025-09-27,Kontoor Brands,36,56,8,100,0.080000
2025-09-27,Korn Ferry,52,35,13,100,0.130000
2025-09-27,Kraft Heinz,31,52,17,100,0.170000
2025-09-27,Kroger,41,45,16,102,0.156863
2025-09-27,Kyndryl,33,61,6,100,0.060000
2025-09-27,L3Harris Technologies,31,63,6,100,0.060000
2025-09-27,LCI Industries,32,62,6,100,0.060000
2025-09-27,LKQ,25,59,16,100,0.160000
2025-09-27,LPL Financial,65,32,3,100,0.030000
2025-09-27,Labcorp Holdings,42,52,6,100,0.060000
2025-09-27,Lam Research,38,54,8,100,0.080000
2025-09-27,Lamb Weston,24,64,12,100,0.120000
2025-09-27,Land O'Lakes,34,57,9,100,0.090000
2025-09-27,Landstar System,18,48,34,100,0.340000
2025-09-27,Las Vegas Sands,35,56,9,100,0.090000
2025-09-27,Lear Corporation,35,50,15,100,0.150000
2025-09-27,Leggett & Platt,18,71,11,100,0.110000
2025-09-27,Leidos,36,56,8,100,0.080000
2025-09-27,Lennar,18,62,20,100,0.200000
2025-09-27,Lennox International,32,61,7,100,0.070000
2025-09-27,Levi Strauss,27,71,2,100,0.020000
2025-09-27,Liberty Energy,89,8,3,100,0.030000
2025-09-27,Liberty Media,94,5,1,100,0.010000
2025-09-27,Liberty Mutual Insurance,80,9,11,100,0.110000
2025-09-27,Light & Wonder,24,62,14,100,0.140000
2025-09-27,Lincoln Electric,45,50,5,100,0.050000
2025-09-27,Lincoln National,30,54,16,100,0.160000
2025-09-27,Lithia Motors,37,58,5,100,0.050000
2025-09-27,Live Nation Entertainment,47,27,26,100,0.260000
2025-09-27,Lockheed Martin,49,41,10,100,0.100000
2025-09-27,Loews,37,57,6,100,0.060000
2025-09-27,Louisiana-Pacific Corporation,35,51,14,100,0.140000
2025-09-27,Lowe's,45,37,18,100,0.180000
2025-09-27,Lululemon athletica,4,2,1,7,0.142857
2025-09-27,Lumen Technologies,25,63,12,100,0.120000
2025-09-27,Lyft,12,60,30,102,0.294118
2025-09-27,M&T Bank,31,57,12,100,0.120000
2025-09-27,M/I Homes,25,65,10,100,0.100000
2025-09-27,MDU Resources Group,38,55,7,100,0.070000
2025-09-27,MGM Resorts International,29,58,13,100,0.130000
2025-09-27,MKS Instruments,39,49,12,100,0.120000
2025-09-27,MRC Global,36,61,3,100,0.030000
2025-09-27,MSC Industrial Direct,23,65,12,100,0.120000
2025-09-27,MSCI,33,59,8,100,0.080000
2025-09-27,MYR Group,33,52,15,100,0.150000
2025-09-27,Macys,27,64,9,100,0.090000
2025-09-27,ManpowerGroup,24,57,19,100,0.190000
2025-09-27,Marathon Oil,26,58,16,100,0.160000
2025-09-27,Marathon Petroleum,45,49,6,100,0.060000
2025-09-27,Markel Group,41,47,12,100,0.120000
2025-09-27,Marriott International,37,58,5,100,0.050000
2025-09-27,Marriott Vacations Worldwide,34,52,14,100,0.140000
2025-09-27,Marsh & McLennan,50,40,10,100,0.100000
2025-09-27,Martin Marietta Materials,31,51,18,100,0.180000
2025-09-27,Marvell Technology,37,48,7,92,0.076087
2025-09-27,MasTec,39,58,3,100,0.030000
2025-09-27,Masco,31,57,12,100,0.120000
2025-09-27,Mass Mutual,25,69,6,100,0.060000
2025-09-27,MasterBrand,30,65,5,100,0.050000
2025-09-27,Mastercard,41,49,10,100,0.100000
2025-09-27,Matador Resources,31,60,9,100,0.090000
2025-09-27,Match Group,16,44,40,100,0.400000
2025-09-27,Mativ,26,66,8,100,0.080000
2025-09-27,Matson Inc,36,50,14,100,0.140000
2025-09-27,Mattel,32,49,19,100,0.190000
2025-09-27,Maximus,25,67,8,100,0.080000
2025-09-27,McCormick & Company,38,45,17,100,0.170000
2025-09-27,McDonalds,24,51,25,100,0.250000
2025-09-27,McKesson,39,56,5,100,0.050000
2025-09-27,Medical Mutual of Ohio,27,60,13,100,0.130000
2025-09-27,Merck,36,50,14,100,0.140000
2025-09-27,Mercury General,23,55,22,100,0.220000
2025-09-27,Meritage Homes,25,60,15,100,0.150000
2025-09-27,MetLife,29,56,15,100,0.150000
2025-09-27,Meta Platforms,37,56,13,106,0.122642
2025-09-27,Mettler-Toledo International,26,71,3,100,0.030000
2025-09-27,Microchip Technology,36,57,7,100,0.070000
2025-09-27,Micron Technology,34,56,10,100,0.100000
2025-09-27,Microsoft,15,46,39,100,0.390000
2025-09-27,Middleby,20,73,7,100,0.070000
2025-09-27,MillerKnoll,28,62,10,100,0.100000
2025-09-27,Moderna,36,45,19,100,0.190000
2025-09-27,ModivCare,27,50,23,100,0.230000
2025-09-27,Mohawk Industries,35,56,9,100,0.090000
2025-09-27,Molina Healthcare,29,52,19,100,0.190000
2025-09-27,Molson Coors Beverage,25,60,15,100,0.150000
2025-09-27,Mondelez,37,46,17,100,0.170000
2025-09-27,Monster Beverage,48,47,5,100,0.050000
2025-09-27,Moodys Corporation,3,11,2,16,0.125000
2025-09-27,Moog Inc,39,54,7,100,0.070000
2025-09-27,Morgan Stanley,18,77,7,102,0.068627
2025-09-27,Motorola Solutions,49,45,6,100,0.060000
2025-09-27,Mueller Industries,43,49,8,100,0.080000
2025-09-27,Murphy Oil,27,59,14,100,0.140000
2025-09-27,Murphy USA,32,58,10,100,0.100000
2025-09-27,Mutual of Omaha,43,50,7,100,0.070000
2025-09-27,NCR Atleos,39,57,4,100,0.040000
2025-09-27,NCR Voyix,29,61,10,100,0.100000
2025-09-27,NGL Energy Partners,83,10,7,100,0.070000
2025-09-27,NLV Financial,3,4,3,10,0.300000
2025-09-27,NOV,26,59,15,100,0.150000
2025-09-27,NRG Energy,81,11,8,100,0.080000
2025-09-27,NVR Inc,36,53,11,100,0.110000
2025-09-27,Nasdaq Inc,37,59,4,100,0.040000
2025-09-27,Nationwide Insurance,19,58,23,100,0.230000
2025-09-27,Navient,34,41,25,100,0.250000
2025-09-27,NetApp,31,63,6,100,0.060000
2025-09-27,Netflix,25,52,25,102,0.245098
2025-09-27,NeueHealth,56,40,4,100,0.040000
2025-09-27,New York Life Insurance,42,47,11,100,0.110000
2025-09-27,NewMarket Corporation,32,36,3,71,0.042254
2025-09-27,Newell Brands,32,55,13,100,0.130000
2025-09-27,Newmont,35,55,10,100,0.100000
2025-09-27,News Corp,16,64,20,100,0.200000
2025-09-27,Nexstar Media Group,12,66,14,92,0.152174
2025-09-27,NextEra Energy,83,14,3,100,0.030000
2025-09-27,NiSource,47,41,12,100,0.120000
2025-09-27,Nike,21,58,19,98,0.193878
2025-09-27,Nordson,38,58,4,100,0.040000
2025-09-27,Nordstrom,35,59,6,100,0.060000
2025-09-27,Norfolk Southern,36,55,9,100,0.090000
2025-09-27,Northern Trust,93,5,2,100,0.020000
2025-09-27,Northrop Grumman,31,61,8,100,0.080000
2025-09-27,Northwestern Mutual,31,50,19,100,0.190000
2025-09-27,Nucor,29,52,19,100,0.190000
2025-09-27,Nvidia,27,60,13,100,0.130000
2025-09-27,O'Reilly Automotive,63,35,2,100,0.020000
2025-09-27,O-I Glass,36,51,13,100,0.130000
2025-09-27,ODP Business Solutions,20,49,1,70,0.014286
2025-09-27,OGE Energy,90,6,4,100,0.040000
2025-09-27,ON Semiconductor,22,62,16,100,0.160000
2025-09-27,Occidental Petroleum,33,47,20,100,0.200000
2025-09-27,Old Dominion Freight Line,35,42,23,100,0.230000
2025-09-27,Old National Bancorp,27,73,0,100,0.000000
2025-09-27,Old Republic International,46,48,6,100,0.060000
2025-09-27,Olin,20,60,20,100,0.200000
2025-09-27,Omnicom Group,38,46,16,100,0.160000
2025-09-27,OneMain,49,49,2,100,0.020000
2025-09-27,Oneok,44,52,4,100,0.040000
2025-09-27,Opendoor Technologies,22,49,29,100,0.290000
2025-09-27,Option Care Health,95,5,0,100,0.000000
2025-09-27,Oracle,30,60,14,104,0.134615
2025-09-27,Organon,30,54,16,100,0.160000
2025-09-27,Oscar Health,25,62,13,100,0.130000
2025-09-27,Oshkosh Corporation,38,51,11,100,0.110000
2025-09-27,Otis Worldwide,31,55,14,100,0.140000
2025-09-27,Ovintiv,39,54,7,100,0.070000
2025-09-27,Owens & Minor,25,49,26,100,0.260000
2025-09-27,Owens Corning,23,75,2,100,0.020000
2025-09-27,PACS Group,21,49,30,100,0.300000
2025-09-27,PBF Energy,79,8,13,100,0.130000
2025-09-27,PC Connection Inc,42,33,4,79,0.050633
2025-09-27,PENN Entertainment,90,10,0,100,0.000000
2025-09-27,PG&E,40,42,18,100,0.180000
2025-09-27,PNC Financial Services,45,51,4,100,0.040000
2025-09-27,PPG Industries,28,61,11,100,0.110000
2025-09-27,PPL Corporation,40,50,10,100,0.100000
2025-09-27,PVH,29,43,28,100,0.280000
2025-09-27,Paccar,41,44,15,100,0.150000
2025-09-27,Pacific Life,39,54,7,100,0.070000
2025-09-27,Packaging Corp of America,16,66,18,100,0.180000
2025-09-27,Palo Alto Networks,34,53,13,100,0.130000
2025-09-27,Par Pacific,30,62,8,100,0.080000
2025-09-27,Paramount Global,28,56,16,100,0.160000
2025-09-27,Park Hotels & Resorts,29,58,13,100,0.130000
2025-09-27,Parker-Hannifin,57,42,1,100,0.010000
2025-09-27,Parsons Corporation,43,44,13,100,0.130000
2025-09-27,Patrick Industries,36,58,6,100,0.060000
2025-09-27,Patterson Companies Inc,12,44,4,60,0.066667
2025-09-27,Patterson-UTI Energy,60,27,13,100,0.130000
2025-09-27,PayPal,38,50,12,100,0.120000
2025-09-27,Paychex,31,48,21,100,0.210000
2025-09-27,Peabody Energy,71,21,8,100,0.080000
2025-09-27,Peloton Interactive,33,55,12,100,0.120000
2025-09-27,Penn Mutual Life Insurance,35,60,5,100,0.050000
2025-09-27,PennyMac Financial Services,32,62,6,100,0.060000
2025-09-27,Penske Automotive,33,62,5,100,0.050000
2025-09-27,PepsiCo,48,44,8,100,0.080000
2025-09-27,Performance Food,36,59,5,100,0.050000
2025-09-27,Permian Resources,38,56,6,100,0.060000
2025-09-27,Petco Health and Wellness,75,19,6,100,0.060000
2025-09-27,Peter Kiewit Sons',9,22,11,42,0.261905
2025-09-27,Pfizer,20,58,22,100,0.220000
2025-09-27,Philip Morris International,55,35,10,100,0.100000
2025-09-27,Phillips 66,44,48,8,100,0.080000
2025-09-27,Pinnacle West Capital,31,47,22,100,0.220000
2025-09-27,Pinterest,32,59,9,100,0.090000
2025-09-27,Pioneer Natural Resources,50,33,17,100,0.170000
2025-09-27,Pitney Bowes,31,61,8,100,0.080000
2025-09-27,Plains GP,32,47,21,100,0.210000
2025-09-27,Playtika Holding,26,51,23,100,0.230000
2025-09-27,Plexus Corp,37,57,6,100,0.060000
2025-09-27,Polaris Inc,42,51,7,100,0.070000
2025-09-27,Pool Corporation,31,55,14,100,0.140000
2025-09-27,Popular Inc,95,3,2,100,0.020000
2025-09-27,Portland General Electric,32,54,14,100,0.140000
2025-09-27,Post Holdings,23,68,9,100,0.090000
2025-09-27,PrIncipal Financial,43,51,6,100,0.060000
2025-09-27,PriceSmart,32,61,7,100,0.070000
2025-09-27,Primerica,38,56,6,100,0.060000
2025-09-27,ProFrac Holding,30,52,18,100,0.180000
2025-09-27,Procter & Gamble,35,47,18,100,0.180000
2025-09-27,Progressive Insurance,29,55,16,100,0.160000
2025-09-27,Prologis,39,58,3,100,0.030000
2025-09-27,Prudential Financial,40,51,9,100,0.090000
2025-09-27,Public Service Enterprise Group,44,48,8,100,0.080000
2025-09-27,Public Storage,41,43,16,100,0.160000
2025-09-27,Publix Super Markets,38,55,7,100,0.070000
2025-09-27,Puget Sound Energy,56,28,16,100,0.160000
2025-09-27,PulteGroup,24,68,8,100,0.080000
2025-09-27,Pure Storage,39,56,5,100,0.050000
2025-09-27,QVC Group,23,64,13,100,0.130000
2025-09-27,QXO Building Products,0,8,2,10,0.200000
2025-09-27,Qorvo,47,45,8,100,0.080000
2025-09-27,Qualcomm,27,66,8,101,0.079208
2025-09-27,Quanta Services,39,58,3,100,0.030000
2025-09-27,Quest Diagnostics,33,59,8,100,0.080000
2025-09-27,QuidelOrtho,32,57,11,100,0.110000
2025-09-27,REV Group,47,44,9,100,0.090000
2025-09-27,RPM International,26,62,12,100,0.120000
2025-09-27,RTX,32,52,16,100,0.160000
2025-09-27,RXO Inc,32,51,17,100,0.170000
2025-09-27,Rackspace Technology,25,59,16,100,0.160000
2025-09-27,Radius Recycling,14,55,31,100,0.310000
2025-09-27,Ralph Lauren,27,65,8,100,0.080000
2025-09-27,Range Resources,45,47,8,100,0.080000
2025-09-27,Raymond James Financial,34,60,6,100,0.060000
2025-09-27,Realty Income,42,41,17,100,0.170000
2025-09-27,Regal Rexnord,30,61,9,100,0.090000
2025-09-27,Regeneron Pharmaceuticals,48,46,6,100,0.060000
2025-09-27,Regions Financial,47,46,7,100,0.070000
2025-09-27,Reinsurance Group of America,34,60,6,100,0.060000
2025-09-27,Reliance Inc,41,48,11,100,0.110000
2025-09-27,Republic Services,33,23,44,100,0.440000
2025-09-27,ResMed,25,70,5,100,0.050000
2025-09-27,Resideo Technologies,38,55,7,100,0.070000
2025-09-27,Restoration Hardware,25,55,20,100,0.200000
2025-09-27,Revvity,29,53,18,100,0.180000
2025-09-27,Rithm Capital,19,76,5,100,0.050000
2025-09-27,Rivian Automotive,33,60,9,102,0.088235
2025-09-27,Robert Half,34,50,16,100,0.160000
2025-09-27,Roblox,28,37,35,100,0.350000
2025-09-27,Rocket Companies,20,73,7,100,0.070000
2025-09-27,Rockwell Automation,36,57,7,100,0.070000
2025-09-27,Roku,57,38,7,102,0.068627
2025-09-27,Rollins Inc,27,68,5,100,0.050000
2025-09-27,Roper Technologies,31,63,6,100,0.060000
2025-09-27,Ross Stores,24,64,12,100,0.120000
2025-09-27,Rush Enterprises,34,53,13,100,0.130000
2025-09-27,Ryder System,44,52,4,100,0.040000
2025-09-27,Ryerson Holding,20,71,8,99,0.080808
2025-09-27,S&P Global,21,71,8,100,0.080000
2025-09-27,SBA Communications,42,45,13,100,0.130000
2025-09-27,SS&C Technologies,42,55,3,100,0.030000
2025-09-27,Sabre Corporation,25,62,13,100,0.130000
2025-09-27,Saia Inc,48,47,5,100,0.050000
2025-09-27,Salesforce,14,41,46,101,0.455446
2025-09-27,Sallie Mae,30,58,12,100,0.120000
2025-09-27,Sally Beauty,94,5,1,100,0.010000
2025-09-27,Sanmina,25,71,4,100,0.040000
2025-09-27,ScanSource,35,56,9,100,0.090000
2025-09-27,Schneider National,30,56,14,100,0.140000
2025-09-27,Science Applications International,30,52,18,100,0.180000
2025-09-27,Scotts Miracle-Gro,37,42,21,100,0.210000
2025-09-27,Seaboard,27,51,22,100,0.220000
2025-09-27,Sealed Air Corporation,23,67,10,100,0.100000
2025-09-27,Securian Financial,27,65,8,100,0.080000
2025-09-27,Select Medical Holdings,28,58,14,100,0.140000
2025-09-27,Selective Insurance Group,21,50,29,100,0.290000
2025-09-27,Sempra,34,61,5,100,0.050000
2025-09-27,Sentry Insurance Group,4,6,0,10,0.000000
2025-09-27,Service Corp International,5,13,6,24,0.250000
2025-09-27,ServiceNow,24,61,15,100,0.150000
2025-09-27,Sherwin-Williams,18,63,18,99,0.181818
2025-09-27,Shift4 Payments,23,62,15,100,0.150000
2025-09-27,Silgan,17,53,30,100,0.300000
2025-09-27,Simon Property Group,42,50,8,100,0.080000
2025-09-27,Sinclair,8,60,24,92,0.260870
2025-09-27,Sirius XM,25,71,4,100,0.040000
2025-09-27,SiteOne Landscape Supply,27,60,13,100,0.130000
2025-09-27,Skechers USA,24,69,7,100,0.070000
2025-09-27,SkyWest,16,53,31,100,0.310000
2025-09-27,Skyline Champion,44,12,2,58,0.034483
2025-09-27,Skyworks Solutions,28,63,9,100,0.090000
2025-09-27,Smurfit Westrock,18,65,17,100,0.170000
2025-09-27,Snap Inc,33,40,27,100,0.270000
2025-09-27,Snap-on,23,61,16,100,0.160000
2025-09-27,Snowflake Inc,53,47,0,100,0.000000
2025-09-27,Solventum,32,64,4,100,0.040000
2025-09-27,Sonic Automotive,16,76,8,100,0.080000
2025-09-27,Sonoco Products,22,67,11,100,0.110000
2025-09-27,Southern Company,43,49,8,100,0.080000
2025-09-27,Southwest Airlines,21,53,27,101,0.267327
2025-09-27,Southwest Gas Holdings,38,54,8,100,0.080000
2025-09-27,SpartanNash,22,75,3,100,0.030000
2025-09-27,Spectrum Brands,26,51,23,100,0.230000
2025-09-27,Spire Inc,53,38,9,100,0.090000
2025-09-27,Spirit AeroSystems,35,42,23,100,0.230000
2025-09-27,Spirit Airlines,13,52,27,92,0.293478
2025-09-27,Splunk,40,45,15,100,0.150000
2025-09-27,Sprouts Farmers Market,27,69,4,100,0.040000
2025-09-27,Stagwell,31,57,12,100,0.120000
2025-09-27,Stanley Black & Decker,23,61,16,100,0.160000
2025-09-27,Starbucks,3,82,7,92,0.076087
2025-09-27,State Farm Insurance,19,55,26,100,0.260000
2025-09-27,State Street,31,57,12,100,0.120000
2025-09-27,Steel Dynamics,85,10,5,100,0.050000
2025-09-27,Steelcase,24,73,3,100,0.030000
2025-09-27,Stericycle,11,31,58,100,0.580000
2025-09-27,Stifel Financial,32,62,6,100,0.060000
2025-09-27,StoneX Group,35,62,3,100,0.030000
2025-09-27,Stryker,23,62,15,100,0.150000
2025-09-27,Summit Materials,23,67,10,100,0.100000
2025-09-27,Sun Communities,44,44,12,100,0.120000
2025-09-27,Super Micro Computer,88,8,4,100,0.040000
2025-09-27,Surgery Partners,28,58,14,100,0.140000
2025-09-27,Sylvamo,24,55,21,100,0.210000
2025-09-27,Synchrony Financial,55,43,2,100,0.020000
2025-09-27,Synopsys,28,50,22,100,0.220000
2025-09-27,Synovus Financial,38,55,7,100,0.070000
2025-09-27,Sysco,48,42,10,100,0.100000
2025-09-27,T Rowe Price,48,49,3,100,0.030000
2025-09-27,TD Synnex,36,59,5,100,0.050000
2025-09-27,TEGNA,23,65,12,100,0.120000
2025-09-27,THOR Industries,25,66,9,100,0.090000
2025-09-27,TIAA,26,62,12,100,0.120000
2025-09-27,TJX,57,35,8,100,0.080000
2025-09-27,Take-Two Interactive Software,37,58,5,100,0.050000
2025-09-27,Talen Energy,86,13,1,100,0.010000
2025-09-27,Tapestry,27,61,12,100,0.120000
2025-09-27,Targa Resources,49,39,12,100,0.120000
2025-09-27,Target Corporation,48,46,6,100,0.060000
2025-09-27,Taylor Morrison Home,29,62,9,100,0.090000
2025-09-27,Teladoc Health,36,52,12,100,0.120000
2025-09-27,Teledyne Technologies,31,65,4,100,0.040000
2025-09-27,Teleflex,22,67,11,100,0.110000
2025-09-27,Telephone & Data Systems,8,14,2,24,0.083333
2025-09-27,TelevisaUnivision,28,54,18,100,0.180000
2025-09-27,Tempur Sealy International,31,53,16,100,0.160000
2025-09-27,Tenet Healthcare,35,52,13,100,0.130000
2025-09-27,Teradyne,33,63,4,100,0.040000
2025-09-27,Terex,17,74,9,100,0.090000
2025-09-27,Tesla,22,43,34,99,0.343434
2025-09-27,Tetra Tech,46,43,11,100,0.110000
2025-09-27,Texas Instruments,26,58,16,100,0.160000
2025-09-27,Texas Roadhouse,36,53,11,100,0.110000
2025-09-27,Textron,30,59,11,100,0.110000
2025-09-27,The Andersons Inc,29,67,4,100,0.040000
2025-09-27,The Coca-Cola Company,30,59,11,100,0.110000
2025-09-27,The Greenbrier Companies,24,66,10,100,0.100000
2025-09-27,The Hartford,26,42,32,100,0.320000
2025-09-27,The Mosaic Company,29,55,16,100,0.160000
2025-09-27,Thermo Fisher Scientific,42,50,8,100,0.080000
2025-09-27,Thrivent Financial for Lutherans,32,57,8,97,0.082474
2025-09-27,Timken,24,63,13,100,0.130000
2025-09-27,Titan Machinery,18,68,14,100,0.140000
2025-09-27,Toast Inc,29,58,13,100,0.130000
2025-09-27,Toll Brothers,13,84,3,100,0.030000
2025-09-27,TopBuild,22,78,0,100,0.000000
2025-09-27,Topgolf Callaway Brands,20,59,21,100,0.210000
2025-09-27,Toro Company,27,64,9,100,0.090000
2025-09-27,Tractor Supply,27,66,7,100,0.070000
2025-09-27,TransDigm,40,45,15,100,0.150000
2025-09-27,TransUnion,34,43,23,100,0.230000
2025-09-27,Travelers Insurance,36,38,26,100,0.260000
2025-09-27,TreeHouse Foods,17,54,29,100,0.290000
2025-09-27,Tri Pointe Homes,26,67,7,100,0.070000
2025-09-27,TriNet Group,26,63,11,100,0.110000
2025-09-27,Trimble Inc,37,54,9,100,0.090000
2025-09-27,Trinity Industries,28,53,19,100,0.190000
2025-09-27,TruStage,50,40,10,100,0.100000
2025-09-27,Truist Financial,39,51,10,100,0.100000
2025-09-27,Tutor Perini Corporation,58,36,6,100,0.060000
2025-09-27,Twilio,37,55,8,100,0.080000
2025-09-27,Tyson Foods,25,60,15,100,0.150000
2025-09-27,U-Haul,8,35,57,100,0.570000
2025-09-27,UFP Industries,26,61,13,100,0.130000
2025-09-27,UGI Utilities Inc,26,32,18,76,0.236842
2025-09-27,UL Solutions,42,50,8,100,0.080000
2025-09-27,UPS,17,51,32,100,0.320000
2025-09-27,US Bancorp,39,55,6,100,0.060000
2025-09-27,US Foods,53,43,4,100,0.040000
2025-09-27,USAA,28,49,23,100,0.230000
2025-09-27,Uber,21,58,23,102,0.225490
2025-09-27,Ulta Beauty,82,12,6,100,0.060000
2025-09-27,Under Armour,25,65,10,100,0.100000
2025-09-27,Union Pacific,45,47,8,100,0.080000
2025-09-27,United Airlines,80,14,7,101,0.069307
2025-09-27,United Natural Foods,85,12,3,100,0.030000
2025-09-27,United Rentals,94,4,2,100,0.020000
2025-09-27,United States Steel,51,42,7,100,0.070000
2025-09-27,UnitedHealth,41,43,16,100,0.160000
2025-09-27,Universal Corporation,34,58,8,100,0.080000
2025-09-27,Universal Health Services,33,55,12,100,0.120000
2025-09-27,Unum Group,39,49,12,100,0.120000
2025-09-27,Upbound Group,40,55,5,100,0.050000
2025-09-27,Urban Outfitters,40,53,7,100,0.070000
2025-09-27,V2X,45,50,5,100,0.050000
2025-09-27,VF Corporation,26,49,25,100,0.250000
2025-09-27,VICI Properties,36,58,6,100,0.060000
2025-09-27,Vail Resorts,23,54,23,100,0.230000
2025-09-27,Valero Energy,84,8,8,100,0.080000
2025-09-27,Valley National Bancorp,23,70,7,100,0.070000
2025-09-27,Valmont Industries,39,51,10,100,0.100000
2025-09-27,Valvoline Inc,33,61,6,100,0.060000
2025-09-27,Ventas Inc,45,55,0,100,0.000000
2025-09-27,Verisk Analytics,37,48,15,100,0.150000
2025-09-27,Verizon,44,49,7,100,0.070000
2025-09-27,Vertex Pharmaceuticals,44,35,21,100,0.210000
2025-09-27,Vertiv,46,48,6,100,0.060000
2025-09-27,Viasat,39,53,8,100,0.080000
2025-09-27,Viatris,27,52,21,100,0.210000
2025-09-27,Victorias Secret,24,52,24,100,0.240000
2025-09-27,Visa Inc,66,28,6,100,0.060000
2025-09-27,Vishay Intertechnology,28,57,15,100,0.150000
2025-09-27,Vista Outdoor,18,64,18,100,0.180000
2025-09-27,Visteon,39,55,6,100,0.060000
2025-09-27,Vistra,43,47,10,100,0.100000
2025-09-27,Vontier,37,57,6,100,0.060000
2025-09-27,Voya Financial,36,58,6,100,0.060000
2025-09-27,Vulcan Materials,28,54,18,100,0.180000
2025-09-27,WEC Energy,82,13,5,100,0.050000
2025-09-27,WESCO International,36,56,8,100,0.080000
2025-09-27,WEX,41,53,6,100,0.060000
2025-09-27,WR Berkley,42,48,10,100,0.100000
2025-09-27,WW Grainger,31,56,13,100,0.130000
2025-09-27,Wabash National,22,51,27,100,0.270000
2025-09-27,Walmart,30,44,26,100,0.260000
2025-09-27,Walt Disney,42,47,11,100,0.110000
2025-09-27,Warner Bros Discovery,14,68,18,100,0.180000
2025-09-27,Warner Music Group,24,62,14,100,0.140000
2025-09-27,Waters Corporation,45,46,9,100,0.090000
2025-09-27,Watsco,27,49,24,100,0.240000
2025-09-27,Wayfair,32,61,7,100,0.070000
2025-09-27,Webster Financial,30,58,12,100,0.120000
2025-09-27,Weis Markets,23,63,14,100,0.140000
2025-09-27,Wells Fargo,83,9,8,100,0.080000
2025-09-27,Welltower,60,40,0,100,0.000000
2025-09-27,Werner Enterprises,31,48,21,100,0.210000
2025-09-27,West Pharmaceutical Services,38,47,15,100,0.150000
2025-09-27,Western & Southern Financial,30,66,4,100,0.040000
2025-09-27,Western Alliance Bancorp,19,44,25,88,0.284091
2025-09-27,Western Digital,28,59,13,100,0.130000
2025-09-27,Western Midstream Partners,35,57,8,100,0.080000
2025-09-27,Western Union,24,66,10,100,0.100000
2025-09-27,Westinghouse Air Brake Technologies,29,56,15,100,0.150000
2025-09-27,Weyerhaeuser,27,60,13,100,0.130000
2025-09-27,Whirlpool,25,57,18,100,0.180000
2025-09-27,Williams Companies,50,42,8,100,0.080000
2025-09-27,Williams-Sonoma,28,65,7,100,0.070000
2025-09-27,Winnebago Industries,20,64,16,100,0.160000
2025-09-27,Wintrust Financial,35,64,1,100,0.010000
2025-09-27,Woodward Inc,30,68,2,100,0.020000
2025-09-27,Workday,25,61,14,100,0.140000
2025-09-27,World Kinect,32,57,11,100,0.110000
2025-09-27,Worthington Enterprises,33,63,4,100,0.040000
2025-09-27,Wynn Resorts,21,59,20,100,0.200000
2025-09-27,XPO,23,62,15,100,0.150000
2025-09-27,Xcel Energy,51,22,27,100,0.270000
2025-09-27,Xerox,22,59,19,100,0.190000
2025-09-27,Xylem Inc,45,49,6,100,0.060000
2025-09-27,Yum Brands,30,55,15,100,0.150000
2025-09-27,Yum China,39,47,14,100,0.140000
2025-09-27,Zebra Technologies,34,55,11,100,0.110000
2025-09-27,Zimmer Biomet,38,58,4,100,0.040000
2025-09-27,Zions Bancorp,36,46,18,100,0.180000
2025-09-27,Zoetis,48,44,8,100,0.080000
2025-09-27,Zoom Video Communications,31,53,16,100,0.160000
2025-09-27,eXp World,31,61,8,100,0.080000
2025-09-27,iHeartMedia,26,64,10,100,0.100000
