date,company,positive,neutral,negative,total,neg_pct
2025-08-13,Alphabet,60,66,21,147,0.142857
2025-08-13,Amazon,83,3,14,100,0.140000
2025-08-13,Apple,39,46,13,98,0.132653
2025-08-13,Disney,38,43,19,100,0.190000
2025-08-13,Ford,26,54,19,99,0.191919
2025-08-13,Meta,80,63,56,199,0.281407
2025-08-13,Procter & Gamble,27,21,7,55,0.127273
2025-08-13,Walmart,36,28,29,93,0.311828
2025-08-15,3M,16,19,5,40,0.125000
2025-08-15,A-Mark Precious Metals,36,4,0,40,0.000000
2025-08-15,AES,21,13,6,40,0.150000
2025-08-15,AGCO,20,16,4,40,0.100000
2025-08-15,APA,16,13,11,40,0.275000
2025-08-15,AT&T,8,26,6,40,0.150000
2025-08-15,AbbVie,13,21,6,40,0.150000
2025-08-15,Abbott Laboratories,20,16,4,40,0.100000
2025-08-15,Advance Auto Parts,13,15,12,40,0.300000
2025-08-15,Advanced Micro Devices,6,2,2,10,0.200000
2025-08-15,Aflac,14,16,10,40,0.250000
2025-08-15,Air Products & Chemicals,15,23,2,40,0.050000
2025-08-15,Alaska Air Group,14,24,2,40,0.050000
2025-08-15,Albertsons,14,14,12,40,0.300000
2025-08-15,Allstate,18,17,5,40,0.125000
2025-08-15,Ally Financial,15,24,1,40,0.025000
2025-08-15,Alphabet,17,20,3,40,0.075000
2025-08-15,Altria Group,16,20,4,40,0.100000
2025-08-15,Amazon,34,2,4,40,0.100000
2025-08-15,American Airlines Group,16,19,5,40,0.125000
2025-08-15,American Express,20,16,4,40,0.100000
2025-08-15,American International Group,6,25,9,40,0.225000
2025-08-15,Ameriprise Financial,23,15,2,40,0.050000
2025-08-15,AmerisourceBergen,13,14,13,40,0.325000
2025-08-15,Amgen,15,18,7,40,0.175000
2025-08-15,Amphenol,12,22,6,40,0.150000
2025-08-15,Antero Resources,11,28,1,40,0.025000
2025-08-15,Aon,9,16,15,40,0.375000
2025-08-15,Apple,14,21,5,40,0.125000
2025-08-15,Applied Materials,4,17,19,40,0.475000
2025-08-15,Aramark,20,14,6,40,0.150000
2025-08-15,Archer Daniels Midland,22,15,3,40,0.075000
2025-08-15,Arrow Electronics,17,21,2,40,0.050000
2025-08-15,Asbury Automotive Group,11,25,4,40,0.100000
2025-08-15,Assurant,21,18,1,40,0.025000
2025-08-15,Athene Holding,20,19,1,40,0.025000
2025-08-15,Atmos Energy,38,1,1,40,0.025000
2025-08-15,AutoNation,13,21,6,40,0.150000
2025-08-15,AutoZone,12,10,18,40,0.450000
2025-08-15,Autoliv,23,16,1,40,0.025000
2025-08-15,Automatic Data Processing,18,17,5,40,0.125000
2025-08-15,Avis Budget Group,9,24,7,40,0.175000
2025-08-15,Baker Hughes,16,14,10,40,0.250000
2025-08-15,Ball,18,17,5,40,0.125000
2025-08-15,Bank of America,23,12,5,40,0.125000
2025-08-15,Bank of New York Mellon,29,10,1,40,0.025000
2025-08-15,Becton Dickinson,18,19,3,40,0.075000
2025-08-15,Berkshire Hathaway,10,27,3,40,0.075000
2025-08-15,Best Buy,38,1,1,40,0.025000
2025-08-15,Biogen,11,27,2,40,0.050000
2025-08-15,BlackRock,15,19,6,40,0.150000
2025-08-15,Blackstone,14,12,14,40,0.350000
2025-08-15,Boeing,7,21,12,40,0.300000
2025-08-15,Booking Holdings,23,13,4,40,0.100000
2025-08-15,BorgWarner,24,15,1,40,0.025000
2025-08-15,Boston Properties,9,26,5,40,0.125000
2025-08-15,Boston Scientific,18,15,7,40,0.175000
2025-08-15,Bristol-Myers Squibb,13,19,8,40,0.200000
2025-08-15,Broadcom,14,19,7,40,0.175000
2025-08-15,Bunge,14,20,6,40,0.150000
2025-08-15,C.H. Robinson,13,22,5,40,0.125000
2025-08-15,C.H. Robinson Worldwide,14,23,3,40,0.075000
2025-08-15,CBRE Group,15,22,3,40,0.075000
2025-08-15,CDW,17,19,4,40,0.100000
2025-08-15,CF Industries Holdings,21,15,4,40,0.100000
2025-08-15,CSX,13,21,6,40,0.150000
2025-08-15,CVS Health,23,16,1,40,0.025000
2025-08-15,Campbell Soup,12,21,7,40,0.175000
2025-08-15,Capital One Financial,18,17,5,40,0.125000
2025-08-15,CarMax,8,25,7,40,0.175000
2025-08-15,Cardinal Health,10,20,10,40,0.250000
2025-08-15,Cargill,8,23,9,40,0.225000
2025-08-15,Carlisle,16,13,11,40,0.275000
2025-08-15,Caterpillar,11,20,9,40,0.225000
2025-08-15,Celanese,8,15,17,40,0.425000
2025-08-15,Centene,13,10,17,40,0.425000
2025-08-15,CenterPoint Energy,25,5,10,40,0.250000
2025-08-15,Century Communities,11,25,4,40,0.100000
2025-08-15,Cerner,13,23,4,40,0.100000
2025-08-15,Charter Communications,15,13,12,40,0.300000
2025-08-15,Chevron,15,17,8,40,0.200000
2025-08-15,Chubb,19,18,3,40,0.075000
2025-08-15,Cigna Group,19,15,6,40,0.150000
2025-08-15,Cisco Systems,12,22,6,40,0.150000
2025-08-15,Citigroup,15,20,5,40,0.125000
2025-08-15,Citizens Financial Group,18,18,4,40,0.100000
2025-08-15,Coca-Cola,13,22,5,40,0.125000
2025-08-15,Cognizant Technology Solutions,32,6,2,40,0.050000
2025-08-15,Colgate-Palmolive,21,12,7,40,0.175000
2025-08-15,Comcast,0,9,3,12,0.250000
2025-08-15,Consolidated Edison,9,27,4,40,0.100000
2025-08-15,Constellation Energy,36,2,2,40,0.050000
2025-08-15,Corning,25,12,3,40,0.075000
2025-08-15,Costco Wholesale,14,19,7,40,0.175000
2025-08-15,Coterra Energy,36,2,2,40,0.050000
2025-08-15,Crown Holdings,19,19,2,40,0.050000
2025-08-15,Cummins,14,23,3,40,0.075000
2025-08-15,D.R. Horton,11,28,1,40,0.025000
2025-08-15,DISH Network,8,24,8,40,0.200000
2025-08-15,DTE Energy,32,3,5,40,0.125000
2025-08-15,DXC Technology,10,29,1,40,0.025000
2025-08-15,DaVita,22,11,7,40,0.175000
2025-08-15,Darden Restaurants,20,18,2,40,0.050000
2025-08-15,Deere,11,16,13,40,0.325000
2025-08-15,Dell Technologies,13,27,0,40,0.000000
2025-08-15,Delta Air Lines,8,18,14,40,0.350000
2025-08-15,Devon Energy,35,3,2,40,0.050000
2025-08-15,Discover,12,25,3,40,0.075000
2025-08-15,Discover Financial Services,14,23,3,40,0.075000
2025-08-15,Dollar General,10,19,11,40,0.275000
2025-08-15,Dollar Tree,18,19,3,40,0.075000
2025-08-15,Dominion Energy,27,7,6,40,0.150000
2025-08-15,Dow,17,18,5,40,0.125000
2025-08-15,Duke Energy,30,3,7,40,0.175000
2025-08-15,EOG Resources,11,27,2,40,0.050000
2025-08-15,Eastman Chemical,6,13,21,40,0.525000
2025-08-15,Ecolab,14,22,4,40,0.100000
2025-08-15,Edison International,14,22,4,40,0.100000
2025-08-15,Elevance Health,12,16,12,40,0.300000
2025-08-15,Eli Lilly,9,22,9,40,0.225000
2025-08-15,Emerson Electric,22,14,4,40,0.100000
2025-08-15,Entergy,25,13,2,40,0.050000
2025-08-15,Enterprise Products Partners,18,13,9,40,0.225000
2025-08-15,Equifax,24,9,7,40,0.175000
2025-08-15,Erie Insurance Group,19,13,8,40,0.200000
2025-08-15,Estee Lauder,9,27,4,40,0.100000
2025-08-15,Eversource Energy,33,3,4,40,0.100000
2025-08-15,Exelon,17,20,3,40,0.075000
2025-08-15,Expeditors Intl. of Washington,2,3,0,5,0.000000
2025-08-15,Exxon Mobil,13,20,7,40,0.175000
2025-08-15,FMC,15,19,6,40,0.150000
2025-08-15,FedEx,21,12,7,40,0.175000
2025-08-15,Fidelity National Financial,15,21,4,40,0.100000
2025-08-15,Fifth Third Bancorp,24,16,0,40,0.000000
2025-08-15,FirstEnergy,15,17,8,40,0.200000
2025-08-15,Fiserv,14,18,8,40,0.200000
2025-08-15,Fluor,17,12,11,40,0.275000
2025-08-15,Ford Motor,17,18,5,40,0.125000
2025-08-15,Fortune Brands Innovations,11,24,5,40,0.125000
2025-08-15,Franklin Resources,19,19,2,40,0.050000
2025-08-15,Freeport-McMoRan,18,15,7,40,0.175000
2025-08-15,GXO Logistics,13,24,3,40,0.075000
2025-08-15,General Dynamics,35,3,2,40,0.050000
2025-08-15,General Electric,10,28,2,40,0.050000
2025-08-15,General Mills,19,15,6,40,0.150000
2025-08-15,General Motors,19,15,6,40,0.150000
2025-08-15,Genuine Parts,14,23,3,40,0.075000
2025-08-15,Gilead Sciences,19,17,4,40,0.100000
2025-08-15,Goldman Sachs Group,11,22,7,40,0.175000
2025-08-15,Group 1,13,22,5,40,0.125000
2025-08-15,Group 1 Automotive,15,23,2,40,0.050000
2025-08-15,Guardian Life Ins. Co. of America,3,5,1,9,0.111111
2025-08-15,HCA Healthcare,21,10,9,40,0.225000
2025-08-15,HF Sinclair,14,19,7,40,0.175000
2025-08-15,HP,17,15,8,40,0.200000
2025-08-15,Halliburton,21,14,5,40,0.125000
2025-08-15,Harley-Davidson,12,23,5,40,0.125000
2025-08-15,Hartford Financial Services Group,18,19,3,40,0.075000
2025-08-15,Hershey,17,17,6,40,0.150000
2025-08-15,Hess,14,11,15,40,0.375000
2025-08-15,Hewlett Packard Enterprise,7,30,3,40,0.075000
2025-08-15,Hilton Worldwide Holdings,18,20,2,40,0.050000
2025-08-15,Home Depot,5,13,22,40,0.550000
2025-08-15,Honeywell International,18,18,4,40,0.100000
2025-08-15,Howmet Aerospace,21,14,5,40,0.125000
2025-08-15,Humana,24,10,6,40,0.150000
2025-08-15,Huntington Ingalls Industries,22,13,5,40,0.125000
2025-08-15,Icahn Enterprises,8,21,11,40,0.275000
2025-08-15,Illinois Tool Works,15,20,5,40,0.125000
2025-08-15,Ingredion,16,18,6,40,0.150000
2025-08-15,Insight Enterprises,14,19,7,40,0.175000
2025-08-15,Intel,14,25,1,40,0.025000
2025-08-15,Intercontinental Exchange,21,13,6,40,0.150000
2025-08-15,International Paper,18,22,0,40,0.000000
2025-08-15,Interpublic Group,15,23,2,40,0.050000
2025-08-15,Iron Mountain,13,20,7,40,0.175000
2025-08-15,J.B. Hunt Transport Services,15,18,7,40,0.175000
2025-08-15,J.M. Smucker,16,18,6,40,0.150000
2025-08-15,Jacobs Engineering Group,16,21,3,40,0.075000
2025-08-15,Jefferies Financial Group,20,16,4,40,0.100000
2025-08-15,Johnson & Johnson,21,17,2,40,0.050000
2025-08-15,Jones Lang LaSalle,17,23,0,40,0.000000
2025-08-15,KB Home,19,17,4,40,0.100000
2025-08-15,KKR,15,20,5,40,0.125000
2025-08-15,Kaiser Permanente,16,19,5,40,0.125000
2025-08-15,KeyCorp,21,14,5,40,0.125000
2025-08-15,Kimberly-Clark,21,17,2,40,0.050000
2025-08-15,Kimco Realty,22,14,4,40,0.100000
2025-08-15,Kinder Morgan,39,1,0,40,0.000000
2025-08-15,Kraft Heinz,10,19,11,40,0.275000
2025-08-15,Kroger,18,7,15,40,0.375000
2025-08-15,L3Harris Technologies,22,15,3,40,0.075000
2025-08-15,LKQ,19,15,6,40,0.150000
2025-08-15,Lam Research,19,18,3,40,0.075000
2025-08-15,Las Vegas Sands,13,25,2,40,0.050000
2025-08-15,Lear,17,17,6,40,0.150000
2025-08-15,Leidos Holdings,24,12,4,40,0.100000
2025-08-15,Lennar,13,26,1,40,0.025000
2025-08-15,Liberty Mutual Insurance Group,31,3,6,40,0.150000
2025-08-15,Lincoln National,16,16,8,40,0.200000
2025-08-15,Lithia Motors,20,14,6,40,0.150000
2025-08-15,Lockheed Martin,18,14,8,40,0.200000
2025-08-15,Loews,20,17,3,40,0.075000
2025-08-15,Lowe's,19,10,11,40,0.275000
2025-08-15,Marathon Petroleum,20,17,3,40,0.075000
2025-08-15,Markel,11,26,3,40,0.075000
2025-08-15,Marriott International,18,20,2,40,0.050000
2025-08-15,Marsh & McLennan,18,18,4,40,0.100000
2025-08-15,MasTec,19,19,2,40,0.050000
2025-08-15,Masco,14,22,4,40,0.100000
2025-08-15,Massachusetts Mutual Life Insurance,13,19,8,40,0.200000
2025-08-15,Medtronic,25,13,2,40,0.050000
2025-08-15,Merck,9,20,11,40,0.275000
2025-08-15,Meritage Homes,16,17,7,40,0.175000
2025-08-15,MetLife,19,20,1,40,0.025000
2025-08-15,Micron Technology,17,21,2,40,0.050000
2025-08-15,Microsoft,12,18,10,40,0.250000
2025-08-15,Mohawk Industries,21,16,3,40,0.075000
2025-08-15,Molina Healthcare,12,15,13,40,0.325000
2025-08-15,Mondelez International,20,14,6,40,0.150000
2025-08-15,Moody's,12,15,13,40,0.325000
2025-08-15,Morgan Stanley,18,18,4,40,0.100000
2025-08-15,Mosaic,17,18,5,40,0.125000
2025-08-15,NRG Energy,36,2,2,40,0.050000
2025-08-15,NVR,18,16,6,40,0.150000
2025-08-15,Netflix,18,16,6,40,0.150000
2025-08-15,New York Life Insurance,14,23,3,40,0.075000
2025-08-15,Newell Brands,9,22,9,40,0.225000
2025-08-15,Newmont,19,17,4,40,0.100000
2025-08-15,NextEra Energy,29,3,8,40,0.200000
2025-08-15,Norfolk Southern,12,25,3,40,0.075000
2025-08-15,Northern Trust,37,0,3,40,0.075000
2025-08-15,Northrop Grumman,16,22,2,40,0.050000
2025-08-15,Northwestern Mutual,17,13,10,40,0.250000
2025-08-15,Nucor,13,23,4,40,0.100000
2025-08-15,Nvidia,16,16,8,40,0.200000
2025-08-15,O'Reilly Automotive,20,15,5,40,0.125000
2025-08-15,Occidental Petroleum,27,12,1,40,0.025000
2025-08-15,Old Dominion Freight Line,19,17,4,40,0.100000
2025-08-15,Omnicom Group,15,20,5,40,0.125000
2025-08-15,Oneok,15,22,3,40,0.075000
2025-08-15,Oracle,11,24,5,40,0.125000
2025-08-15,Otis Worldwide,17,19,4,40,0.100000
2025-08-15,Ovintiv,19,19,2,40,0.050000
2025-08-15,PBF Energy,31,2,7,40,0.175000
2025-08-15,PG&E,17,17,6,40,0.150000
2025-08-15,PNC Financial Services Group,20,19,1,40,0.025000
2025-08-15,PPG Industries,20,18,2,40,0.050000
2025-08-15,PPL,16,23,1,40,0.025000
2025-08-15,Paccar,17,19,4,40,0.100000
2025-08-15,Pacific Gas and Electric,25,9,6,40,0.150000
2025-08-15,Parker-Hannifin,19,16,5,40,0.125000
2025-08-15,PayPal Holdings,19,18,3,40,0.075000
2025-08-15,Penske,15,18,7,40,0.175000
2025-08-15,Penske Automotive Group,11,28,1,40,0.025000
2025-08-15,PepsiCo,15,20,5,40,0.125000
2025-08-15,Pfizer,11,15,14,40,0.350000
2025-08-15,Philip Morris International,15,21,4,40,0.100000
2025-08-15,Phillips 66,12,17,11,40,0.275000
2025-08-15,Pioneer Natural Resources,20,9,11,40,0.275000
2025-08-15,Plains GP Holdings,19,18,3,40,0.075000
2025-08-15,Principal Financial Group,17,20,3,40,0.075000
2025-08-15,Procter & Gamble,20,13,7,40,0.175000
2025-08-15,Progressive,16,17,7,40,0.175000
2025-08-15,Prudential Financial,13,19,8,40,0.200000
2025-08-15,Public Service Enterprise Group,17,21,2,40,0.050000
2025-08-15,Publix Super Markets,15,20,5,40,0.125000
2025-08-15,PulteGroup,19,18,3,40,0.075000
2025-08-15,Quanta Services,17,15,8,40,0.200000
2025-08-15,Quest Diagnostics,17,20,3,40,0.075000
2025-08-15,RTX,6,6,0,12,0.000000
2025-08-15,Raymond James Financial,18,19,3,40,0.075000
2025-08-15,Realty Income,15,15,10,40,0.250000
2025-08-15,Regeneron Pharmaceuticals,16,18,6,40,0.150000
2025-08-15,Regions Financial,20,20,0,40,0.000000
2025-08-15,Reinsurance Group of America,22,16,2,40,0.050000
2025-08-15,Republic Services,10,11,19,40,0.475000
2025-08-15,Robert Half International,9,13,18,40,0.450000
2025-08-15,Rockwell Automation,15,23,2,40,0.050000
2025-08-15,Ross Stores,17,20,3,40,0.075000
2025-08-15,Ryder System,22,15,3,40,0.075000
2025-08-15,S&P Global,15,17,8,40,0.200000
2025-08-15,Salesforce,15,18,7,40,0.175000
2025-08-15,Sempra,30,8,2,40,0.050000
2025-08-15,ServiceNow,19,20,1,40,0.025000
2025-08-15,Sherwin-Williams,12,17,11,40,0.275000
2025-08-15,Simon Property Group,17,18,5,40,0.125000
2025-08-15,Sonic Automotive,6,31,3,40,0.075000
2025-08-15,Sonoco Products,18,18,4,40,0.100000
2025-08-15,Southern,10,20,10,40,0.250000
2025-08-15,Southwest Airlines,10,17,13,40,0.325000
2025-08-15,Southwestern Energy,35,3,2,40,0.050000
2025-08-15,Stanley Black & Decker,10,23,7,40,0.175000
2025-08-15,Starbucks,9,20,11,40,0.275000
2025-08-15,State Farm Insurance,13,21,6,40,0.150000
2025-08-15,Stellantis,0,5,5,10,0.500000
2025-08-15,StoneX Group,18,19,3,40,0.075000
2025-08-15,Stryker,15,16,9,40,0.225000
2025-08-15,Synchrony Financial,19,16,5,40,0.125000
2025-08-15,Sysco,16,15,9,40,0.225000
2025-08-15,T-Mobile US,21,17,2,40,0.050000
2025-08-15,TD Synnex,22,18,0,40,0.000000
2025-08-15,TIAA,13,24,3,40,0.075000
2025-08-15,TJX,13,22,5,40,0.125000
2025-08-15,Targa Resources,15,20,5,40,0.125000
2025-08-15,Target,16,16,8,40,0.200000
2025-08-15,Taylor Morrison Home,15,24,1,40,0.025000
2025-08-15,Teleflex,10,27,3,40,0.075000
2025-08-15,Tenet Healthcare,14,20,6,40,0.150000
2025-08-15,Texas Instruments,14,18,8,40,0.200000
2025-08-15,Textron,21,17,2,40,0.050000
2025-08-15,Thermo Fisher Scientific,20,18,2,40,0.050000
2025-08-15,Toll Brothers,11,27,2,40,0.050000
2025-08-15,Tractor Supply,22,17,1,40,0.025000
2025-08-15,Travelers,12,18,10,40,0.250000
2025-08-15,Truist Financial,16,21,3,40,0.075000
2025-08-15,Tyson Foods,11,27,2,40,0.050000
2025-08-15,U.S. Bancorp,21,16,3,40,0.075000
2025-08-15,U.S. Postal Service,15,18,7,40,0.175000
2025-08-15,US Foods Holding,22,17,1,40,0.025000
2025-08-15,USAUSA,15,20,5,40,0.125000
2025-08-15,Union Pacific,8,18,14,40,0.350000
2025-08-15,United Airlines Holdings,39,1,0,40,0.000000
2025-08-15,United Rentals,37,3,0,40,0.000000
2025-08-15,UnitedHealth Group,11,22,7,40,0.175000
2025-08-15,Universal Health Services,17,17,6,40,0.150000
2025-08-15,Unum Group,14,19,7,40,0.175000
2025-08-15,V.F.,13,20,7,40,0.175000
2025-08-15,VF,14,18,8,40,0.200000
2025-08-15,Valero Energy,36,1,3,40,0.075000
2025-08-15,Ventas,19,18,3,40,0.075000
2025-08-15,Veritiv,14,21,5,40,0.125000
2025-08-15,Verizon Communications,23,16,1,40,0.025000
2025-08-15,Viatris,17,19,4,40,0.100000
2025-08-15,W. R. Berkley,15,19,6,40,0.150000
2025-08-15,W.W. Grainger,13,23,4,40,0.100000
2025-08-15,WESCO International,19,20,1,40,0.025000
2025-08-15,Walgreens Boots Alliance,9,23,8,40,0.200000
2025-08-15,Walmart,12,14,14,40,0.350000
2025-08-15,Warner Bros. Discovery,16,23,1,40,0.025000
2025-08-15,Waste Management,10,4,26,40,0.650000
2025-08-15,Wayfair,14,25,1,40,0.025000
2025-08-15,WestRock,7,23,10,40,0.250000
2025-08-15,Western Digital,17,20,3,40,0.075000
2025-08-15,Westinghouse Air Brake Technologies,20,18,2,40,0.050000
2025-08-15,Weyerhaeuser,14,19,7,40,0.175000
2025-08-15,Whirlpool,11,22,7,40,0.175000
2025-08-15,Williams,11,23,6,40,0.150000
2025-08-15,XPO Logistics,14,21,5,40,0.125000
2025-08-15,Xcel Energy,34,3,3,40,0.075000
2025-08-15,Yum Brands,18,15,7,40,0.175000
2025-08-15,Zoetis,23,14,3,40,0.075000
2025-08-15,eBay,18,20,2,40,0.050000
2025-08-17,1 Automotive,15,23,2,40,0.050000
2025-08-17,3M,24,15,1,40,0.025000
2025-08-17,A-Mark Precious Metals,35,5,0,40,0.000000
2025-08-17,ABM Industries,12,22,6,40,0.150000
2025-08-17,AECOM,19,20,1,40,0.025000
2025-08-17,AES,25,10,5,40,0.125000
2025-08-17,AGCO,16,20,4,40,0.100000
2025-08-17,APA,17,15,8,40,0.200000
2025-08-17,ARKO,18,20,2,40,0.050000
2025-08-17,AT&T,10,23,7,40,0.175000
2025-08-17,AbbVie,20,19,1,40,0.025000
2025-08-17,Abbott Laboratories,20,17,3,40,0.075000
2025-08-17,Ace Hardware,18,17,5,40,0.125000
2025-08-17,Adobe,14,20,6,40,0.150000
2025-08-17,Advance Auto Parts,13,16,11,40,0.275000
2025-08-17,Advanced Micro Devices,27,7,6,40,0.150000
2025-08-17,Aflac,17,13,10,40,0.250000
2025-08-17,Air Products & Chemicals,18,17,5,40,0.125000
2025-08-17,Airbnb,17,14,9,40,0.225000
2025-08-17,Alaska Air,11,23,6,40,0.150000
2025-08-17,Albertsons,16,16,8,40,0.200000
2025-08-17,Alcoa,9,26,5,40,0.125000
2025-08-17,Allstate,21,17,2,40,0.050000
2025-08-17,Ally Financial,14,25,1,40,0.025000
2025-08-17,Alphabet,16,20,4,40,0.100000
2025-08-17,Altice,9,23,8,40,0.200000
2025-08-17,Altria,21,14,5,40,0.125000
2025-08-17,Amazon,34,2,4,40,0.100000
2025-08-17,American Airlines,8,18,14,40,0.350000
2025-08-17,American Electric Power,15,23,2,40,0.050000
2025-08-17,American Express,19,17,4,40,0.100000
2025-08-17,American Family Insurance,25,12,3,40,0.075000
2025-08-17,American Financial,14,20,6,40,0.150000
2025-08-17,American International,9,24,7,40,0.175000
2025-08-17,American Tower,19,14,7,40,0.175000
2025-08-17,Ameriprise Financial,21,16,3,40,0.075000
2025-08-17,Amgen,19,15,6,40,0.150000
2025-08-17,Amphenol,16,20,4,40,0.100000
2025-08-17,Analog Devices,18,18,4,40,0.100000
2025-08-17,Apollo Global Management,18,17,5,40,0.125000
2025-08-17,Apple,10,23,7,40,0.175000
2025-08-17,Applied Materials,6,15,19,40,0.475000
2025-08-17,Aramark,19,17,4,40,0.100000
2025-08-17,Archer Daniels Midland,20,15,5,40,0.125000
2025-08-17,Arrow Electronics,20,20,0,40,0.000000
2025-08-17,Arthur J. Gallagher,10,24,6,40,0.150000
2025-08-17,Asbury Automotive,9,25,6,40,0.150000
2025-08-17,Assurant,19,19,2,40,0.050000
2025-08-17,Auto-Owners Insurance,10,27,3,40,0.075000
2025-08-17,AutoNation,14,20,6,40,0.150000
2025-08-17,AutoZone,11,12,17,40,0.425000
2025-08-17,Autoliv,24,15,1,40,0.025000
2025-08-17,Automatic Data Processing,18,17,5,40,0.125000
2025-08-17,Avery Dennison,15,20,5,40,0.125000
2025-08-17,Avis Budget,10,21,9,40,0.225000
2025-08-17,Avnet,15,20,5,40,0.125000
2025-08-17,BJ's Wholesale Club,13,22,5,40,0.125000
2025-08-17,Baker Hughes,16,16,8,40,0.200000
2025-08-17,Ball,15,21,4,40,0.100000
2025-08-17,Bank of America,23,13,4,40,0.100000
2025-08-17,Bank of New York,24,14,2,40,0.050000
2025-08-17,Baxter International,9,20,11,40,0.275000
2025-08-17,Becton Dickinson,16,21,3,40,0.075000
2025-08-17,Berkshire Hathaway,14,24,2,40,0.050000
2025-08-17,Berry Global,11,21,8,40,0.200000
2025-08-17,Best Buy,40,0,0,40,0.000000
2025-08-17,Biogen,19,19,2,40,0.050000
2025-08-17,BlackRock,19,13,8,40,0.200000
2025-08-17,Blackstone,12,17,11,40,0.275000
2025-08-17,Boeing,10,24,6,40,0.150000
2025-08-17,Booking s,4,5,5,14,0.357143
2025-08-17,Booz Allen Hamilton,24,15,1,40,0.025000
2025-08-17,BorgWarner,20,20,0,40,0.000000
2025-08-17,Boston Scientific,18,16,6,40,0.150000
2025-08-17,BrightSpring Health Services,16,21,3,40,0.075000
2025-08-17,Bristol-Myers Squibb,13,19,8,40,0.200000
2025-08-17,Broadcom,16,14,10,40,0.250000
2025-08-17,Builders FirstSource,18,19,3,40,0.075000
2025-08-17,Burlington Stores,14,25,1,40,0.025000
2025-08-17,C.H. Robinson Worldwide,15,21,4,40,0.100000
2025-08-17,CACI International,20,19,1,40,0.025000
2025-08-17,CBRE,17,23,0,40,0.000000
2025-08-17,CDW,21,17,2,40,0.050000
2025-08-17,CHS,19,17,4,40,0.100000
2025-08-17,CMS Energy,38,1,1,40,0.025000
2025-08-17,CSX,12,22,6,40,0.150000
2025-08-17,CVS Health,12,24,4,40,0.100000
2025-08-17,Caesars Entertainment,29,10,1,40,0.025000
2025-08-17,Campbell's,15,17,8,40,0.200000
2025-08-17,Capital One,10,26,4,40,0.100000
2025-08-17,CarMax,8,25,7,40,0.175000
2025-08-17,Cardinal Health,16,16,8,40,0.200000
2025-08-17,Carrier Global,11,25,4,40,0.100000
2025-08-17,Carvana,25,10,5,40,0.125000
2025-08-17,Casey's General Stores,21,15,4,40,0.100000
2025-08-17,Caterpillar,9,23,8,40,0.200000
2025-08-17,Celanese,11,10,19,40,0.475000
2025-08-17,Cencora,21,17,2,40,0.050000
2025-08-17,Centene,11,10,19,40,0.475000
2025-08-17,CenterPoint Energy,25,6,9,40,0.225000
2025-08-17,Charles Schwab,20,18,2,40,0.050000
2025-08-17,Charter Communications,14,11,15,40,0.375000
2025-08-17,Cheniere Energy,36,3,1,40,0.025000
2025-08-17,Chevron,15,20,5,40,0.125000
2025-08-17,Chewy,21,17,2,40,0.050000
2025-08-17,Chipotle Mexican Grill,25,9,6,40,0.150000
2025-08-17,Cigna,23,13,4,40,0.100000
2025-08-17,Cincinnati Financial,20,17,3,40,0.075000
2025-08-17,Cintas,20,17,3,40,0.075000
2025-08-17,Cisco Systems,14,21,5,40,0.125000
2025-08-17,Citi,18,17,5,40,0.125000
2025-08-17,Citizens Financial,20,18,2,40,0.050000
2025-08-17,Cleveland-Cliffs,10,22,8,40,0.200000
2025-08-17,Coca-Cola,19,13,8,40,0.200000
2025-08-17,Cognizant Technology,22,12,6,40,0.150000
2025-08-17,Colgate-Palmolive,19,17,4,40,0.100000
2025-08-17,Comcast,12,23,5,40,0.125000
2025-08-17,Commercial Metals,9,20,11,40,0.275000
2025-08-17,Community Health Systems,17,18,5,40,0.125000
2025-08-17,Conagra Brands,11,25,4,40,0.100000
2025-08-17,Concentrix,19,18,3,40,0.075000
2025-08-17,ConocoPhillips,19,15,6,40,0.150000
2025-08-17,Consolidated Edison,7,30,3,40,0.075000
2025-08-17,Constellation Brands,11,15,14,40,0.350000
2025-08-17,Constellation Energy,38,2,0,40,0.000000
2025-08-17,Core & Main,15,20,5,40,0.125000
2025-08-17,Corebridge Financial,14,20,6,40,0.150000
2025-08-17,Corning,22,15,3,40,0.075000
2025-08-17,Corteva,19,17,4,40,0.100000
2025-08-17,Costco,17,17,6,40,0.150000
2025-08-17,Coupang,21,14,5,40,0.125000
2025-08-17,Cummins,15,23,2,40,0.050000
2025-08-17,D.R. Horton,13,25,2,40,0.050000
2025-08-17,DTE Energy,31,3,6,40,0.150000
2025-08-17,DXC Technology,13,26,1,40,0.025000
2025-08-17,DaVita,23,10,7,40,0.175000
2025-08-17,Danaher,21,15,4,40,0.100000
2025-08-17,Darden Restaurants,18,20,2,40,0.050000
2025-08-17,Deere,10,21,9,40,0.225000
2025-08-17,Delek US,16,13,11,40,0.275000
2025-08-17,Dell Technologies,16,24,0,40,0.000000
2025-08-17,Delta Airlines,9,12,19,40,0.475000
2025-08-17,Devon Energy,34,4,2,40,0.050000
2025-08-17,Diamondback Energy,36,4,0,40,0.000000
2025-08-17,Dick's Sporting Goods,13,22,5,40,0.125000
2025-08-17,Discover Financial,17,18,5,40,0.125000
2025-08-17,Dollar General,9,26,5,40,0.125000
2025-08-17,Dollar Tree,20,18,2,40,0.050000
2025-08-17,Dominion Energy,29,7,4,40,0.100000
2025-08-17,DoorDash,18,14,8,40,0.200000
2025-08-17,Dover,8,19,13,40,0.325000
2025-08-17,DuPont,16,15,9,40,0.225000
2025-08-17,Duke Energy,34,1,5,40,0.125000
2025-08-17,EMCOR,19,20,1,40,0.025000
2025-08-17,EOG Resources,22,16,2,40,0.050000
2025-08-17,Eastman Chemical,6,15,19,40,0.475000
2025-08-17,Ebay,17,21,2,40,0.050000
2025-08-17,EchoStar,14,19,7,40,0.175000
2025-08-17,Ecolab,15,22,3,40,0.075000
2025-08-17,Edison International,14,22,4,40,0.100000
2025-08-17,Edward Jones,16,20,4,40,0.100000
2025-08-17,Electronic Arts,8,24,8,40,0.200000
2025-08-17,Elevance Health,14,16,10,40,0.250000
2025-08-17,Eli Lilly,10,17,13,40,0.325000
2025-08-17,Emerson Electric,22,12,6,40,0.150000
2025-08-17,Endeavor,11,25,4,40,0.100000
2025-08-17,Energy Transfer,33,1,6,40,0.150000
2025-08-17,Entergy,22,17,1,40,0.025000
2025-08-17,Enterprise Products Partners,22,8,10,40,0.250000
2025-08-17,Equinix,18,21,1,40,0.025000
2025-08-17,Equitable,19,18,3,40,0.075000
2025-08-17,Erie Insurance,14,14,12,40,0.300000
2025-08-17,Estée Lauder,12,28,0,40,0.000000
2025-08-17,Eversource Energy,30,4,6,40,0.150000
2025-08-17,Exelon,20,18,2,40,0.050000
2025-08-17,Expedia,23,13,4,40,0.100000
2025-08-17,Expeditors International of Washington,14,22,4,40,0.100000
2025-08-17,Exxon Mobil,18,19,3,40,0.075000
2025-08-17,Fannie Mae,10,25,5,40,0.125000
2025-08-17,Farmers Insurance,9,30,1,40,0.025000
2025-08-17,Fastenal,22,15,3,40,0.075000
2025-08-17,FedEx,23,14,3,40,0.075000
2025-08-17,Ferguson,10,18,12,40,0.300000
2025-08-17,Fidelity National Financial,16,21,3,40,0.075000
2025-08-17,Fidelity National Information,19,16,5,40,0.125000
2025-08-17,Fifth Third Bancorp,18,20,2,40,0.050000
2025-08-17,First Citizens BancShares,20,18,2,40,0.050000
2025-08-17,FirstEnergy,15,16,9,40,0.225000
2025-08-17,Fiserv,11,21,8,40,0.200000
2025-08-17,Fluor,17,11,12,40,0.300000
2025-08-17,Foot Locker,8,26,6,40,0.150000
2025-08-17,Ford Motor,16,20,4,40,0.100000
2025-08-17,Franklin Resources,20,18,2,40,0.050000
2025-08-17,Freddie Mac,10,22,8,40,0.200000
2025-08-17,Freeport-McMoRan,18,16,6,40,0.150000
2025-08-17,GE HealthCare Technologies,16,20,4,40,0.100000
2025-08-17,GE Vernova,21,13,6,40,0.150000
2025-08-17,GXO Logistics,14,23,3,40,0.075000
2025-08-17,General Dynamics,39,1,0,40,0.000000
2025-08-17,General Electric,13,25,2,40,0.050000
2025-08-17,General Mills,18,15,7,40,0.175000
2025-08-17,General Motors,18,16,6,40,0.150000
2025-08-17,Genuine Parts,15,22,3,40,0.075000
2025-08-17,Gilead Sciences,22,13,5,40,0.125000
2025-08-17,Global Partners,15,17,8,40,0.200000
2025-08-17,Global Payments,18,21,1,40,0.025000
2025-08-17,Goldman Sachs,8,21,11,40,0.275000
2025-08-17,Goodyear Tire & Rubber,12,22,6,40,0.150000
2025-08-17,Graphic Packaging,9,28,3,40,0.075000
2025-08-17,Graybar Electric,12,23,5,40,0.125000
2025-08-17,Guardian Life,16,22,2,40,0.050000
2025-08-17,GuideWell Mutual,19,21,0,40,0.000000
2025-08-17,HCA Healthcare,22,9,9,40,0.225000
2025-08-17,HF Sinclair,15,16,9,40,0.225000
2025-08-17,HP,17,18,5,40,0.125000
2025-08-17,Halliburton,21,14,5,40,0.125000
2025-08-17,Hartford Insurance,19,18,3,40,0.075000
2025-08-17,Henry Schein,15,23,2,40,0.050000
2025-08-17,Hershey,12,24,4,40,0.100000
2025-08-17,Hertz,16,10,14,40,0.350000
2025-08-17,Hewlett Packard,11,24,5,40,0.125000
2025-08-17,Hilton,12,22,6,40,0.150000
2025-08-17,Home Depot,7,14,19,40,0.475000
2025-08-17,Honeywell,17,18,5,40,0.125000
2025-08-17,Hormel Foods,15,23,2,40,0.050000
2025-08-17,Howmet Aerospace,16,18,6,40,0.150000
2025-08-17,Humana,24,13,3,40,0.075000
2025-08-17,Huntington Bancshares,16,21,3,40,0.075000
2025-08-17,Huntington Ingalls Industries,19,14,7,40,0.175000
2025-08-17,IBM,8,26,6,40,0.150000
2025-08-17,IQVIA,21,16,3,40,0.075000
2025-08-17,Icahn Enterprises,8,20,12,40,0.300000
2025-08-17,Illinois Tool Works,16,18,6,40,0.150000
2025-08-17,Ingram Micro,13,10,17,40,0.425000
2025-08-17,Ingredion,15,18,7,40,0.175000
2025-08-17,Insight Enterprises,14,18,8,40,0.200000
2025-08-17,Intel,20,18,2,40,0.050000
2025-08-17,Interactive Brokers,14,22,4,40,0.100000
2025-08-17,Intercontinental Exchange,15,22,3,40,0.075000
2025-08-17,International Flavors & Fragrances,22,11,7,40,0.175000
2025-08-17,International Paper,19,21,0,40,0.000000
2025-08-17,Interpublic,13,22,5,40,0.125000
2025-08-17,Intuit,24,13,3,40,0.075000
2025-08-17,Intuitive Surgical,13,19,8,40,0.200000
2025-08-17,J.B. Hunt Transport Services,15,18,7,40,0.175000
2025-08-17,J.M. Smucker,17,17,6,40,0.150000
2025-08-17,JPMorgan Chase,16,18,6,40,0.150000
2025-08-17,Jabil,21,18,1,40,0.025000
2025-08-17,Jacobs Solutions,37,0,3,40,0.075000
2025-08-17,Jefferies Financial,17,16,7,40,0.175000
2025-08-17,JetBlue Airways,13,21,6,40,0.150000
2025-08-17,Johnson & Johnson,17,17,6,40,0.150000
2025-08-17,Jones Lang LaSalle,16,24,0,40,0.000000
2025-08-17,KBR,28,9,3,40,0.075000
2025-08-17,KKR,15,20,5,40,0.125000
2025-08-17,KLA,17,16,7,40,0.175000
2025-08-17,Kellanova,18,17,5,40,0.125000
2025-08-17,Kenvue,15,17,8,40,0.200000
2025-08-17,Keurig Dr Pepper,21,13,6,40,0.150000
2025-08-17,KeyCorp,20,18,2,40,0.050000
2025-08-17,Kimberly-Clark,21,17,2,40,0.050000
2025-08-17,Kinder Morgan,38,1,1,40,0.025000
2025-08-17,Kohl's,13,20,7,40,0.175000
2025-08-17,Kraft Heinz,11,20,9,40,0.225000
2025-08-17,Kroger,12,14,14,40,0.350000
2025-08-17,Kyndryl s,9,4,0,13,0.000000
2025-08-17,L3Harris Technologies,23,16,1,40,0.025000
2025-08-17,LKQ,19,15,6,40,0.150000
2025-08-17,LPL Financial,26,9,5,40,0.125000
2025-08-17,Labcorp,21,15,4,40,0.100000
2025-08-17,Lam Research,15,21,4,40,0.100000
2025-08-17,Land O'Lakes,9,27,4,40,0.100000
2025-08-17,Las Vegas Sands,11,28,1,40,0.025000
2025-08-17,Lear Corporation,22,16,2,40,0.050000
2025-08-17,Leidos,27,13,0,40,0.000000
2025-08-17,Lennar,13,26,1,40,0.025000
2025-08-17,Liberty Mutual Insurance,35,1,4,40,0.100000
2025-08-17,Lincoln National,16,17,7,40,0.175000
2025-08-17,Lithia Motors,20,17,3,40,0.075000
2025-08-17,Live Nation Entertainment,37,2,1,40,0.025000
2025-08-17,Lockheed Martin,22,10,8,40,0.200000
2025-08-17,Loews,18,20,2,40,0.050000
2025-08-17,Lowe's,23,10,7,40,0.175000
2025-08-17,Lululemon athletica,18,17,5,40,0.125000
2025-08-17,Lumen Technologies,8,25,7,40,0.175000
2025-08-17,M&T Bank,14,19,7,40,0.175000
2025-08-17,MGM Resorts International,19,20,1,40,0.025000
2025-08-17,Macy's,16,21,3,40,0.075000
2025-08-17,ManpowerGroup,18,18,4,40,0.100000
2025-08-17,Marathon Petroleum,19,18,3,40,0.075000
2025-08-17,Markel,14,21,5,40,0.125000
2025-08-17,Marriott International,17,20,3,40,0.075000
2025-08-17,Marsh & McLennan,18,18,4,40,0.100000
2025-08-17,MasTec,17,19,4,40,0.100000
2025-08-17,Masco,13,25,2,40,0.050000
2025-08-17,Mass Mutual,10,26,4,40,0.100000
2025-08-17,Mastercard,12,22,6,40,0.150000
2025-08-17,McDonald's,18,10,12,40,0.300000
2025-08-17,McKesson,15,23,2,40,0.050000
2025-08-17,Merck,11,21,8,40,0.200000
2025-08-17,MetLife,14,25,1,40,0.025000
2025-08-17,Meta,16,18,6,40,0.150000
2025-08-17,Microchip Technology,15,24,1,40,0.025000
2025-08-17,Micron Technology,16,19,5,40,0.125000
2025-08-17,Microsoft,13,17,10,40,0.250000
2025-08-17,Mohawk Industries,22,14,4,40,0.100000
2025-08-17,Molina Healthcare,12,20,8,40,0.200000
2025-08-17,Molson Coors Beverage,15,14,11,40,0.275000
2025-08-17,Mondelez,15,18,7,40,0.175000
2025-08-17,Monster Beverage,19,21,0,40,0.000000
2025-08-17,Morgan Stanley,17,21,2,40,0.050000
2025-08-17,Mosaic,19,18,3,40,0.075000
2025-08-17,Motorola Solutions,37,2,1,40,0.025000
2025-08-17,Murphy USA,19,20,1,40,0.025000
2025-08-17,Mutual of Omaha Insurance,20,20,0,40,0.000000
2025-08-17,NOV,13,21,6,40,0.150000
2025-08-17,NRG Energy,36,2,2,40,0.050000
2025-08-17,NVR,20,16,4,40,0.100000
2025-08-17,Nationwide Insurance,10,16,14,40,0.350000
2025-08-17,Netflix,18,13,9,40,0.225000
2025-08-17,New York Life Insurance,14,23,3,40,0.075000
2025-08-17,Newell Brands,12,24,4,40,0.100000
2025-08-17,Newmont,21,13,6,40,0.150000
2025-08-17,News Corp.,15,17,8,40,0.200000
2025-08-17,NextEra Energy,31,3,6,40,0.150000
2025-08-17,Nike,11,20,9,40,0.225000
2025-08-17,Nordstrom,10,27,3,40,0.075000
2025-08-17,Norfolk Southern,8,22,10,40,0.250000
2025-08-17,Northern Trust,38,1,1,40,0.025000
2025-08-17,Northrop Grumman,19,18,3,40,0.075000
2025-08-17,Northwestern Mutual,19,11,10,40,0.250000
2025-08-17,Nucor,15,23,2,40,0.050000
2025-08-17,Nvidia,14,18,8,40,0.200000
2025-08-17,O'Reilly Automotive,19,16,5,40,0.125000
2025-08-17,Occidental Petroleum,29,10,1,40,0.025000
2025-08-17,Old Republic International,22,16,2,40,0.050000
2025-08-17,Omnicom,18,17,5,40,0.125000
2025-08-17,Oneok,20,15,5,40,0.125000
2025-08-17,Oracle,7,23,10,40,0.250000
2025-08-17,Oscar Health,15,18,7,40,0.175000
2025-08-17,Oshkosh,10,22,8,40,0.200000
2025-08-17,Otis Worldwide,17,19,4,40,0.100000
2025-08-17,Ovintiv,21,17,2,40,0.050000
2025-08-17,Owens & Minor,11,22,7,40,0.175000
2025-08-17,Owens Corning,22,12,6,40,0.150000
2025-08-17,PBF Energy,32,1,7,40,0.175000
2025-08-17,PG&E,14,18,8,40,0.200000
2025-08-17,PNC,13,20,7,40,0.175000
2025-08-17,PPG Industries,20,16,4,40,0.100000
2025-08-17,PPL,18,20,2,40,0.050000
2025-08-17,PVH,16,15,9,40,0.225000
2025-08-17,Paccar,17,21,2,40,0.050000
2025-08-17,Pacific Life,18,21,1,40,0.025000
2025-08-17,Packaging Corp. of America,5,29,6,40,0.150000
2025-08-17,Palo Alto Networks,12,26,2,40,0.050000
2025-08-17,Par Pacific,17,19,4,40,0.100000
2025-08-17,Paramount Global,12,23,5,40,0.125000
2025-08-17,Parker-Hannifin,18,19,3,40,0.075000
2025-08-17,PayPal,9,19,12,40,0.300000
2025-08-17,Penske Automotive,15,24,1,40,0.025000
2025-08-17,PepsiCo,17,20,3,40,0.075000
2025-08-17,Performance Food,18,18,4,40,0.100000
2025-08-17,Peter Kiewit Sons',5,20,15,40,0.375000
2025-08-17,Pfizer,10,17,13,40,0.325000
2025-08-17,Philip Morris,13,22,5,40,0.125000
2025-08-17,Phillips 66,17,15,8,40,0.200000
2025-08-17,Plains GP,17,17,6,40,0.150000
2025-08-17,Principal Financial,16,22,2,40,0.050000
2025-08-17,Procter & Gamble,17,16,7,40,0.175000
2025-08-17,Progressive Insurance,16,20,4,40,0.100000
2025-08-17,Prologis,14,21,5,40,0.125000
2025-08-17,Prudential Financial,12,25,3,40,0.075000
2025-08-17,Public Service Enterprise,18,20,2,40,0.050000
2025-08-17,Publix Super Markets,18,17,5,40,0.125000
2025-08-17,Pulte,8,20,12,40,0.300000
2025-08-17,QVC,13,22,5,40,0.125000
2025-08-17,QXO Building Products,2,5,3,10,0.300000
2025-08-17,Qualcomm,22,13,5,40,0.125000
2025-08-17,Quanta Services,16,16,8,40,0.200000
2025-08-17,Quest Diagnostics,18,18,4,40,0.100000
2025-08-17,RTX,15,17,8,40,0.200000
2025-08-17,Raymond James Financial,16,23,1,40,0.025000
2025-08-17,Regeneron Pharmaceuticals,17,18,5,40,0.125000
2025-08-17,Regions Financial,20,20,0,40,0.000000
2025-08-17,Reinsurance of America,0,5,1,6,0.166667
2025-08-17,Reliance,12,17,11,40,0.275000
2025-08-17,Republic Services,9,13,18,40,0.450000
2025-08-17,Rockwell Automation,19,19,2,40,0.050000
2025-08-17,Ross Stores,17,21,2,40,0.050000
2025-08-17,Rush Enterprises,16,20,4,40,0.100000
2025-08-17,Ryder System,23,14,3,40,0.075000
2025-08-17,S&P Global,10,25,5,40,0.125000
2025-08-17,Salesforce,19,14,7,40,0.175000
2025-08-17,Sanmina,15,23,2,40,0.050000
2025-08-17,Science Applications International,12,24,4,40,0.100000
2025-08-17,Seaboard,6,25,9,40,0.225000
2025-08-17,Securian Financial,13,22,5,40,0.125000
2025-08-17,Sempra,26,14,0,40,0.000000
2025-08-17,ServiceNow,20,18,2,40,0.050000
2025-08-17,Sherwin-Williams,10,17,13,40,0.325000
2025-08-17,Sirius XM,14,23,3,40,0.075000
2025-08-17,Skechers,15,21,4,40,0.100000
2025-08-17,Solventum,17,21,2,40,0.050000
2025-08-17,Sonic Automotive,6,31,3,40,0.075000
2025-08-17,Southern,8,24,8,40,0.200000
2025-08-17,Southwest Airlines,11,16,13,40,0.325000
2025-08-17,SpartanNash,18,21,1,40,0.025000
2025-08-17,Sprouts Farmers Market,15,22,3,40,0.075000
2025-08-17,Stanley Black & Decker,9,23,8,40,0.200000
2025-08-17,Starbucks,8,21,11,40,0.275000
2025-08-17,State Farm,14,15,11,40,0.275000
2025-08-17,State Street,11,19,10,40,0.250000
2025-08-17,Steel Dynamics,33,3,4,40,0.100000
2025-08-17,StoneX,19,18,3,40,0.075000
2025-08-17,Stryker,15,16,9,40,0.225000
2025-08-17,Synchrony Financial,21,13,6,40,0.150000
2025-08-17,Sysco,20,12,8,40,0.200000
2025-08-17,TD Synnex,22,18,0,40,0.000000
2025-08-17,THOR Industries,18,18,4,40,0.100000
2025-08-17,TIAA,11,25,4,40,0.100000
2025-08-17,TJX,18,19,3,40,0.075000
2025-08-17,Targa Resources,17,18,5,40,0.125000
2025-08-17,Target,16,16,8,40,0.200000
2025-08-17,Taylor Morrison Home,16,23,1,40,0.025000
2025-08-17,Tenet Healthcare,15,19,6,40,0.150000
2025-08-17,Tesla,11,18,11,40,0.275000
2025-08-17,Texas Instruments,9,20,11,40,0.275000
2025-08-17,Textron,13,26,1,40,0.025000
2025-08-17,The Andersons,12,26,2,40,0.050000
2025-08-17,Thermo Fisher Scientific,21,17,2,40,0.050000
2025-08-17,Thrivent Financial for Lutherans,18,18,4,40,0.100000
2025-08-17,Toll Brothers,8,31,1,40,0.025000
2025-08-17,Tractor Supply,20,19,1,40,0.025000
2025-08-17,TransDigm,21,17,2,40,0.050000
2025-08-17,Travelers Insurance,12,18,10,40,0.250000
2025-08-17,Truist Financial,19,19,2,40,0.050000
2025-08-17,Tyson Foods,11,26,3,40,0.075000
2025-08-17,U.S. Bancorp,20,15,5,40,0.125000
2025-08-17,UPS,13,16,11,40,0.275000
2025-08-17,US Foods,22,15,3,40,0.075000
2025-08-17,USAA,16,11,13,40,0.325000
2025-08-17,Uber,7,15,18,40,0.450000
2025-08-17,Ulta Beauty,33,5,2,40,0.050000
2025-08-17,Union Pacific,10,17,13,40,0.325000
2025-08-17,United Airlines,27,4,9,40,0.225000
2025-08-17,United Natural Foods,37,1,2,40,0.050000
2025-08-17,United Rentals,35,5,0,40,0.000000
2025-08-17,United States Steel,22,8,10,40,0.250000
2025-08-17,UnitedHealth,13,22,5,40,0.125000
2025-08-17,Universal Health Services,18,15,7,40,0.175000
2025-08-17,Unum,18,17,5,40,0.125000
2025-08-17,VF Corporation,16,18,6,40,0.150000
2025-08-17,Valero Energy,36,1,3,40,0.075000
2025-08-17,Verizon,18,17,5,40,0.125000
2025-08-17,Vertex Pharmaceuticals,16,16,8,40,0.200000
2025-08-17,Vertiv,24,11,5,40,0.125000
2025-08-17,Viatris,14,17,9,40,0.225000
2025-08-17,Vistra,21,11,8,40,0.200000
2025-08-17,Voya Financial,16,20,4,40,0.100000
2025-08-17,Vulcan Materials,12,17,11,40,0.275000
2025-08-17,W.R. Berkley,15,17,8,40,0.200000
2025-08-17,W.W. Grainger,12,22,6,40,0.150000
2025-08-17,WEC Energy,39,1,0,40,0.000000
2025-08-17,WESCO International,20,19,1,40,0.025000
2025-08-17,Walgreens,7,18,15,40,0.375000
2025-08-17,Walmart,14,19,7,40,0.175000
2025-08-17,Walt Disney,14,18,8,40,0.200000
2025-08-17,Warner Bros. Discovery,16,23,1,40,0.025000
2025-08-17,Watsco,12,21,7,40,0.175000
2025-08-17,Wayfair,15,22,3,40,0.075000
2025-08-17,Wells Fargo,35,1,4,40,0.100000
2025-08-17,Welltower,20,19,1,40,0.025000
2025-08-17,Western & Southern Financial,13,23,4,40,0.100000
2025-08-17,Western Digital,15,22,3,40,0.075000
2025-08-17,Westinghouse Air Brake Technologies,20,18,2,40,0.050000
2025-08-17,Whirlpool,11,23,6,40,0.150000
2025-08-17,Williams,19,17,4,40,0.100000
2025-08-17,Williams-Sonoma,15,23,2,40,0.050000
2025-08-17,Workday,14,19,7,40,0.175000
2025-08-17,World Kinect,11,21,8,40,0.200000
2025-08-17,XPO,9,22,9,40,0.225000
2025-08-17,Xcel Energy,35,1,4,40,0.100000
2025-08-17,Xylem,20,17,3,40,0.075000
2025-08-17,Yum Brands,24,10,6,40,0.150000
2025-08-17,Yum China,18,18,4,40,0.100000
2025-08-17,Zimmer Biomet,19,19,2,40,0.050000
2025-08-17,Zoetis,25,13,2,40,0.050000
2025-08-19,1 Automotive,17,21,2,40,0.050000
2025-08-19,3M,22,17,1,40,0.025000
2025-08-19,A-Mark Precious Metals,36,4,0,40,0.000000
2025-08-19,ABM Industries,10,25,5,40,0.125000
2025-08-19,AECOM,25,14,1,40,0.025000
2025-08-19,AES,18,11,11,40,0.275000
2025-08-19,AGCO,12,23,5,40,0.125000
2025-08-19,AIG,11,25,4,40,0.100000
2025-08-19,APA,14,18,8,40,0.200000
2025-08-19,ARKO,10,26,4,40,0.100000
2025-08-19,AT&T,6,24,10,40,0.250000
2025-08-19,AbbVie,19,19,2,40,0.050000
2025-08-19,Abbott Laboratories,18,18,4,40,0.100000
2025-08-19,Ace Hardware,14,21,5,40,0.125000
2025-08-19,Adobe,13,22,5,40,0.125000
2025-08-19,Advance Auto Parts,11,18,11,40,0.275000
2025-08-19,Advanced Micro Devices,30,2,8,40,0.200000
2025-08-19,Aflac,13,16,11,40,0.275000
2025-08-19,Air Products & Chemicals,19,16,5,40,0.125000
2025-08-19,Airbnb,13,17,10,40,0.250000
2025-08-19,Alaska Air,11,25,4,40,0.100000
2025-08-19,Albertsons,18,16,6,40,0.150000
2025-08-19,Alcoa,10,22,8,40,0.200000
2025-08-19,Allstate,20,16,4,40,0.100000
2025-08-19,Ally Financial,15,24,1,40,0.025000
2025-08-19,Alphabet,17,14,9,40,0.225000
2025-08-19,Altice,11,20,9,40,0.225000
2025-08-19,Altria,19,18,3,40,0.075000
2025-08-19,Amazon,33,4,3,40,0.075000
2025-08-19,American Airlines,7,12,21,40,0.525000
2025-08-19,American Electric Power,19,19,2,40,0.050000
2025-08-19,American Express,18,19,3,40,0.075000
2025-08-19,American Family Insurance,25,11,4,40,0.100000
2025-08-19,American Financial,12,25,3,40,0.075000
2025-08-19,American International,11,25,4,40,0.100000
2025-08-19,American Tower,13,20,7,40,0.175000
2025-08-19,Ameriprise Financial,20,17,3,40,0.075000
2025-08-19,Amgen,21,14,5,40,0.125000
2025-08-19,Amphenol,17,18,5,40,0.125000
2025-08-19,Analog Devices,16,17,7,40,0.175000
2025-08-19,Apollo Global Management,16,21,3,40,0.075000
2025-08-19,Apple,14,17,9,40,0.225000
2025-08-19,Applied Materials,6,16,18,40,0.450000
2025-08-19,Aramark,20,16,4,40,0.100000
2025-08-19,Archer Daniels Midland,20,15,5,40,0.125000
2025-08-19,Arrow Electronics,17,22,1,40,0.025000
2025-08-19,Arthur J. Gallagher,8,29,3,40,0.075000
2025-08-19,Asbury Automotive,12,22,6,40,0.150000
2025-08-19,Assurant,20,18,2,40,0.050000
2025-08-19,Auto-Owners Insurance,10,26,4,40,0.100000
2025-08-19,AutoNation,12,22,6,40,0.150000
2025-08-19,AutoZone,12,12,16,40,0.400000
2025-08-19,Autoliv,19,20,1,40,0.025000
2025-08-19,Automatic Data Processing,20,16,4,40,0.100000
2025-08-19,Avery Dennison,11,22,7,40,0.175000
2025-08-19,Avis Budget,12,23,5,40,0.125000
2025-08-19,Avnet,17,20,3,40,0.075000
2025-08-19,BJ's Wholesale Club,12,22,6,40,0.150000
2025-08-19,Baker Hughes,18,14,8,40,0.200000
2025-08-19,Ball,14,19,7,40,0.175000
2025-08-19,Bank of America,20,15,5,40,0.125000
2025-08-19,Bank of New York,23,15,2,40,0.050000
2025-08-19,Baxter International,7,22,11,40,0.275000
2025-08-19,Becton Dickinson,16,21,3,40,0.075000
2025-08-19,Berkshire Hathaway,13,23,4,40,0.100000
2025-08-19,Berry Global,12,20,8,40,0.200000
2025-08-19,Best Buy,39,1,0,40,0.000000
2025-08-19,Biogen,17,20,3,40,0.075000
2025-08-19,BlackRock,10,26,4,40,0.100000
2025-08-19,Blackstone,16,16,8,40,0.200000
2025-08-19,Boeing,13,17,10,40,0.250000
2025-08-19,Booking s,5,6,5,16,0.312500
2025-08-19,Booz Allen Hamilton,20,16,4,40,0.100000
2025-08-19,BorgWarner,21,19,0,40,0.000000
2025-08-19,Boston Scientific,18,18,4,40,0.100000
2025-08-19,BrightSpring Health Services,14,22,4,40,0.100000
2025-08-19,Bristol-Myers Squibb,12,22,6,40,0.150000
2025-08-19,Broadcom,18,19,3,40,0.075000
2025-08-19,Builders FirstSource,12,25,3,40,0.075000
2025-08-19,Burlington Stores,14,25,1,40,0.025000
2025-08-19,C.H. Robinson Worldwide,15,21,4,40,0.100000
2025-08-19,CACI International,23,17,0,40,0.000000
2025-08-19,CBRE,15,25,0,40,0.000000
2025-08-19,CDW,22,18,0,40,0.000000
2025-08-19,CHS,16,20,4,40,0.100000
2025-08-19,CMS Energy,39,0,1,40,0.025000
2025-08-19,CSX,6,15,19,40,0.475000
2025-08-19,CVS Health,16,21,3,40,0.075000
2025-08-19,Caesars Entertainment,33,7,0,40,0.000000
2025-08-19,Campbell's,16,17,7,40,0.175000
2025-08-19,Capital One,15,20,5,40,0.125000
2025-08-19,CarMax,9,24,7,40,0.175000
2025-08-19,Cardinal Health,18,16,6,40,0.150000
2025-08-19,Carrier Global,10,24,6,40,0.150000
2025-08-19,Carvana,19,17,4,40,0.100000
2025-08-19,Casey's General Stores,20,17,3,40,0.075000
2025-08-19,Caterpillar,9,24,7,40,0.175000
2025-08-19,Celanese,11,12,17,40,0.425000
2025-08-19,Cencora,20,17,3,40,0.075000
2025-08-19,Centene,13,8,19,40,0.475000
2025-08-19,CenterPoint Energy,29,6,5,40,0.125000
2025-08-19,Charles Schwab,22,16,2,40,0.050000
2025-08-19,Charter Communications,16,11,13,40,0.325000
2025-08-19,Cheniere Energy,37,1,2,40,0.050000
2025-08-19,Chevron,17,16,7,40,0.175000
2025-08-19,Chewy,22,16,2,40,0.050000
2025-08-19,Chipotle Mexican Grill,21,16,3,40,0.075000
2025-08-19,Cigna,20,15,5,40,0.125000
2025-08-19,Cincinnati Financial,14,19,7,40,0.175000
2025-08-19,Cintas,19,16,5,40,0.125000
2025-08-19,Cisco Systems,16,19,5,40,0.125000
2025-08-19,Citi,17,15,8,40,0.200000
2025-08-19,Citizens Financial,21,17,2,40,0.050000
2025-08-19,Cleveland-Cliffs,13,21,6,40,0.150000
2025-08-19,Coca-Cola,18,18,4,40,0.100000
2025-08-19,Cognizant Technology,23,11,6,40,0.150000
2025-08-19,Colgate-Palmolive,22,13,5,40,0.125000
2025-08-19,Comcast,13,19,8,40,0.200000
2025-08-19,Commercial Metals,10,20,10,40,0.250000
2025-08-19,Community Health Systems,17,17,6,40,0.150000
2025-08-19,Conagra Brands,12,24,4,40,0.100000
2025-08-19,Concentrix,17,18,5,40,0.125000
2025-08-19,ConocoPhillips,19,15,6,40,0.150000
2025-08-19,Consolidated Edison,6,30,4,40,0.100000
2025-08-19,Constellation Brands,10,20,10,40,0.250000
2025-08-19,Constellation Energy,36,4,0,40,0.000000
2025-08-19,Core & Main,12,23,5,40,0.125000
2025-08-19,Corebridge Financial,13,23,4,40,0.100000
2025-08-19,Corning,13,23,4,40,0.100000
2025-08-19,Corteva,21,16,3,40,0.075000
2025-08-19,Costco,14,18,8,40,0.200000
2025-08-19,Coupang,23,15,2,40,0.050000
2025-08-19,Cummins,18,17,5,40,0.125000
2025-08-19,D.R. Horton,10,28,2,40,0.050000
2025-08-19,DTE Energy,35,1,4,40,0.100000
2025-08-19,DXC Technology,13,26,1,40,0.025000
2025-08-19,DaVita,22,11,7,40,0.175000
2025-08-19,Danaher,21,18,1,40,0.025000
2025-08-19,Darden Restaurants,16,21,3,40,0.075000
2025-08-19,Deere,4,31,5,40,0.125000
2025-08-19,Delek US,13,15,12,40,0.300000
2025-08-19,Dell Technologies,10,29,1,40,0.025000
2025-08-19,Delta Airlines,7,17,16,40,0.400000
2025-08-19,Devon Energy,36,2,2,40,0.050000
2025-08-19,Diamondback Energy,35,1,4,40,0.100000
2025-08-19,Dick's Sporting Goods,12,23,5,40,0.125000
2025-08-19,Discover Financial,18,17,5,40,0.125000
2025-08-19,Dollar General,8,18,14,40,0.350000
2025-08-19,Dollar Tree,16,21,3,40,0.075000
2025-08-19,Dominion Energy,33,4,3,40,0.075000
2025-08-19,DoorDash,21,15,4,40,0.100000
2025-08-19,Dover,6,20,14,40,0.350000
2025-08-19,DuPont,11,25,4,40,0.100000
2025-08-19,Duke Energy,39,1,0,40,0.000000
2025-08-19,EMCOR,16,23,1,40,0.025000
2025-08-19,EOG Resources,28,10,2,40,0.050000
2025-08-19,Eastman Chemical,4,20,16,40,0.400000
2025-08-19,Ebay,17,19,4,40,0.100000
2025-08-19,EchoStar,14,17,9,40,0.225000
2025-08-19,Ecolab,14,22,4,40,0.100000
2025-08-19,Edison International,11,24,5,40,0.125000
2025-08-19,Edward Jones,13,23,4,40,0.100000
2025-08-19,Electronic Arts,7,23,10,40,0.250000
2025-08-19,Elevance Health,18,13,9,40,0.225000
2025-08-19,Eli Lilly,13,20,7,40,0.175000
2025-08-19,Emerson Electric,20,11,9,40,0.225000
2025-08-19,Endeavor,10,26,4,40,0.100000
2025-08-19,Energy Transfer,34,3,3,40,0.075000
2025-08-19,Entergy,18,18,4,40,0.100000
2025-08-19,Enterprise Products Partners,23,10,7,40,0.175000
2025-08-19,Equinix,20,19,1,40,0.025000
2025-08-19,Equitable,18,18,4,40,0.100000
2025-08-19,Erie Insurance,16,14,10,40,0.250000
2025-08-19,Estée Lauder,11,27,2,40,0.050000
2025-08-19,Eversource Energy,32,3,5,40,0.125000
2025-08-19,Exelon,19,17,4,40,0.100000
2025-08-19,Expedia,21,17,2,40,0.050000
2025-08-19,Expeditors International of Washington,13,23,4,40,0.100000
2025-08-19,Exxon Mobil,19,18,3,40,0.075000
2025-08-19,Fannie Mae,8,24,8,40,0.200000
2025-08-19,Farmers Insurance,9,30,1,40,0.025000
2025-08-19,Fastenal,26,12,2,40,0.050000
2025-08-19,FedEx,27,7,6,40,0.150000
2025-08-19,Ferguson,10,18,12,40,0.300000
2025-08-19,Fidelity National Financial,14,23,3,40,0.075000
2025-08-19,Fidelity National Information,21,15,4,40,0.100000
2025-08-19,Fifth Third Bancorp,26,14,0,40,0.000000
2025-08-19,First Citizens BancShares,23,15,2,40,0.050000
2025-08-19,FirstEnergy,14,14,12,40,0.300000
2025-08-19,Fiserv,12,22,6,40,0.150000
2025-08-19,Fluor,15,17,8,40,0.200000
2025-08-19,Foot Locker,6,28,6,40,0.150000
2025-08-19,Ford Motor,16,18,6,40,0.150000
2025-08-19,Franklin Resources,19,17,4,40,0.100000
2025-08-19,Freddie Mac,8,23,9,40,0.225000
2025-08-19,Freeport-McMoRan,20,18,2,40,0.050000
2025-08-19,GE HealthCare Technologies,14,22,4,40,0.100000
2025-08-19,GE Vernova,22,16,2,40,0.050000
2025-08-19,GXO Logistics,14,22,4,40,0.100000
2025-08-19,General Dynamics,40,0,0,40,0.000000
2025-08-19,General Electric,11,27,2,40,0.050000
2025-08-19,General Mills,18,18,4,40,0.100000
2025-08-19,General Motors,13,23,4,40,0.100000
2025-08-19,Genuine Parts,22,14,4,40,0.100000
2025-08-19,Gilead Sciences,19,17,4,40,0.100000
2025-08-19,Global Partners,18,13,9,40,0.225000
2025-08-19,Global Payments,17,23,0,40,0.000000
2025-08-19,Goldman Sachs,13,12,15,40,0.375000
2025-08-19,Goodyear Tire & Rubber,9,24,7,40,0.175000
2025-08-19,Graphic Packaging,9,28,3,40,0.075000
2025-08-19,Graybar Electric,13,21,6,40,0.150000
2025-08-19,Guardian Life,16,22,2,40,0.050000
2025-08-19,GuideWell Mutual,19,20,1,40,0.025000
2025-08-19,HCA Healthcare,24,7,9,40,0.225000
2025-08-19,HF Sinclair,17,15,8,40,0.200000
2025-08-19,HP,15,22,3,40,0.075000
2025-08-19,Halliburton,17,15,8,40,0.200000
2025-08-19,Hartford Insurance,21,16,3,40,0.075000
2025-08-19,Henry Schein,16,23,1,40,0.025000
2025-08-19,Hershey,11,27,2,40,0.050000
2025-08-19,Hertz,19,11,10,40,0.250000
2025-08-19,Hewlett Packard,12,23,5,40,0.125000
2025-08-19,Hilton,7,29,4,40,0.100000
2025-08-19,Home Depot,6,21,13,40,0.325000
2025-08-19,Honeywell,17,21,2,40,0.050000
2025-08-19,Hormel Foods,14,22,4,40,0.100000
2025-08-19,Howmet Aerospace,16,18,6,40,0.150000
2025-08-19,Humana,24,12,4,40,0.100000
2025-08-19,Huntington Bancshares,17,21,2,40,0.050000
2025-08-19,Huntington Ingalls Industries,26,11,3,40,0.075000
2025-08-19,IBM,15,22,3,40,0.075000
2025-08-19,IQVIA,21,14,5,40,0.125000
2025-08-19,Icahn Enterprises,11,19,10,40,0.250000
2025-08-19,Illinois Tool Works,15,20,5,40,0.125000
2025-08-19,Ingram Micro,11,11,18,40,0.450000
2025-08-19,Ingredion,17,18,5,40,0.125000
2025-08-19,Insight Enterprises,15,18,7,40,0.175000
2025-08-19,Intel,10,26,4,40,0.100000
2025-08-19,Interactive Brokers,14,21,5,40,0.125000
2025-08-19,Intercontinental Exchange,19,19,2,40,0.050000
2025-08-19,International Flavors & Fragrances,23,10,7,40,0.175000
2025-08-19,International Paper,17,21,2,40,0.050000
2025-08-19,Interpublic,14,20,6,40,0.150000
2025-08-19,Intuit,21,17,2,40,0.050000
2025-08-19,Intuitive Surgical,11,20,9,40,0.225000
2025-08-19,J.B. Hunt Transport Services,15,17,8,40,0.200000
2025-08-19,J.M. Smucker,13,21,6,40,0.150000
2025-08-19,JPMorgan Chase,22,15,3,40,0.075000
2025-08-19,Jabil,24,14,2,40,0.050000
2025-08-19,Jacobs Solutions,37,0,3,40,0.075000
2025-08-19,Jefferies Financial,15,17,8,40,0.200000
2025-08-19,JetBlue Airways,13,21,6,40,0.150000
2025-08-19,Johnson & Johnson,22,15,3,40,0.075000
2025-08-19,Jones Lang LaSalle,19,21,0,40,0.000000
2025-08-19,KBR,31,8,1,40,0.025000
2025-08-19,KKR,11,23,6,40,0.150000
2025-08-19,KLA,17,16,7,40,0.175000
2025-08-19,Kellanova,19,15,6,40,0.150000
2025-08-19,Kenvue,15,19,6,40,0.150000
2025-08-19,Keurig Dr Pepper,18,15,7,40,0.175000
2025-08-19,KeyCorp,20,18,2,40,0.050000
2025-08-19,Kimberly-Clark,19,18,3,40,0.075000
2025-08-19,Kinder Morgan,39,0,1,40,0.025000
2025-08-19,Kohl's,10,20,10,40,0.250000
2025-08-19,Kraft Heinz,13,19,8,40,0.200000
2025-08-19,Kroger,8,23,9,40,0.225000
2025-08-19,Kyndryl s,8,4,0,12,0.000000
2025-08-19,L3Harris Technologies,21,16,3,40,0.075000
2025-08-19,LKQ,23,13,4,40,0.100000
2025-08-19,LPL Financial,24,13,3,40,0.075000
2025-08-19,Labcorp,20,15,5,40,0.125000
2025-08-19,Lam Research,17,17,6,40,0.150000
2025-08-19,Land O'Lakes,11,27,2,40,0.050000
2025-08-19,Las Vegas Sands,14,25,1,40,0.025000
2025-08-19,Lear Corporation,24,15,1,40,0.025000
2025-08-19,Leidos,25,15,0,40,0.000000
2025-08-19,Lennar,14,24,2,40,0.050000
2025-08-19,Liberty Mutual Insurance,36,0,4,40,0.100000
2025-08-19,Lincoln National,14,16,10,40,0.250000
2025-08-19,Lithia Motors,21,16,3,40,0.075000
2025-08-19,Live Nation Entertainment,35,4,1,40,0.025000
2025-08-19,Lockheed Martin,24,8,8,40,0.200000
2025-08-19,Loews,20,18,2,40,0.050000
2025-08-19,Lowe's,15,17,8,40,0.200000
2025-08-19,Lululemon athletica,16,16,8,40,0.200000
2025-08-19,Lumen Technologies,9,25,6,40,0.150000
2025-08-19,M&T Bank,14,21,5,40,0.125000
2025-08-19,MGM Resorts International,14,26,0,40,0.000000
2025-08-19,Macy's,19,18,3,40,0.075000
2025-08-19,ManpowerGroup,21,16,3,40,0.075000
2025-08-19,Marathon Petroleum,15,23,2,40,0.050000
2025-08-19,Markel,10,22,8,40,0.200000
2025-08-19,Marriott International,16,22,2,40,0.050000
2025-08-19,Marsh & McLennan,21,14,5,40,0.125000
2025-08-19,MasTec,18,18,4,40,0.100000
2025-08-19,Masco,11,27,2,40,0.050000
2025-08-19,Mass Mutual,11,25,4,40,0.100000
2025-08-19,Mastercard,17,21,2,40,0.050000
2025-08-19,McDonald's,22,12,6,40,0.150000
2025-08-19,McKesson,18,19,3,40,0.075000
2025-08-19,Merck,14,20,6,40,0.150000
2025-08-19,MetLife,15,23,2,40,0.050000
2025-08-19,Meta,12,21,7,40,0.175000
2025-08-19,Microchip Technology,18,19,3,40,0.075000
2025-08-19,Micron Technology,12,22,6,40,0.150000
2025-08-19,Microsoft,11,19,10,40,0.250000
2025-08-19,Mohawk Industries,17,18,5,40,0.125000
2025-08-19,Molina Healthcare,15,15,10,40,0.250000
2025-08-19,Molson Coors Beverage,22,11,7,40,0.175000
2025-08-19,Mondelez,17,14,9,40,0.225000
2025-08-19,Monster Beverage,17,23,0,40,0.000000
2025-08-19,Morgan Stanley,18,20,2,40,0.050000
2025-08-19,Mosaic,16,21,3,40,0.075000
2025-08-19,Motorola Solutions,37,2,1,40,0.025000
2025-08-19,Murphy USA,18,21,1,40,0.025000
2025-08-19,Mutual of Omaha Insurance,20,20,0,40,0.000000
2025-08-19,NOV,9,27,4,40,0.100000
2025-08-19,NRG Energy,34,4,2,40,0.050000
2025-08-19,NVR,22,14,4,40,0.100000
2025-08-19,Nationwide Insurance,11,17,12,40,0.300000
2025-08-19,Netflix,12,24,4,40,0.100000
2025-08-19,New York Life Insurance,15,22,3,40,0.075000
2025-08-19,Newell Brands,13,23,4,40,0.100000
2025-08-19,Newmont,21,14,5,40,0.125000
2025-08-19,News Corp.,18,16,6,40,0.150000
2025-08-19,NextEra Energy,30,3,7,40,0.175000
2025-08-19,Nike,11,22,7,40,0.175000
2025-08-19,Nordstrom,14,21,5,40,0.125000
2025-08-19,Norfolk Southern,15,17,8,40,0.200000
2025-08-19,Northern Trust,38,1,1,40,0.025000
2025-08-19,Northrop Grumman,17,19,4,40,0.100000
2025-08-19,Northwestern Mutual,17,14,9,40,0.225000
2025-08-19,Nucor,14,24,2,40,0.050000
2025-08-19,Nvidia,11,22,7,40,0.175000
2025-08-19,O'Reilly Automotive,12,25,3,40,0.075000
2025-08-19,Occidental Petroleum,22,15,3,40,0.075000
2025-08-19,Old Republic International,21,16,3,40,0.075000
2025-08-19,Omnicom,20,16,4,40,0.100000
2025-08-19,Oneok,24,14,2,40,0.050000
2025-08-19,Oracle,11,20,9,40,0.225000
2025-08-19,Oscar Health,12,21,7,40,0.175000
2025-08-19,Oshkosh,7,25,8,40,0.200000
2025-08-19,Otis Worldwide,20,18,2,40,0.050000
2025-08-19,Ovintiv,22,16,2,40,0.050000
2025-08-19,Owens & Minor,8,25,7,40,0.175000
2025-08-19,Owens Corning,22,12,6,40,0.150000
2025-08-19,PBF Energy,33,2,5,40,0.125000
2025-08-19,PG&E,19,14,7,40,0.175000
2025-08-19,PNC,20,13,7,40,0.175000
2025-08-19,PPG Industries,17,17,6,40,0.150000
2025-08-19,PPL,14,25,1,40,0.025000
2025-08-19,PVH,14,15,11,40,0.275000
2025-08-19,Paccar,19,20,1,40,0.025000
2025-08-19,Pacific Life,17,22,1,40,0.025000
2025-08-19,Packaging Corp. of America,6,28,6,40,0.150000
2025-08-19,Palo Alto Networks,13,25,2,40,0.050000
2025-08-19,Par Pacific,18,20,2,40,0.050000
2025-08-19,Paramount Global,12,25,3,40,0.075000
2025-08-19,Parker-Hannifin,20,18,2,40,0.050000
2025-08-19,PayPal,9,13,18,40,0.450000
2025-08-19,Penske Automotive,14,24,2,40,0.050000
2025-08-19,PepsiCo,15,18,7,40,0.175000
2025-08-19,Performance Food,16,20,4,40,0.100000
2025-08-19,Peter Kiewit Sons',6,19,15,40,0.375000
2025-08-19,Pfizer,11,17,12,40,0.300000
2025-08-19,Philip Morris,22,18,0,40,0.000000
2025-08-19,Phillips 66,14,20,6,40,0.150000
2025-08-19,Plains GP,18,17,5,40,0.125000
2025-08-19,Principal Financial,15,24,1,40,0.025000
2025-08-19,Procter & Gamble,15,18,7,40,0.175000
2025-08-19,Progressive Insurance,17,19,4,40,0.100000
2025-08-19,Prologis,17,19,4,40,0.100000
2025-08-19,Prudential Financial,18,19,3,40,0.075000
2025-08-19,Public Service Enterprise,17,20,3,40,0.075000
2025-08-19,Publix Super Markets,21,15,4,40,0.100000
2025-08-19,Pulte,8,19,13,40,0.325000
2025-08-19,QVC,13,22,5,40,0.125000
2025-08-19,QXO Building Products,2,5,3,10,0.300000
2025-08-19,Qualcomm,24,11,5,40,0.125000
2025-08-19,Quanta Services,18,11,11,40,0.275000
2025-08-19,Quest Diagnostics,11,24,5,40,0.125000
2025-08-19,RTX,19,13,8,40,0.200000
2025-08-19,Raymond James Financial,15,19,6,40,0.150000
2025-08-19,Regeneron Pharmaceuticals,18,19,3,40,0.075000
2025-08-19,Regions Financial,20,20,0,40,0.000000
2025-08-19,Reinsurance of America,0,5,1,6,0.166667
2025-08-19,Reliance,17,15,8,40,0.200000
2025-08-19,Republic Services,12,12,16,40,0.400000
2025-08-19,Rockwell Automation,13,22,5,40,0.125000
2025-08-19,Ross Stores,15,21,4,40,0.100000
2025-08-19,Rush Enterprises,18,20,2,40,0.050000
2025-08-19,Ryder System,25,13,2,40,0.050000
2025-08-19,S&P Global,14,20,6,40,0.150000
2025-08-19,Salesforce,10,18,12,40,0.300000
2025-08-19,Sanmina,12,25,3,40,0.075000
2025-08-19,Science Applications International,14,22,4,40,0.100000
2025-08-19,Seaboard,9,24,7,40,0.175000
2025-08-19,Securian Financial,14,21,5,40,0.125000
2025-08-19,Sempra,32,7,1,40,0.025000
2025-08-19,ServiceNow,13,24,3,40,0.075000
2025-08-19,Sherwin-Williams,10,17,13,40,0.325000
2025-08-19,Sirius XM,18,15,7,40,0.175000
2025-08-19,Skechers,19,20,1,40,0.025000
2025-08-19,Solventum,17,21,2,40,0.050000
2025-08-19,Sonic Automotive,5,31,4,40,0.100000
2025-08-19,Southern,9,20,11,40,0.275000
2025-08-19,Southwest Airlines,7,19,14,40,0.350000
2025-08-19,SpartanNash,16,20,4,40,0.100000
2025-08-19,Sprouts Farmers Market,20,19,1,40,0.025000
2025-08-19,Stanley Black & Decker,9,26,5,40,0.125000
2025-08-19,Starbucks,8,25,7,40,0.175000
2025-08-19,State Farm,10,13,17,40,0.425000
2025-08-19,State Street,13,18,9,40,0.225000
2025-08-19,Steel Dynamics,36,1,3,40,0.075000
2025-08-19,StoneX,19,19,2,40,0.050000
2025-08-19,Stryker,14,18,8,40,0.200000
2025-08-19,Synchrony Financial,23,14,3,40,0.075000
2025-08-19,Sysco,17,15,8,40,0.200000
2025-08-19,TD Synnex,21,19,0,40,0.000000
2025-08-19,THOR Industries,16,19,5,40,0.125000
2025-08-19,TIAA,12,24,4,40,0.100000
2025-08-19,TJX,20,17,3,40,0.075000
2025-08-19,Targa Resources,17,16,7,40,0.175000
2025-08-19,Target,7,25,8,40,0.200000
2025-08-19,Taylor Morrison Home,16,23,1,40,0.025000
2025-08-19,Tenet Healthcare,15,19,6,40,0.150000
2025-08-19,Tesla,17,15,8,40,0.200000
2025-08-19,Texas Instruments,11,19,10,40,0.250000
2025-08-19,Textron,19,18,3,40,0.075000
2025-08-19,The Andersons,12,25,3,40,0.075000
2025-08-19,Thermo Fisher Scientific,22,16,2,40,0.050000
2025-08-19,Thrivent Financial for Lutherans,19,18,3,40,0.075000
2025-08-19,Toll Brothers,7,33,0,40,0.000000
2025-08-19,Tractor Supply,21,15,4,40,0.100000
2025-08-19,TransDigm,22,14,4,40,0.100000
2025-08-19,Travelers Insurance,9,19,12,40,0.300000
2025-08-19,Truist Financial,15,21,4,40,0.100000
2025-08-19,Tyson Foods,12,25,3,40,0.075000
2025-08-19,U.S. Bancorp,14,17,9,40,0.225000
2025-08-19,UPS,9,19,12,40,0.300000
2025-08-19,US Foods,22,16,2,40,0.050000
2025-08-19,USAA,18,13,9,40,0.225000
2025-08-19,Uber,7,12,21,40,0.525000
2025-08-19,Ulta Beauty,32,5,3,40,0.075000
2025-08-19,Union Pacific,15,16,9,40,0.225000
2025-08-19,United Airlines,25,5,10,40,0.250000
2025-08-19,United Natural Foods,38,1,1,40,0.025000
2025-08-19,United Rentals,35,5,0,40,0.000000
2025-08-19,United States Steel,24,10,6,40,0.150000
2025-08-19,UnitedHealth,13,21,6,40,0.150000
2025-08-19,Universal Health Services,17,19,4,40,0.100000
2025-08-19,Unum,18,17,5,40,0.125000
2025-08-19,VF Corporation,15,21,4,40,0.100000
2025-08-19,Valero Energy,36,2,2,40,0.050000
2025-08-19,Verizon,15,20,5,40,0.125000
2025-08-19,Vertex Pharmaceuticals,17,16,7,40,0.175000
2025-08-19,Vertiv,28,11,1,40,0.025000
2025-08-19,Viatris,14,17,9,40,0.225000
2025-08-19,Vistra,21,13,6,40,0.150000
2025-08-19,Voya Financial,13,23,4,40,0.100000
2025-08-19,Vulcan Materials,14,16,10,40,0.250000
2025-08-19,W.R. Berkley,16,16,8,40,0.200000
2025-08-19,W.W. Grainger,10,24,6,40,0.150000
2025-08-19,WEC Energy,39,1,0,40,0.000000
2025-08-19,WESCO International,21,17,2,40,0.050000
2025-08-19,Walgreens,8,21,11,40,0.275000
2025-08-19,Walmart,9,22,9,40,0.225000
2025-08-19,Walt Disney,12,25,3,40,0.075000
2025-08-19,Warner Bros. Discovery,12,27,1,40,0.025000
2025-08-19,Watsco,13,20,7,40,0.175000
2025-08-19,Wayfair,19,18,3,40,0.075000
2025-08-19,Wells Fargo,35,2,3,40,0.075000
2025-08-19,Welltower,23,17,0,40,0.000000
2025-08-19,Western & Southern Financial,14,23,3,40,0.075000
2025-08-19,Western Digital,12,22,6,40,0.150000
2025-08-19,Westinghouse Air Brake Technologies,18,19,3,40,0.075000
2025-08-19,Whirlpool,13,24,3,40,0.075000
2025-08-19,Williams,15,19,6,40,0.150000
2025-08-19,Williams-Sonoma,14,21,5,40,0.125000
2025-08-19,Workday,8,14,18,40,0.450000
2025-08-19,World Kinect,14,21,5,40,0.125000
2025-08-19,XPO,13,22,5,40,0.125000
2025-08-19,Xcel Energy,32,2,6,40,0.150000
2025-08-19,Xylem,20,17,3,40,0.075000
2025-08-19,Yum Brands,25,10,5,40,0.125000
2025-08-19,Yum China,18,15,7,40,0.175000
2025-08-19,Zimmer Biomet,19,18,3,40,0.075000
2025-08-19,Zoetis,24,14,2,40,0.050000
2025-08-20,1 Automotive,15,22,3,40,0.075000
2025-08-20,3M,24,13,3,40,0.075000
2025-08-20,A-Mark Precious Metals,35,5,0,40,0.000000
2025-08-20,ABM Industries,11,23,6,40,0.150000
2025-08-20,AECOM,18,21,1,40,0.025000
2025-08-20,AES,18,11,11,40,0.275000
2025-08-20,AGCO,14,19,7,40,0.175000
2025-08-20,AIG,12,24,4,40,0.100000
2025-08-20,APA,16,20,4,40,0.100000
2025-08-20,ARKO,7,31,2,40,0.050000
2025-08-20,AT&T,6,25,9,40,0.225000
2025-08-20,AbbVie,13,23,4,40,0.100000
2025-08-20,Abbott Laboratories,17,18,5,40,0.125000
2025-08-20,Ace Hardware,13,22,5,40,0.125000
2025-08-20,Adobe,14,23,3,40,0.075000
2025-08-20,Advance Auto Parts,8,20,12,40,0.300000
2025-08-20,Advanced Micro Devices,29,7,4,40,0.100000
2025-08-20,Aflac,14,17,9,40,0.225000
2025-08-20,Air Products & Chemicals,21,13,6,40,0.150000
2025-08-20,Airbnb,14,18,8,40,0.200000
2025-08-20,Alaska Air,19,17,4,40,0.100000
2025-08-20,Albertsons,19,14,7,40,0.175000
2025-08-20,Alcoa,13,21,6,40,0.150000
2025-08-20,Allstate,22,16,2,40,0.050000
2025-08-20,Ally Financial,15,24,1,40,0.025000
2025-08-20,Alphabet,18,13,9,40,0.225000
2025-08-20,Altice,14,17,9,40,0.225000
2025-08-20,Altria,15,18,7,40,0.175000
2025-08-20,Amazon,26,4,10,40,0.250000
2025-08-20,American Airlines,8,18,14,40,0.350000
2025-08-20,American Electric Power,17,19,4,40,0.100000
2025-08-20,American Express,22,13,5,40,0.125000
2025-08-20,American Family Insurance,24,12,4,40,0.100000
2025-08-20,American Financial,17,19,4,40,0.100000
2025-08-20,American International,13,22,5,40,0.125000
2025-08-20,American Tower,20,14,6,40,0.150000
2025-08-20,Ameriprise Financial,21,17,2,40,0.050000
2025-08-20,Amgen,23,11,6,40,0.150000
2025-08-20,Amphenol,19,18,3,40,0.075000
2025-08-20,Analog Devices,15,25,0,40,0.000000
2025-08-20,Apollo Global Management,20,15,5,40,0.125000
2025-08-20,Apple,14,19,7,40,0.175000
2025-08-20,Applied Materials,5,18,17,40,0.425000
2025-08-20,Aramark,22,13,5,40,0.125000
2025-08-20,Archer Daniels Midland,16,21,3,40,0.075000
2025-08-20,Arrow Electronics,17,22,1,40,0.025000
2025-08-20,Arthur J. Gallagher,7,30,3,40,0.075000
2025-08-20,Asbury Automotive,10,25,5,40,0.125000
2025-08-20,Assurant,22,17,1,40,0.025000
2025-08-20,Auto-Owners Insurance,13,23,4,40,0.100000
2025-08-20,AutoNation,14,22,4,40,0.100000
2025-08-20,AutoZone,13,12,15,40,0.375000
2025-08-20,Autoliv,18,21,1,40,0.025000
2025-08-20,Automatic Data Processing,17,19,4,40,0.100000
2025-08-20,Avery Dennison,12,21,7,40,0.175000
2025-08-20,Avis Budget,13,23,4,40,0.100000
2025-08-20,BJ's Wholesale Club,10,24,6,40,0.150000
2025-08-20,Baker Hughes,20,16,4,40,0.100000
2025-08-20,Ball,11,20,9,40,0.225000
2025-08-20,Bank of America,17,19,4,40,0.100000
2025-08-20,Bank of New York,23,16,1,40,0.025000
2025-08-20,Baxter International,7,22,11,40,0.275000
2025-08-20,Becton Dickinson,17,20,3,40,0.075000
2025-08-20,Berkshire Hathaway,12,26,2,40,0.050000
2025-08-20,Berry Global,12,20,8,40,0.200000
2025-08-20,Best Buy,39,0,1,40,0.025000
2025-08-20,Biogen,16,19,5,40,0.125000
2025-08-20,BlackRock,8,24,8,40,0.200000
2025-08-20,Blackstone,13,20,7,40,0.175000
2025-08-20,Boeing,15,15,10,40,0.250000
2025-08-20,Booking s,5,6,5,16,0.312500
2025-08-20,Booz Allen Hamilton,18,16,6,40,0.150000
2025-08-20,BorgWarner,20,20,0,40,0.000000
2025-08-20,Boston Scientific,16,18,6,40,0.150000
2025-08-20,BrightSpring Health Services,14,22,4,40,0.100000
2025-08-20,Bristol-Myers Squibb,8,20,12,40,0.300000
2025-08-20,Broadcom,17,17,6,40,0.150000
2025-08-20,Builders FirstSource,16,20,4,40,0.100000
2025-08-20,Burlington Stores,17,22,1,40,0.025000
2025-08-20,C.H. Robinson Worldwide,15,19,6,40,0.150000
2025-08-20,CACI International,21,18,1,40,0.025000
2025-08-20,CBRE,13,27,0,40,0.000000
2025-08-20,CDW,20,20,0,40,0.000000
2025-08-20,CHS,18,19,3,40,0.075000
2025-08-20,CMS Energy,39,0,1,40,0.025000
2025-08-20,CSX,4,19,17,40,0.425000
2025-08-20,CVS Health,17,17,6,40,0.150000
2025-08-20,Caesars Entertainment,35,5,0,40,0.000000
2025-08-20,Campbell's,6,29,5,40,0.125000
2025-08-20,Capital One,16,19,5,40,0.125000
2025-08-20,CarMax,9,24,7,40,0.175000
2025-08-20,Cardinal Health,20,16,4,40,0.100000
2025-08-20,Carrier Global,10,25,5,40,0.125000
2025-08-20,Carvana,13,18,9,40,0.225000
2025-08-20,Casey's General Stores,18,16,6,40,0.150000
2025-08-20,Caterpillar,12,25,3,40,0.075000
2025-08-20,Celanese,11,12,17,40,0.425000
2025-08-20,Cencora,21,17,2,40,0.050000
2025-08-20,Centene,10,10,20,40,0.500000
2025-08-20,CenterPoint Energy,25,8,7,40,0.175000
2025-08-20,Charles Schwab,25,13,2,40,0.050000
2025-08-20,Charter Communications,15,10,15,40,0.375000
2025-08-20,Cheniere Energy,36,1,3,40,0.075000
2025-08-20,Chevron,22,14,4,40,0.100000
2025-08-20,Chewy,17,19,4,40,0.100000
2025-08-20,Chipotle Mexican Grill,21,18,1,40,0.025000
2025-08-20,Cigna,25,11,4,40,0.100000
2025-08-20,Cincinnati Financial,16,19,5,40,0.125000
2025-08-20,Cintas,20,15,5,40,0.125000
2025-08-20,Cisco Systems,13,21,6,40,0.150000
2025-08-20,Citi,18,16,6,40,0.150000
2025-08-20,Citizens Financial,20,19,1,40,0.025000
2025-08-20,Cleveland-Cliffs,11,24,5,40,0.125000
2025-08-20,Coca-Cola,21,17,2,40,0.050000
2025-08-20,Cognizant Technology,23,10,7,40,0.175000
2025-08-20,Colgate-Palmolive,16,18,6,40,0.150000
2025-08-20,Comcast,20,16,4,40,0.100000
2025-08-20,Commercial Metals,9,22,9,40,0.225000
2025-08-20,Community Health Systems,17,15,8,40,0.200000
2025-08-20,Conagra Brands,12,23,5,40,0.125000
2025-08-20,Concentrix,19,18,3,40,0.075000
2025-08-20,ConocoPhillips,20,14,6,40,0.150000
2025-08-20,Consolidated Edison,7,30,3,40,0.075000
2025-08-20,Constellation Brands,9,18,13,40,0.325000
2025-08-20,Core & Main,13,22,5,40,0.125000
2025-08-20,Corebridge Financial,12,25,3,40,0.075000
2025-08-20,Corning,9,23,8,40,0.200000
2025-08-20,Corteva,18,18,4,40,0.100000
2025-08-20,Coupang,20,16,4,40,0.100000
2025-08-20,Cummins,16,20,4,40,0.100000
2025-08-20,D.R. Horton,9,28,3,40,0.075000
2025-08-20,DTE Energy,36,1,3,40,0.075000
2025-08-20,DXC Technology,13,26,1,40,0.025000
2025-08-20,DaVita,20,11,9,40,0.225000
2025-08-20,Danaher,22,17,1,40,0.025000
2025-08-20,Darden Restaurants,15,20,5,40,0.125000
2025-08-20,Deere,8,27,5,40,0.125000
2025-08-20,Delek US,10,18,12,40,0.300000
2025-08-20,Dell Technologies,18,20,2,40,0.050000
2025-08-20,Delta Airlines,13,14,13,40,0.325000
2025-08-20,Devon Energy,37,1,2,40,0.050000
2025-08-20,Diamondback Energy,37,1,2,40,0.050000
2025-08-20,Dick's Sporting Goods,14,24,2,40,0.050000
2025-08-20,Discover Financial,16,19,5,40,0.125000
2025-08-20,Dollar General,10,19,11,40,0.275000
2025-08-20,Dollar Tree,19,17,4,40,0.100000
2025-08-20,Dominion Energy,27,8,5,40,0.125000
2025-08-20,DoorDash,18,14,8,40,0.200000
2025-08-20,Dover,8,16,16,40,0.400000
2025-08-20,DuPont,16,18,6,40,0.150000
2025-08-20,Duke Energy,36,2,2,40,0.050000
2025-08-20,EMCOR,17,22,1,40,0.025000
2025-08-20,EOG Resources,21,18,1,40,0.025000
2025-08-20,Eastman Chemical,6,18,16,40,0.400000
2025-08-20,Ebay,19,12,9,40,0.225000
2025-08-20,EchoStar,14,18,8,40,0.200000
2025-08-20,Ecolab,17,19,4,40,0.100000
2025-08-20,Edison International,9,27,4,40,0.100000
2025-08-20,Edward Jones,15,22,3,40,0.075000
2025-08-20,Electronic Arts,10,25,5,40,0.125000
2025-08-20,Elevance Health,17,10,13,40,0.325000
2025-08-20,Eli Lilly,10,23,7,40,0.175000
2025-08-20,Emerson Electric,22,11,7,40,0.175000
2025-08-20,Endeavor,11,23,6,40,0.150000
2025-08-20,Energy Transfer,35,1,4,40,0.100000
2025-08-20,Entergy,17,20,3,40,0.075000
2025-08-20,Enterprise Products Partners,24,10,6,40,0.150000
2025-08-20,Equinix,21,16,3,40,0.075000
2025-08-20,Equitable,15,17,8,40,0.200000
2025-08-20,Erie Insurance,16,14,10,40,0.250000
2025-08-20,Estée Lauder,15,14,11,40,0.275000
2025-08-20,Eversource Energy,30,3,7,40,0.175000
2025-08-20,Exelon,17,19,4,40,0.100000
2025-08-20,Expedia,19,18,3,40,0.075000
2025-08-20,Expeditors International of Washington,13,23,4,40,0.100000
2025-08-20,Exxon Mobil,18,20,2,40,0.050000
2025-08-20,Fannie Mae,7,25,8,40,0.200000
2025-08-20,Farmers Insurance,9,30,1,40,0.025000
2025-08-20,Fastenal,26,12,2,40,0.050000
2025-08-20,FedEx,34,3,3,40,0.075000
2025-08-20,Ferguson Enterprises,14,23,3,40,0.075000
2025-08-20,Fidelity National Financial,14,23,3,40,0.075000
2025-08-20,Fidelity National Information,17,17,6,40,0.150000
2025-08-20,Fifth Third Bancorp,20,19,1,40,0.025000
2025-08-20,First Citizens BancShares,20,18,2,40,0.050000
2025-08-20,FirstEnergy,12,19,9,40,0.225000
2025-08-20,Fiserv,10,7,10,27,0.370370
2025-08-20,Fluor,16,17,7,40,0.175000
2025-08-20,Foot Locker,5,28,7,40,0.175000
2025-08-20,Ford Motor,13,18,9,40,0.225000
2025-08-20,Franklin Resources,19,17,4,40,0.100000
2025-08-20,Freddie Mac,10,22,8,40,0.200000
2025-08-20,Freeport-McMoRan,19,19,2,40,0.050000
2025-08-20,GE HealthCare Technologies,15,23,2,40,0.050000
2025-08-20,GE Vernova,16,21,3,40,0.075000
2025-08-20,GXO Logistics,15,22,3,40,0.075000
2025-08-20,General Dynamics,38,2,0,40,0.000000
2025-08-20,General Electric,9,30,1,40,0.025000
2025-08-20,General Mills,14,21,5,40,0.125000
2025-08-20,General Motors,13,23,4,40,0.100000
2025-08-20,Genuine Parts,21,17,2,40,0.050000
2025-08-20,Gilead Sciences,21,15,4,40,0.100000
2025-08-20,Global Partners,19,13,8,40,0.200000
2025-08-20,Global Payments,10,30,0,40,0.000000
2025-08-20,Goldman Sachs,15,17,8,40,0.200000
2025-08-20,Goodyear Tire & Rubber,14,22,4,40,0.100000
2025-08-20,Graphic Packaging,10,26,4,40,0.100000
2025-08-20,Graybar Electric,13,21,6,40,0.150000
2025-08-20,Guardian Life,16,22,2,40,0.050000
2025-08-20,GuideWell Mutual,19,20,1,40,0.025000
2025-08-20,HCA Healthcare,24,8,8,40,0.200000
2025-08-20,HF Sinclair,17,17,6,40,0.150000
2025-08-20,HP,18,18,4,40,0.100000
2025-08-20,Halliburton,15,17,8,40,0.200000
2025-08-20,Henry Schein,15,24,1,40,0.025000
2025-08-20,Hershey,10,24,6,40,0.150000
2025-08-20,Hertz,30,5,5,40,0.125000
2025-08-20,Hewlett Packard,11,24,5,40,0.125000
2025-08-20,Hilton,11,26,3,40,0.075000
2025-08-20,Home Depot,13,19,8,40,0.200000
2025-08-20,Honeywell,14,20,6,40,0.150000
2025-08-20,Hormel Foods,13,23,4,40,0.100000
2025-08-20,Howmet Aerospace,16,17,7,40,0.175000
2025-08-20,Humana,20,14,6,40,0.150000
2025-08-20,Huntington Bancshares,17,21,2,40,0.050000
2025-08-20,Huntington Ingalls Industries,26,10,4,40,0.100000
2025-08-20,IBM,13,21,6,40,0.150000
2025-08-20,IQVIA,20,14,6,40,0.150000
2025-08-20,Icahn Enterprises,12,19,9,40,0.225000
2025-08-20,Illinois Tool Works,14,21,5,40,0.125000
2025-08-20,Ingram Micro,15,11,14,40,0.350000
2025-08-20,Ingredion,21,13,6,40,0.150000
2025-08-20,Insight Enterprises,15,18,7,40,0.175000
2025-08-20,Intel,14,22,4,40,0.100000
2025-08-20,Interactive Brokers,14,21,5,40,0.125000
2025-08-20,Intercontinental Exchange,22,18,0,40,0.000000
2025-08-20,International Flavors & Fragrances,18,12,10,40,0.250000
2025-08-20,International Paper,16,22,2,40,0.050000
2025-08-20,Interpublic,13,20,7,40,0.175000
2025-08-20,Intuit,14,22,4,40,0.100000
2025-08-20,Intuitive Surgical,13,18,9,40,0.225000
2025-08-20,J.B. Hunt Transport Services,14,18,8,40,0.200000
2025-08-20,J.M. Smucker,14,20,6,40,0.150000
2025-08-20,JPMorgan Chase,12,23,5,40,0.125000
2025-08-20,Jabil,21,15,4,40,0.100000
2025-08-20,Jacobs Solutions,38,0,2,40,0.050000
2025-08-20,JetBlue Airways,11,21,8,40,0.200000
2025-08-20,Johnson & Johnson,23,13,4,40,0.100000
2025-08-20,Jones Lang LaSalle,18,22,0,40,0.000000
2025-08-20,KBR,30,9,1,40,0.025000
2025-08-20,KKR,17,17,6,40,0.150000
2025-08-20,KLA,15,20,5,40,0.125000
2025-08-20,Kellanova,20,12,8,40,0.200000
2025-08-20,Kenvue,21,15,4,40,0.100000
2025-08-20,Keurig Dr Pepper,19,17,4,40,0.100000
2025-08-20,KeyCorp,20,17,3,40,0.075000
2025-08-20,Kimberly-Clark,18,21,1,40,0.025000
2025-08-20,Kinder Morgan,39,0,1,40,0.025000
2025-08-20,Kohl's,10,20,10,40,0.250000
2025-08-20,Kraft Heinz,13,19,8,40,0.200000
2025-08-20,Kroger,10,24,6,40,0.150000
2025-08-20,Kyndryl s,8,4,0,12,0.000000
2025-08-20,L3Harris Technologies,25,13,2,40,0.050000
2025-08-20,LKQ,20,16,4,40,0.100000
2025-08-20,LPL Financial,31,9,0,40,0.000000
2025-08-20,Labcorp,20,16,4,40,0.100000
2025-08-20,Lam Research,20,15,5,40,0.125000
2025-08-20,Land O'Lakes,10,29,1,40,0.025000
2025-08-20,Las Vegas Sands,15,21,4,40,0.100000
2025-08-20,Lear Corporation,21,17,2,40,0.050000
2025-08-20,Leidos,27,13,0,40,0.000000
2025-08-20,Lennar,12,26,2,40,0.050000
2025-08-20,Liberty Mutual Insurance,35,0,5,40,0.125000
2025-08-20,Lincoln National,14,18,8,40,0.200000
2025-08-20,Lithia Motors,20,17,3,40,0.075000
2025-08-20,Live Nation Entertainment,30,10,0,40,0.000000
2025-08-20,Lockheed Martin,21,12,7,40,0.175000
2025-08-20,Loews,22,16,2,40,0.050000
2025-08-20,Lowe's,15,22,3,40,0.075000
2025-08-20,Lululemon athletica,22,13,5,40,0.125000
2025-08-20,Lumen Technologies,9,25,6,40,0.150000
2025-08-20,M&T Bank,18,20,2,40,0.050000
2025-08-20,MGM Resorts International,16,23,1,40,0.025000
2025-08-20,Macy's,19,19,2,40,0.050000
2025-08-20,ManpowerGroup,19,18,3,40,0.075000
2025-08-20,Marathon Petroleum,15,23,2,40,0.050000
2025-08-20,Markel,5,17,18,40,0.450000
2025-08-20,Marriott International,17,22,1,40,0.025000
2025-08-20,Marsh & McLennan,25,10,5,40,0.125000
2025-08-20,MasTec,19,17,4,40,0.100000
2025-08-20,Masco,11,26,3,40,0.075000
2025-08-20,Mass Mutual,11,28,1,40,0.025000
2025-08-20,Mastercard,18,15,7,40,0.175000
2025-08-20,McDonald's,19,10,11,40,0.275000
2025-08-20,McKesson,18,20,2,40,0.050000
2025-08-20,Merck,16,18,6,40,0.150000
2025-08-20,MetLife,15,23,2,40,0.050000
2025-08-20,Meta,12,21,7,40,0.175000
2025-08-20,Microchip Technology,15,22,3,40,0.075000
2025-08-20,Micron Technology,13,21,6,40,0.150000
2025-08-20,Microsoft,9,13,18,40,0.450000
2025-08-20,Mohawk Industries,17,20,3,40,0.075000
2025-08-20,Molina Healthcare,16,16,8,40,0.200000
2025-08-20,Molson Coors Beverage,20,12,8,40,0.200000
2025-08-20,Mondelez,17,11,12,40,0.300000
2025-08-20,Monster Beverage,12,27,1,40,0.025000
2025-08-20,Morgan Stanley,14,20,6,40,0.150000
2025-08-20,Mosaic,20,17,3,40,0.075000
2025-08-20,Motorola Solutions,38,0,2,40,0.050000
2025-08-20,Murphy USA,16,23,1,40,0.025000
2025-08-20,Mutual of Omaha Insurance,19,21,0,40,0.000000
2025-08-20,NOV,8,30,2,40,0.050000
2025-08-20,NRG Energy,34,5,1,40,0.025000
2025-08-20,NVR,18,16,6,40,0.150000
2025-08-20,Nationwide Insurance,11,18,11,40,0.275000
2025-08-20,New York Life Insurance,13,24,3,40,0.075000
2025-08-20,Newmont,22,13,5,40,0.125000
2025-08-20,News Corp.,15,19,6,40,0.150000
2025-08-20,NextEra Energy,32,2,6,40,0.150000
2025-08-20,Nike,12,23,5,40,0.125000
2025-08-20,Nordstrom,15,22,3,40,0.075000
2025-08-20,Norfolk Southern,15,16,9,40,0.225000
2025-08-20,Northern Trust,40,0,0,40,0.000000
2025-08-20,Northrop Grumman,19,18,3,40,0.075000
2025-08-20,Northwestern Mutual,16,12,12,40,0.300000
2025-08-20,Nucor,15,22,3,40,0.075000
2025-08-20,Nvidia,9,22,9,40,0.225000
2025-08-20,O'Reilly Automotive,13,23,4,40,0.100000
2025-08-20,Occidental Petroleum,18,19,3,40,0.075000
2025-08-20,Old Republic International,22,16,2,40,0.050000
2025-08-20,Omnicom,20,15,5,40,0.125000
2025-08-20,Oneok,22,14,4,40,0.100000
2025-08-20,Oracle,7,25,8,40,0.200000
2025-08-20,Oscar Health,10,22,8,40,0.200000
2025-08-20,Oshkosh,11,17,12,40,0.300000
2025-08-20,Otis Worldwide,18,17,5,40,0.125000
2025-08-20,Ovintiv,21,15,4,40,0.100000
2025-08-20,Owens & Minor,9,22,9,40,0.225000
2025-08-20,Owens Corning,21,14,5,40,0.125000
2025-08-20,PBF Energy,33,1,6,40,0.150000
2025-08-20,PG&E,19,14,7,40,0.175000
2025-08-20,PNC,16,18,6,40,0.150000
2025-08-20,PPG Industries,20,14,6,40,0.150000
2025-08-20,PPL,14,25,1,40,0.025000
2025-08-20,PVH,15,15,10,40,0.250000
2025-08-20,Paccar,19,18,3,40,0.075000
2025-08-20,Pacific Life,18,21,1,40,0.025000
2025-08-20,Packaging Corp. of America,6,27,7,40,0.175000
2025-08-20,Palo Alto Networks,16,20,4,40,0.100000
2025-08-20,Par Pacific,16,21,3,40,0.075000
2025-08-20,Paramount Global,9,30,1,40,0.025000
2025-08-20,Parker-Hannifin,24,16,0,40,0.000000
2025-08-20,PayPal,16,11,13,40,0.325000
2025-08-20,Penske Automotive,15,24,1,40,0.025000
2025-08-20,PepsiCo,18,18,4,40,0.100000
2025-08-20,Performance Food,18,19,3,40,0.075000
2025-08-20,Peter Kiewit Sons',6,19,15,40,0.375000
2025-08-20,Pfizer,9,17,14,40,0.350000
2025-08-20,Philip Morris,26,12,2,40,0.050000
2025-08-20,Phillips 66,14,19,7,40,0.175000
2025-08-20,Plains GP,20,16,4,40,0.100000
2025-08-20,Principal Financial,11,24,5,40,0.125000
2025-08-20,Procter & Gamble,15,18,7,40,0.175000
2025-08-20,Progressive Insurance,17,19,4,40,0.100000
2025-08-20,Prologis,18,16,6,40,0.150000
2025-08-20,Prudential Financial,19,17,4,40,0.100000
2025-08-20,Public Service Enterprise,17,19,4,40,0.100000
2025-08-20,Publix Super Markets,16,19,5,40,0.125000
2025-08-20,PulteGroup,19,16,5,40,0.125000
2025-08-20,QVC,12,23,5,40,0.125000
2025-08-20,QXO Building Products,2,5,3,10,0.300000
2025-08-20,Qualcomm,21,18,1,40,0.025000
2025-08-20,Quanta Services,16,14,10,40,0.250000
2025-08-20,Quest Diagnostics,12,25,3,40,0.075000
2025-08-20,RTX,21,11,8,40,0.200000
2025-08-20,Raymond James Financial,25,14,1,40,0.025000
2025-08-20,Regeneron Pharmaceuticals,21,15,4,40,0.100000
2025-08-20,Regions Financial,18,21,1,40,0.025000
2025-08-20,Reinsurance of America,0,5,1,6,0.166667
2025-08-20,Reliance,10,24,6,40,0.150000
2025-08-20,Republic Services,9,14,17,40,0.425000
2025-08-20,Rockwell Automation,17,19,4,40,0.100000
2025-08-20,Ross Stores,14,23,3,40,0.075000
2025-08-20,Rush Enterprises,17,21,2,40,0.050000
2025-08-20,Ryder System,26,11,3,40,0.075000
2025-08-20,S&P Global,18,17,5,40,0.125000
2025-08-20,Salesforce,13,22,5,40,0.125000
2025-08-20,Sanmina,14,24,2,40,0.050000
2025-08-20,Science Applications International,16,20,4,40,0.100000
2025-08-20,Seaboard,7,23,10,40,0.250000
2025-08-20,Securian Financial,13,22,5,40,0.125000
2025-08-20,Sempra,25,14,1,40,0.025000
2025-08-20,ServiceNow,17,19,4,40,0.100000
2025-08-20,Sherwin-Williams,10,17,13,40,0.325000
2025-08-20,Sirius XM,11,21,8,40,0.200000
2025-08-20,Skechers,20,19,1,40,0.025000
2025-08-20,Solventum,16,21,3,40,0.075000
2025-08-20,Sonic Automotive,8,29,3,40,0.075000
2025-08-20,Southern Company,19,20,1,40,0.025000
2025-08-20,Southwest Airlines,6,19,15,40,0.375000
2025-08-20,SpartanNash,15,22,3,40,0.075000
2025-08-20,Sprouts Farmers Market,22,18,0,40,0.000000
2025-08-20,Stanley Black & Decker,11,25,4,40,0.100000
2025-08-20,Starbucks,5,30,5,40,0.125000
2025-08-20,State Farm,16,12,12,40,0.300000
2025-08-20,State Street,11,18,11,40,0.275000
2025-08-20,Steel Dynamics,35,3,2,40,0.050000
2025-08-20,StoneX,15,23,2,40,0.050000
2025-08-20,Stryker,16,17,7,40,0.175000
2025-08-20,Synchrony Financial,21,16,3,40,0.075000
2025-08-20,Sysco,17,16,7,40,0.175000
2025-08-20,TD Synnex,23,17,0,40,0.000000
2025-08-20,THOR Industries,16,19,5,40,0.125000
2025-08-20,TIAA,12,24,4,40,0.100000
2025-08-20,TJX,20,18,2,40,0.050000
2025-08-20,Targa Resources,17,18,5,40,0.125000
2025-08-20,Target,4,18,18,40,0.450000
2025-08-20,Taylor Morrison Home,16,23,1,40,0.025000
2025-08-20,Tenet Healthcare,11,21,8,40,0.200000
2025-08-20,Tesla,13,12,15,40,0.375000
2025-08-20,Texas Instruments,11,19,10,40,0.250000
2025-08-20,Textron,23,15,2,40,0.050000
2025-08-20,The Andersons,13,24,3,40,0.075000
2025-08-20,Thermo Fisher Scientific,17,18,5,40,0.125000
2025-08-20,Thrivent Financial for Lutherans,18,19,3,40,0.075000
2025-08-20,Toll Brothers,13,25,2,40,0.050000
2025-08-20,Tractor Supply,22,17,1,40,0.025000
2025-08-20,TransDigm,28,9,3,40,0.075000
2025-08-20,Travelers Insurance,10,20,10,40,0.250000
2025-08-20,Truist Financial,16,20,4,40,0.100000
2025-08-20,Tyson Foods,13,23,4,40,0.100000
2025-08-20,U.S. Bancorp,17,16,7,40,0.175000
2025-08-20,UPS,5,20,15,40,0.375000
2025-08-20,US Foods,19,18,3,40,0.075000
2025-08-20,USAA,17,14,9,40,0.225000
2025-08-20,Uber,9,11,20,40,0.500000
2025-08-20,Ulta Beauty,31,6,3,40,0.075000
2025-08-20,Union Pacific,19,14,7,40,0.175000
2025-08-20,United Airlines,32,3,5,40,0.125000
2025-08-20,United Natural Foods,40,0,0,40,0.000000
2025-08-20,United Rentals,33,7,0,40,0.000000
2025-08-20,United States Steel,24,8,8,40,0.200000
2025-08-20,UnitedHealth,12,21,7,40,0.175000
2025-08-20,Universal Health Services,16,19,5,40,0.125000
2025-08-20,Unum,16,17,7,40,0.175000
2025-08-20,VF Corporation,13,23,4,40,0.100000
2025-08-20,Valero Energy,37,1,2,40,0.050000
2025-08-20,Verizon,19,14,7,40,0.175000
2025-08-20,Vertex Pharmaceuticals,19,12,9,40,0.225000
2025-08-20,Vertiv,22,16,2,40,0.050000
2025-08-20,Viatris,12,21,7,40,0.175000
2025-08-20,Vistra,19,14,7,40,0.175000
2025-08-20,Voya Financial,13,24,3,40,0.075000
2025-08-20,Vulcan Materials,14,16,10,40,0.250000
2025-08-20,W.R. Berkley,11,20,9,40,0.225000
2025-08-20,W.W. Grainger,10,23,7,40,0.175000
2025-08-20,WEC Energy,39,1,0,40,0.000000
2025-08-20,WESCO International,22,16,2,40,0.050000
2025-08-20,Walgreens,9,20,11,40,0.275000
2025-08-20,Walmart,6,17,17,40,0.425000
2025-08-20,Walt Disney,14,23,3,40,0.075000
2025-08-20,Warner Bros. Discovery,9,31,0,40,0.000000
2025-08-20,Watsco,14,20,6,40,0.150000
2025-08-20,Wayfair,16,21,3,40,0.075000
2025-08-20,Wells Fargo,36,1,3,40,0.075000
2025-08-20,Western & Southern Financial,14,22,4,40,0.100000
2025-08-20,Western Digital,14,20,6,40,0.150000
2025-08-20,Westinghouse Air Brake Technologies,17,18,5,40,0.125000
2025-08-20,Whirlpool,12,24,4,40,0.100000
2025-08-20,Williams,14,18,8,40,0.200000
2025-08-20,Williams-Sonoma,14,21,5,40,0.125000
2025-08-20,Workday,11,13,16,40,0.400000
2025-08-20,World Kinect,14,22,4,40,0.100000
2025-08-20,XPO,14,21,5,40,0.125000
2025-08-20,Xcel Energy,29,5,6,40,0.150000
2025-08-20,Xylem,18,20,2,40,0.050000
2025-08-20,Yum Brands,23,11,6,40,0.150000
2025-08-20,Yum China,17,16,7,40,0.175000
2025-08-20,Zimmer Biomet,18,18,4,40,0.100000
2025-08-20,Zoetis,21,19,0,40,0.000000
2025-08-21,1 Automotive,16,22,2,40,0.050000
2025-08-21,3M,25,10,5,40,0.125000
2025-08-21,A-Mark Precious Metals,36,4,0,40,0.000000
2025-08-21,ABM Industries,13,21,6,40,0.150000
2025-08-21,AECOM,20,17,3,40,0.075000
2025-08-21,AES,19,13,8,40,0.200000
2025-08-21,AGCO,14,18,8,40,0.200000
2025-08-21,AIG,12,23,5,40,0.125000
2025-08-21,APA,19,15,6,40,0.150000
2025-08-21,ARKO,8,30,2,40,0.050000
2025-08-21,AT&T,10,22,8,40,0.200000
2025-08-21,AbbVie,18,20,2,40,0.050000
2025-08-21,Abbott Laboratories,19,16,5,40,0.125000
2025-08-21,Ace Hardware,15,21,4,40,0.100000
2025-08-21,Adobe,13,24,3,40,0.075000
2025-08-21,Advance Auto Parts,12,14,14,40,0.350000
2025-08-21,Advanced Micro Devices,30,3,7,40,0.175000
2025-08-21,Aflac,11,17,12,40,0.300000
2025-08-21,Air Products & Chemicals,22,13,5,40,0.125000
2025-08-21,Airbnb,11,21,8,40,0.200000
2025-08-21,Alaska Air,20,18,2,40,0.050000
2025-08-21,Albertsons,22,12,6,40,0.150000
2025-08-21,Alcoa,15,18,7,40,0.175000
2025-08-21,Allstate,15,12,13,40,0.325000
2025-08-21,Ally Financial,15,23,2,40,0.050000
2025-08-21,Alphabet,16,13,11,40,0.275000
2025-08-21,Altice,11,21,8,40,0.200000
2025-08-21,Altria,20,19,1,40,0.025000
2025-08-21,Amazon,28,2,10,40,0.250000
2025-08-21,American Airlines,14,12,14,40,0.350000
2025-08-21,American Electric Power,13,23,4,40,0.100000
2025-08-21,American Express,21,14,5,40,0.125000
2025-08-21,American Family Insurance,25,12,3,40,0.075000
2025-08-21,American Financial,19,18,3,40,0.075000
2025-08-21,American International,13,23,4,40,0.100000
2025-08-21,American Tower,17,17,6,40,0.150000
2025-08-21,Ameriprise Financial,21,17,2,40,0.050000
2025-08-21,Amgen,16,14,10,40,0.250000
2025-08-21,Amphenol,18,19,3,40,0.075000
2025-08-21,Analog Devices,17,23,0,40,0.000000
2025-08-21,Apollo Global Management,16,21,3,40,0.075000
2025-08-21,Apple,11,21,8,40,0.200000
2025-08-21,Applied Materials,6,19,15,40,0.375000
2025-08-21,Aramark,23,13,4,40,0.100000
2025-08-21,Archer Daniels Midland,16,21,3,40,0.075000
2025-08-21,Arrow Electronics,19,20,1,40,0.025000
2025-08-21,Arthur J. Gallagher,7,30,3,40,0.075000
2025-08-21,Asbury Automotive,10,26,4,40,0.100000
2025-08-21,Assurant,24,15,1,40,0.025000
2025-08-21,Auto-Owners Insurance,12,24,4,40,0.100000
2025-08-21,AutoNation,13,22,5,40,0.125000
2025-08-21,AutoZone,12,13,15,40,0.375000
2025-08-21,Autoliv,20,19,1,40,0.025000
2025-08-21,Automatic Data Processing,18,18,4,40,0.100000
2025-08-21,Avery Dennison,17,18,5,40,0.125000
2025-08-21,Avis Budget,12,19,9,40,0.225000
2025-08-21,Avnet,18,19,3,40,0.075000
2025-08-21,Baker Hughes,16,18,6,40,0.150000
2025-08-21,Ball,14,21,5,40,0.125000
2025-08-21,Bank of America,13,20,7,40,0.175000
2025-08-21,Bank of New York,22,14,4,40,0.100000
2025-08-21,Baxter International,9,20,11,40,0.275000
2025-08-21,Becton Dickinson,16,19,5,40,0.125000
2025-08-21,Berkshire Hathaway,12,22,6,40,0.150000
2025-08-21,Berry Global,10,22,8,40,0.200000
2025-08-21,Best Buy,40,0,0,40,0.000000
2025-08-21,Biogen,20,18,2,40,0.050000
2025-08-21,BlackRock,11,25,4,40,0.100000
2025-08-21,Blackstone,14,22,4,40,0.100000
2025-08-21,Boeing,7,27,6,40,0.150000
2025-08-21,Booking s,5,5,4,14,0.285714
2025-08-21,Booz Allen Hamilton,16,20,4,40,0.100000
2025-08-21,BorgWarner,22,18,0,40,0.000000
2025-08-21,Boston Scientific,16,16,8,40,0.200000
2025-08-21,BrightSpring Health Services,13,23,4,40,0.100000
2025-08-21,Bristol-Myers Squibb,9,21,10,40,0.250000
2025-08-21,Broadcom,23,12,5,40,0.125000
2025-08-21,Builders FirstSource,13,23,4,40,0.100000
2025-08-21,Burlington Stores,12,28,0,40,0.000000
2025-08-21,C.H. Robinson Worldwide,14,19,7,40,0.175000
2025-08-21,CACI International,21,18,1,40,0.025000
2025-08-21,CBRE,10,28,2,40,0.050000
2025-08-21,CDW,28,12,0,40,0.000000
2025-08-21,CHS,18,20,2,40,0.050000
2025-08-21,CMS Energy,38,0,2,40,0.050000
2025-08-21,CSX,3,17,20,40,0.500000
2025-08-21,CVS Health,18,17,5,40,0.125000
2025-08-21,Caesars Entertainment,33,7,0,40,0.000000
2025-08-21,Campbell's,8,28,4,40,0.100000
2025-08-21,Capital One,19,19,2,40,0.050000
2025-08-21,CarMax,12,21,7,40,0.175000
2025-08-21,Cardinal Health,21,11,8,40,0.200000
2025-08-21,Carrier Global,14,22,4,40,0.100000
2025-08-21,Carvana,15,17,8,40,0.200000
2025-08-21,Casey's General Stores,19,17,4,40,0.100000
2025-08-21,Caterpillar,17,19,4,40,0.100000
2025-08-21,Celanese,12,16,12,40,0.300000
2025-08-21,Cencora,19,20,1,40,0.025000
2025-08-21,Centene,11,13,16,40,0.400000
2025-08-21,CenterPoint Energy,26,7,7,40,0.175000
2025-08-21,Charles Schwab,22,15,3,40,0.075000
2025-08-21,Charter Communications,13,14,13,40,0.325000
2025-08-21,Cheniere Energy,35,5,0,40,0.000000
2025-08-21,Chevron,24,13,3,40,0.075000
2025-08-21,Chewy,15,24,1,40,0.025000
2025-08-21,Chipotle Mexican Grill,21,17,2,40,0.050000
2025-08-21,Cigna,24,12,4,40,0.100000
2025-08-21,Cincinnati Financial,21,15,4,40,0.100000
2025-08-21,Cintas,22,14,4,40,0.100000
2025-08-21,Cisco Systems,14,17,9,40,0.225000
2025-08-21,Citi,18,19,3,40,0.075000
2025-08-21,Citizens Financial,18,22,0,40,0.000000
2025-08-21,Cleveland-Cliffs,12,22,6,40,0.150000
2025-08-21,Coca-Cola,16,18,6,40,0.150000
2025-08-21,Cognizant Technology,21,12,7,40,0.175000
2025-08-21,Colgate-Palmolive,17,16,7,40,0.175000
2025-08-21,Comcast,14,20,6,40,0.150000
2025-08-21,Commercial Metals,8,22,10,40,0.250000
2025-08-21,Community Health Systems,18,14,8,40,0.200000
2025-08-21,Conagra Brands,12,23,5,40,0.125000
2025-08-21,Concentrix,19,15,6,40,0.150000
2025-08-21,ConocoPhillips,17,20,3,40,0.075000
2025-08-21,Consolidated Edison,6,30,4,40,0.100000
2025-08-21,Constellation Brands,10,20,10,40,0.250000
2025-08-21,Constellation Energy,36,2,2,40,0.050000
2025-08-21,Core & Main,15,21,4,40,0.100000
2025-08-21,Corebridge Financial,11,26,3,40,0.075000
2025-08-21,Corning,10,21,9,40,0.225000
2025-08-21,Corteva,21,15,4,40,0.100000
2025-08-21,Costco,18,19,3,40,0.075000
2025-08-21,Coupang,18,19,3,40,0.075000
2025-08-21,Cummins,20,17,3,40,0.075000
2025-08-21,D.R. Horton,13,25,2,40,0.050000
2025-08-21,DTE Energy,34,1,5,40,0.125000
2025-08-21,DXC Technology,11,28,1,40,0.025000
2025-08-21,DaVita,18,13,9,40,0.225000
2025-08-21,Danaher,20,17,3,40,0.075000
2025-08-21,Darden Restaurants,14,22,4,40,0.100000
2025-08-21,Deere,14,19,7,40,0.175000
2025-08-21,Delek US,12,15,13,40,0.325000
2025-08-21,Dell Technologies,13,22,5,40,0.125000
2025-08-21,Delta Airlines,18,15,7,40,0.175000
2025-08-21,Devon Energy,37,3,0,40,0.000000
2025-08-21,Diamondback Energy,38,1,1,40,0.025000
2025-08-21,Dick's Sporting Goods,13,24,3,40,0.075000
2025-08-21,Discover Financial,15,21,4,40,0.100000
2025-08-21,Dollar General,11,19,10,40,0.250000
2025-08-21,Dollar Tree,19,14,7,40,0.175000
2025-08-21,Dominion Energy,29,8,3,40,0.075000
2025-08-21,DoorDash,15,17,8,40,0.200000
2025-08-21,Dover,6,19,15,40,0.375000
2025-08-21,DuPont,16,17,7,40,0.175000
2025-08-21,Duke Energy,37,1,2,40,0.050000
2025-08-21,EMCOR,20,19,1,40,0.025000
2025-08-21,EOG Resources,23,16,1,40,0.025000
2025-08-21,Eastman Chemical,4,20,16,40,0.400000
2025-08-21,Ebay,25,11,4,40,0.100000
2025-08-21,EchoStar,11,21,8,40,0.200000
2025-08-21,Ecolab,18,17,5,40,0.125000
2025-08-21,Edison International,10,25,5,40,0.125000
2025-08-21,Edward Jones,13,24,3,40,0.075000
2025-08-21,Electronic Arts,9,23,8,40,0.200000
2025-08-21,Elevance Health,17,9,14,40,0.350000
2025-08-21,Eli Lilly,11,21,8,40,0.200000
2025-08-21,Emerson Electric,20,14,6,40,0.150000
2025-08-21,Endeavor,11,25,4,40,0.100000
2025-08-21,Energy Transfer,34,2,4,40,0.100000
2025-08-21,Entergy,22,16,2,40,0.050000
2025-08-21,Enterprise Products Partners,19,16,5,40,0.125000
2025-08-21,Equitable,15,20,5,40,0.125000
2025-08-21,Erie Insurance,17,13,10,40,0.250000
2025-08-21,Estée Lauder,8,16,16,40,0.400000
2025-08-21,Eversource Energy,31,4,5,40,0.125000
2025-08-21,Exelon,18,19,3,40,0.075000
2025-08-21,Expedia,19,18,3,40,0.075000
2025-08-21,Expeditors International of Washington,14,22,4,40,0.100000
2025-08-21,Exxon Mobil,19,19,2,40,0.050000
2025-08-21,Fannie Mae,8,27,5,40,0.125000
2025-08-21,Farmers Insurance,9,30,1,40,0.025000
2025-08-21,Fastenal,26,12,2,40,0.050000
2025-08-21,FedEx,31,6,3,40,0.075000
2025-08-21,Ferguson Enterprises,12,24,4,40,0.100000
2025-08-21,Fidelity National Financial,14,23,3,40,0.075000
2025-08-21,Fidelity National Information,21,16,3,40,0.075000
2025-08-21,Fifth Third Bancorp,21,19,0,40,0.000000
2025-08-21,First Citizens BancShares,19,19,2,40,0.050000
2025-08-21,FirstEnergy,11,18,11,40,0.275000
2025-08-21,Fiserv,13,19,8,40,0.200000
2025-08-21,Fluor,14,17,9,40,0.225000
2025-08-21,Foot Locker,9,22,9,40,0.225000
2025-08-21,Ford Motor,13,19,8,40,0.200000
2025-08-21,Franklin Resources,16,19,5,40,0.125000
2025-08-21,Freddie Mac,10,20,10,40,0.250000
2025-08-21,Freeport-McMoRan,20,13,7,40,0.175000
2025-08-21,GE HealthCare Technologies,15,22,3,40,0.075000
2025-08-21,GE Vernova,13,26,1,40,0.025000
2025-08-21,GXO Logistics,15,22,3,40,0.075000
2025-08-21,General Dynamics,36,4,0,40,0.000000
2025-08-21,General Electric,12,27,1,40,0.025000
2025-08-21,General Mills,18,18,4,40,0.100000
2025-08-21,General Motors,16,19,5,40,0.125000
2025-08-21,Genuine Parts,20,15,5,40,0.125000
2025-08-21,Gilead Sciences,10,23,7,40,0.175000
2025-08-21,Global Partners,22,12,6,40,0.150000
2025-08-21,Global Payments,13,27,0,40,0.000000
2025-08-21,Goldman Sachs,14,19,7,40,0.175000
2025-08-21,Goodyear Tire & Rubber,14,22,4,40,0.100000
2025-08-21,Graphic Packaging,10,27,3,40,0.075000
2025-08-21,Graybar Electric,14,19,7,40,0.175000
2025-08-21,Guardian Life,16,22,2,40,0.050000
2025-08-21,GuideWell Mutual,19,20,1,40,0.025000
2025-08-21,HCA Healthcare,23,10,7,40,0.175000
2025-08-21,HF Sinclair,18,15,7,40,0.175000
2025-08-21,HP,13,22,5,40,0.125000
2025-08-21,Halliburton,20,13,7,40,0.175000
2025-08-21,Hartford Insurance,21,16,3,40,0.075000
2025-08-21,Henry Schein,15,23,2,40,0.050000
2025-08-21,Hershey,11,24,5,40,0.125000
2025-08-21,Hertz,31,6,3,40,0.075000
2025-08-21,Hewlett Packard,13,23,4,40,0.100000
2025-08-21,Hilton,10,27,3,40,0.075000
2025-08-21,Home Depot,9,21,10,40,0.250000
2025-08-21,Honeywell,20,16,4,40,0.100000
2025-08-21,Hormel Foods,12,26,2,40,0.050000
2025-08-21,Howmet Aerospace,14,16,10,40,0.250000
2025-08-21,Humana,22,13,5,40,0.125000
2025-08-21,Huntington Bancshares,17,21,2,40,0.050000
2025-08-21,Huntington Ingalls Industries,19,16,5,40,0.125000
2025-08-21,IBM,15,19,6,40,0.150000
2025-08-21,IQVIA,22,14,4,40,0.100000
2025-08-21,Icahn Enterprises,11,20,9,40,0.225000
2025-08-21,Illinois Tool Works,14,21,5,40,0.125000
2025-08-21,Ingram Micro,14,11,15,40,0.375000
2025-08-21,Ingredion,20,16,4,40,0.100000
2025-08-21,Insight Enterprises,15,19,6,40,0.150000
2025-08-21,Intel,15,21,4,40,0.100000
2025-08-21,Interactive Brokers,14,21,5,40,0.125000
2025-08-21,Intercontinental Exchange,21,19,0,40,0.000000
2025-08-21,International Flavors & Fragrances,18,12,10,40,0.250000
2025-08-21,International Paper,4,33,3,40,0.075000
2025-08-21,Interpublic,13,21,6,40,0.150000
2025-08-21,Intuit,17,19,4,40,0.100000
2025-08-21,Intuitive Surgical,15,17,8,40,0.200000
2025-08-21,J.B. Hunt Transport Services,17,17,6,40,0.150000
2025-08-21,J.M. Smucker,13,22,5,40,0.125000
2025-08-21,JPMorgan Chase,13,23,4,40,0.100000
2025-08-21,Jabil,22,15,3,40,0.075000
2025-08-21,Jacobs Solutions,36,1,3,40,0.075000
2025-08-21,Jefferies Financial,8,22,10,40,0.250000
2025-08-21,JetBlue Airways,14,18,8,40,0.200000
2025-08-21,Johnson & Johnson,20,15,5,40,0.125000
2025-08-21,Jones Lang LaSalle,19,21,0,40,0.000000
2025-08-21,KBR,28,10,2,40,0.050000
2025-08-21,KKR,15,18,7,40,0.175000
2025-08-21,KLA,13,19,8,40,0.200000
2025-08-21,Kellanova,17,16,7,40,0.175000
2025-08-21,Kenvue,23,13,4,40,0.100000
2025-08-21,Keurig Dr Pepper,14,16,10,40,0.250000
2025-08-21,KeyCorp,16,18,6,40,0.150000
2025-08-21,Kimberly-Clark,20,17,3,40,0.075000
2025-08-21,Kinder Morgan,39,0,1,40,0.025000
2025-08-21,Kohl's,10,21,9,40,0.225000
2025-08-21,Kraft Heinz,12,21,7,40,0.175000
2025-08-21,Kroger,9,25,6,40,0.150000
2025-08-21,Kyndryl s,8,5,0,13,0.000000
2025-08-21,L3Harris Technologies,24,13,3,40,0.075000
2025-08-21,LKQ,16,17,7,40,0.175000
2025-08-21,LPL Financial,28,12,0,40,0.000000
2025-08-21,Labcorp,17,19,4,40,0.100000
2025-08-21,Lam Research,20,15,5,40,0.125000
2025-08-21,Land O'Lakes,9,30,1,40,0.025000
2025-08-21,Las Vegas Sands,14,25,1,40,0.025000
2025-08-21,Lear Corporation,18,18,4,40,0.100000
2025-08-21,Leidos,24,15,1,40,0.025000
2025-08-21,Lennar,14,23,3,40,0.075000
2025-08-21,Liberty Mutual Insurance,33,1,6,40,0.150000
2025-08-21,Lincoln National,9,22,9,40,0.225000
2025-08-21,Lithia Motors,22,17,1,40,0.025000
2025-08-21,Live Nation Entertainment,27,12,1,40,0.025000
2025-08-21,Lockheed Martin,22,9,9,40,0.225000
2025-08-21,Loews,23,15,2,40,0.050000
2025-08-21,Lowe's,18,18,4,40,0.100000
2025-08-21,Lululemon athletica,16,18,6,40,0.150000
2025-08-21,Lumen Technologies,10,26,4,40,0.100000
2025-08-21,M&T Bank,17,19,4,40,0.100000
2025-08-21,MGM Resorts International,18,20,2,40,0.050000
2025-08-21,Macy's,16,22,2,40,0.050000
2025-08-21,ManpowerGroup,18,17,5,40,0.125000
2025-08-21,Marathon Petroleum,17,23,0,40,0.000000
2025-08-21,Markel Group,17,16,7,40,0.175000
2025-08-21,Marriott International,19,17,4,40,0.100000
2025-08-21,Marsh & McLennan,26,11,3,40,0.075000
2025-08-21,MasTec,17,19,4,40,0.100000
2025-08-21,Masco,12,25,3,40,0.075000
2025-08-21,Mass Mutual,12,26,2,40,0.050000
2025-08-21,Mastercard,16,20,4,40,0.100000
2025-08-21,McDonald's,20,5,15,40,0.375000
2025-08-21,McKesson,19,20,1,40,0.025000
2025-08-21,Merck,14,20,6,40,0.150000
2025-08-21,MetLife,17,21,2,40,0.050000
2025-08-21,Meta,18,16,6,40,0.150000
2025-08-21,Microchip Technology,15,22,3,40,0.075000
2025-08-21,Micron Technology,10,23,7,40,0.175000
2025-08-21,Microsoft,8,16,16,40,0.400000
2025-08-21,Mohawk Industries,19,17,4,40,0.100000
2025-08-21,Molina Healthcare,15,15,10,40,0.250000
2025-08-21,Molson Coors Beverage,17,16,7,40,0.175000
2025-08-21,Mondelez,13,11,16,40,0.400000
2025-08-21,Monster Beverage,18,22,0,40,0.000000
2025-08-21,Morgan Stanley,11,21,8,40,0.200000
2025-08-21,Mosaic,12,27,1,40,0.025000
2025-08-21,Motorola Solutions,39,0,1,40,0.025000
2025-08-21,Murphy USA,18,22,0,40,0.000000
2025-08-21,Mutual of Omaha Insurance,21,19,0,40,0.000000
2025-08-21,NOV,7,26,7,40,0.175000
2025-08-21,NRG Energy,36,3,1,40,0.025000
2025-08-21,NVR,15,18,7,40,0.175000
2025-08-21,Nationwide Insurance,10,19,11,40,0.275000
2025-08-21,Netflix,12,17,11,40,0.275000
2025-08-21,New York Life Insurance,14,23,3,40,0.075000
2025-08-21,Newell Brands,13,22,5,40,0.125000
2025-08-21,Newmont,25,11,4,40,0.100000
2025-08-21,News Corp.,14,19,7,40,0.175000
2025-08-21,NextEra Energy,33,3,4,40,0.100000
2025-08-21,Nike,9,23,8,40,0.200000
2025-08-21,Nordstrom,10,26,4,40,0.100000
2025-08-21,Norfolk Southern,15,17,8,40,0.200000
2025-08-21,Northern Trust,38,1,1,40,0.025000
2025-08-21,Northrop Grumman,17,20,3,40,0.075000
2025-08-21,Northwestern Mutual,15,15,10,40,0.250000
2025-08-21,Nucor,16,20,4,40,0.100000
2025-08-21,Nvidia,13,22,5,40,0.125000
2025-08-21,O'Reilly Automotive,14,24,2,40,0.050000
2025-08-21,Occidental Petroleum,14,21,5,40,0.125000
2025-08-21,Old Republic International,25,13,2,40,0.050000
2025-08-21,Omnicom,21,14,5,40,0.125000
2025-08-21,Oneok,21,14,5,40,0.125000
2025-08-21,Oracle,11,23,6,40,0.150000
2025-08-21,Oscar Health,12,20,8,40,0.200000
2025-08-21,Oshkosh,8,15,17,40,0.425000
2025-08-21,Otis Worldwide,17,19,4,40,0.100000
2025-08-21,Ovintiv,22,15,3,40,0.075000
2025-08-21,Owens & Minor,10,21,9,40,0.225000
2025-08-21,Owens Corning,18,17,5,40,0.125000
2025-08-21,PBF Energy,34,1,5,40,0.125000
2025-08-21,PG&E,18,12,10,40,0.250000
2025-08-21,PNC,14,21,5,40,0.125000
2025-08-21,PPG Industries,18,15,7,40,0.175000
2025-08-21,PPL,13,24,3,40,0.075000
2025-08-21,PVH,11,17,12,40,0.300000
2025-08-21,Paccar,22,15,3,40,0.075000
2025-08-21,Pacific Life,17,22,1,40,0.025000
2025-08-21,Packaging Corp. of America,9,24,7,40,0.175000
2025-08-21,Palo Alto Networks,16,20,4,40,0.100000
2025-08-21,Par Pacific,19,18,3,40,0.075000
2025-08-21,Paramount Global,7,28,5,40,0.125000
2025-08-21,Parker-Hannifin,20,19,1,40,0.025000
2025-08-21,PayPal,10,17,13,40,0.325000
2025-08-21,Penske Automotive,16,22,2,40,0.050000
2025-08-21,PepsiCo,18,17,5,40,0.125000
2025-08-21,Performance Food,18,20,2,40,0.050000
2025-08-21,Peter Kiewit Sons',6,20,14,40,0.350000
2025-08-21,Pfizer,9,19,12,40,0.300000
2025-08-21,Philip Morris,19,18,3,40,0.075000
2025-08-21,Phillips 66,19,17,4,40,0.100000
2025-08-21,Plains GP,20,16,4,40,0.100000
2025-08-21,Principal Financial,10,27,3,40,0.075000
2025-08-21,Procter & Gamble,17,14,9,40,0.225000
2025-08-21,Progressive Insurance,15,20,5,40,0.125000
2025-08-21,Prologis,18,14,8,40,0.200000
2025-08-21,Prudential Financial,16,20,4,40,0.100000
2025-08-21,Public Service Enterprise,17,19,4,40,0.100000
2025-08-21,Publix Super Markets,16,19,5,40,0.125000
2025-08-21,PulteGroup,18,16,6,40,0.150000
2025-08-21,QVC,13,24,3,40,0.075000
2025-08-21,QXO Building Products,2,5,3,10,0.300000
2025-08-21,Qualcomm,20,15,5,40,0.125000
2025-08-21,Quanta Services,14,17,9,40,0.225000
2025-08-21,Quest Diagnostics,13,26,1,40,0.025000
2025-08-21,RTX,19,15,6,40,0.150000
2025-08-21,Raymond James Financial,17,21,2,40,0.050000
2025-08-21,Regeneron Pharmaceuticals,16,16,8,40,0.200000
2025-08-21,Regions Financial,17,20,3,40,0.075000
2025-08-21,Reinsurance of America,0,4,1,5,0.200000
2025-08-21,Reliance,14,13,13,40,0.325000
2025-08-21,Republic Services,12,10,18,40,0.450000
2025-08-21,Rockwell Automation,16,23,1,40,0.025000
2025-08-21,Ross Stores,10,28,2,40,0.050000
2025-08-21,Rush Enterprises,18,20,2,40,0.050000
2025-08-21,Ryder System,27,10,3,40,0.075000
2025-08-21,S&P Global,15,24,1,40,0.025000
2025-08-21,Salesforce,17,17,6,40,0.150000
2025-08-21,Sanmina,14,24,2,40,0.050000
2025-08-21,Science Applications International,16,20,4,40,0.100000
2025-08-21,Seaboard,9,22,9,40,0.225000
2025-08-21,Securian Financial,14,23,3,40,0.075000
2025-08-21,Sempra,18,20,2,40,0.050000
2025-08-21,ServiceNow,10,26,4,40,0.100000
2025-08-21,Sherwin-Williams,11,18,11,40,0.275000
2025-08-21,Sirius XM,15,19,6,40,0.150000
2025-08-21,Skechers,18,21,1,40,0.025000
2025-08-21,Solventum,15,23,2,40,0.050000
2025-08-21,Sonic Automotive,8,29,3,40,0.075000
2025-08-21,Southern Company,17,21,2,40,0.050000
2025-08-21,Southwest Airlines,7,22,11,40,0.275000
2025-08-21,SpartanNash,16,21,3,40,0.075000
2025-08-21,Sprouts Farmers Market,21,19,0,40,0.000000
2025-08-21,Stanley Black & Decker,11,24,5,40,0.125000
2025-08-21,Starbucks,9,27,4,40,0.100000
2025-08-21,State Farm Insurance,16,18,6,40,0.150000
2025-08-21,State Street,7,15,18,40,0.450000
2025-08-21,Steel Dynamics,35,4,1,40,0.025000
2025-08-21,StoneX,19,19,2,40,0.050000
2025-08-21,Stryker,13,19,8,40,0.200000
2025-08-21,Synchrony Financial,20,19,1,40,0.025000
2025-08-21,Sysco,18,15,7,40,0.175000
2025-08-21,TD Synnex,20,20,0,40,0.000000
2025-08-21,THOR Industries,17,19,4,40,0.100000
2025-08-21,TIAA,13,24,3,40,0.075000
2025-08-21,TJX,21,16,3,40,0.075000
2025-08-21,Targa Resources,19,15,6,40,0.150000
2025-08-21,Target,6,22,12,40,0.300000
2025-08-21,Taylor Morrison Home,16,23,1,40,0.025000
2025-08-21,Tenet Healthcare,13,18,9,40,0.225000
2025-08-21,Tesla,10,13,17,40,0.425000
2025-08-21,Texas Instruments,10,20,10,40,0.250000
2025-08-21,Textron,22,16,2,40,0.050000
2025-08-21,The Andersons,10,29,1,40,0.025000
2025-08-21,Thermo Fisher Scientific,22,15,3,40,0.075000
2025-08-21,Thrivent Financial for Lutherans,20,17,3,40,0.075000
2025-08-21,Toll Brothers,15,23,2,40,0.050000
2025-08-21,Tractor Supply,22,17,1,40,0.025000
2025-08-21,TransDigm,29,8,3,40,0.075000
2025-08-21,Travelers Insurance,8,21,11,40,0.275000
2025-08-21,Truist Financial,15,21,4,40,0.100000
2025-08-21,Tyson Foods,14,24,2,40,0.050000
2025-08-21,U.S. Bancorp,18,17,5,40,0.125000
2025-08-21,UPS,11,14,15,40,0.375000
2025-08-21,US Foods,19,19,2,40,0.050000
2025-08-21,USAA,17,14,9,40,0.225000
2025-08-21,Uber,6,14,20,40,0.500000
2025-08-21,Ulta Beauty,30,5,5,40,0.125000
2025-08-21,Union Pacific,16,16,8,40,0.200000
2025-08-21,United Airlines,29,2,9,40,0.225000
2025-08-21,United Natural Foods,40,0,0,40,0.000000
2025-08-21,United Rentals,33,7,0,40,0.000000
2025-08-21,United States Steel,26,9,5,40,0.125000
2025-08-21,UnitedHealth,16,22,2,40,0.050000
2025-08-21,Universal Health Services,18,18,4,40,0.100000
2025-08-21,Unum,19,14,7,40,0.175000
2025-08-21,VF Corporation,13,21,6,40,0.150000
2025-08-21,Valero Energy,37,1,2,40,0.050000
2025-08-21,Verizon,21,15,4,40,0.100000
2025-08-21,Vertex Pharmaceuticals,11,14,15,40,0.375000
2025-08-21,Vertiv,21,17,2,40,0.050000
2025-08-21,Viatris,14,20,6,40,0.150000
2025-08-21,Vistra,21,11,8,40,0.200000
2025-08-21,Voya Financial,16,20,4,40,0.100000
2025-08-21,Vulcan Materials,13,17,10,40,0.250000
2025-08-21,W.R. Berkley,10,21,9,40,0.225000
2025-08-21,W.W. Grainger,12,21,7,40,0.175000
2025-08-21,WEC Energy,39,1,0,40,0.000000
2025-08-21,WESCO International,22,16,2,40,0.050000
2025-08-21,Walgreens,8,18,14,40,0.350000
2025-08-21,Walmart,13,16,11,40,0.275000
2025-08-21,Walt Disney,25,13,2,40,0.050000
2025-08-21,Warner Bros. Discovery,9,31,0,40,0.000000
2025-08-21,Watsco,14,18,8,40,0.200000
2025-08-21,Wayfair,15,21,4,40,0.100000
2025-08-21,Wells Fargo,32,2,6,40,0.150000
2025-08-21,Welltower,32,8,0,40,0.000000
2025-08-21,Western & Southern Financial,14,24,2,40,0.050000
2025-08-21,Western Digital,14,20,6,40,0.150000
2025-08-21,Westinghouse Air Brake Technologies,17,19,4,40,0.100000
2025-08-21,Whirlpool,13,20,7,40,0.175000
2025-08-21,Williams,9,17,14,40,0.350000
2025-08-21,Williams-Sonoma,14,22,4,40,0.100000
2025-08-21,Workday,12,18,10,40,0.250000
2025-08-21,World Kinect,15,20,5,40,0.125000
2025-08-21,XPO,12,22,6,40,0.150000
2025-08-21,Xcel Energy,28,7,5,40,0.125000
2025-08-21,Xylem,17,21,2,40,0.050000
2025-08-21,Yum Brands,19,12,9,40,0.225000
2025-08-21,Yum China,17,18,5,40,0.125000
2025-08-21,Zimmer Biomet,15,21,4,40,0.100000
2025-08-21,Zoetis,20,18,2,40,0.050000
2025-08-22,1 Automotive,15,24,1,40,0.025000
2025-08-22,3M,21,16,3,40,0.075000
2025-08-22,A-Mark Precious Metals,35,5,0,40,0.000000
2025-08-22,ABM Industries,12,22,6,40,0.150000
2025-08-22,AECOM,18,19,3,40,0.075000
2025-08-22,AES,17,13,10,40,0.250000
2025-08-22,AGCO,15,19,6,40,0.150000
2025-08-22,AIG,12,25,3,40,0.075000
2025-08-22,APA,20,14,6,40,0.150000
2025-08-22,ARKO,9,29,2,40,0.050000
2025-08-22,AT&T,11,23,6,40,0.150000
2025-08-22,AbbVie,18,19,3,40,0.075000
2025-08-22,Abbott Laboratories,19,16,5,40,0.125000
2025-08-22,Ace Hardware,16,19,5,40,0.125000
2025-08-22,Adobe,11,26,3,40,0.075000
2025-08-22,Advance Auto Parts,10,15,15,40,0.375000
2025-08-22,Advanced Micro Devices,27,6,7,40,0.175000
2025-08-22,Aflac,16,14,10,40,0.250000
2025-08-22,Air Products & Chemicals,22,13,5,40,0.125000
2025-08-22,Airbnb,14,19,7,40,0.175000
2025-08-22,Alaska Air,26,13,1,40,0.025000
2025-08-22,Albertsons,22,13,5,40,0.125000
2025-08-22,Alcoa,11,20,9,40,0.225000
2025-08-22,Allstate,18,12,10,40,0.250000
2025-08-22,Ally Financial,15,23,2,40,0.050000
2025-08-22,Alphabet,15,18,7,40,0.175000
2025-08-22,Altice,11,21,8,40,0.200000
2025-08-22,Altria,19,17,4,40,0.100000
2025-08-22,Amazon,30,5,5,40,0.125000
2025-08-22,American Airlines,11,12,17,40,0.425000
2025-08-22,American Electric Power,15,22,3,40,0.075000
2025-08-22,American Express,22,14,4,40,0.100000
2025-08-22,American Family Insurance,25,12,3,40,0.075000
2025-08-22,American Financial,18,18,4,40,0.100000
2025-08-22,American International,14,22,4,40,0.100000
2025-08-22,American Tower,18,14,8,40,0.200000
2025-08-22,Ameriprise Financial,19,19,2,40,0.050000
2025-08-22,Amgen,19,10,11,40,0.275000
2025-08-22,Amphenol,16,20,4,40,0.100000
2025-08-22,Analog Devices,13,25,2,40,0.050000
2025-08-22,Apollo Global Management,17,20,3,40,0.075000
2025-08-22,Apple,10,25,5,40,0.125000
2025-08-22,Applied Materials,5,23,12,40,0.300000
2025-08-22,Aramark,23,14,3,40,0.075000
2025-08-22,Archer Daniels Midland,14,22,4,40,0.100000
2025-08-22,Arrow Electronics,20,20,0,40,0.000000
2025-08-22,Arthur J. Gallagher,8,30,2,40,0.050000
2025-08-22,Asbury Automotive,9,24,7,40,0.175000
2025-08-22,Assurant,23,16,1,40,0.025000
2025-08-22,Auto-Owners Insurance,14,21,5,40,0.125000
2025-08-22,AutoNation,13,23,4,40,0.100000
2025-08-22,AutoZone,12,14,14,40,0.350000
2025-08-22,Autoliv,20,19,1,40,0.025000
2025-08-22,Automatic Data Processing,19,18,3,40,0.075000
2025-08-22,Avery Dennison,15,18,7,40,0.175000
2025-08-22,Avis Budget,13,18,9,40,0.225000
2025-08-22,Avnet,18,22,0,40,0.000000
2025-08-22,BJ's Wholesale Club,19,17,4,40,0.100000
2025-08-22,Baker Hughes,18,14,8,40,0.200000
2025-08-22,Ball,12,20,8,40,0.200000
2025-08-22,Bank of America,16,20,4,40,0.100000
2025-08-22,Bank of New York,24,13,3,40,0.075000
2025-08-22,Baxter International,9,21,10,40,0.250000
2025-08-22,Becton Dickinson,16,20,4,40,0.100000
2025-08-22,Berkshire Hathaway,11,22,7,40,0.175000
2025-08-22,Berry Global,10,22,8,40,0.200000
2025-08-22,Best Buy,40,0,0,40,0.000000
2025-08-22,Biogen,18,19,3,40,0.075000
2025-08-22,BlackRock,11,22,7,40,0.175000
2025-08-22,Blackstone,20,17,3,40,0.075000
2025-08-22,Boeing,13,20,7,40,0.175000
2025-08-22,Booking s,5,5,4,14,0.285714
2025-08-22,Booz Allen Hamilton,16,21,3,40,0.075000
2025-08-22,BorgWarner,21,19,0,40,0.000000
2025-08-22,Boston Scientific,17,17,6,40,0.150000
2025-08-22,BrightSpring Health Services,10,26,4,40,0.100000
2025-08-22,Bristol-Myers Squibb,9,22,9,40,0.225000
2025-08-22,Broadcom,22,15,3,40,0.075000
2025-08-22,Builders FirstSource,11,25,4,40,0.100000
2025-08-22,Burlington Stores,14,25,1,40,0.025000
2025-08-22,C.H. Robinson Worldwide,16,17,7,40,0.175000
2025-08-22,CACI International,21,18,1,40,0.025000
2025-08-22,CBRE,13,26,1,40,0.025000
2025-08-22,CDW,25,15,0,40,0.000000
2025-08-22,CHS,20,17,3,40,0.075000
2025-08-22,CMS Energy,38,0,2,40,0.050000
2025-08-22,CSX,10,19,11,40,0.275000
2025-08-22,CVS Health,14,17,9,40,0.225000
2025-08-22,Caesars Entertainment,33,7,0,40,0.000000
2025-08-22,Campbell's,8,28,4,40,0.100000
2025-08-22,Capital One,18,19,3,40,0.075000
2025-08-22,CarMax,11,21,8,40,0.200000
2025-08-22,Cardinal Health,20,12,8,40,0.200000
2025-08-22,Carrier Global,13,21,6,40,0.150000
2025-08-22,Carvana,19,13,8,40,0.200000
2025-08-22,Casey's General Stores,20,16,4,40,0.100000
2025-08-22,Caterpillar,14,22,4,40,0.100000
2025-08-22,Celanese,11,17,12,40,0.300000
2025-08-22,Cencora,20,20,0,40,0.000000
2025-08-22,Centene,10,12,18,40,0.450000
2025-08-22,CenterPoint Energy,27,6,7,40,0.175000
2025-08-22,Charles Schwab,23,12,5,40,0.125000
2025-08-22,Charter Communications,10,17,13,40,0.325000
2025-08-22,Cheniere Energy,36,4,0,40,0.000000
2025-08-22,Chevron,27,10,3,40,0.075000
2025-08-22,Chewy,16,22,2,40,0.050000
2025-08-22,Chipotle Mexican Grill,23,16,1,40,0.025000
2025-08-22,Cigna,26,9,5,40,0.125000
2025-08-22,Cincinnati Financial,19,18,3,40,0.075000
2025-08-22,Cintas,26,11,3,40,0.075000
2025-08-22,Cisco Systems,19,16,5,40,0.125000
2025-08-22,Citigroup,15,18,7,40,0.175000
2025-08-22,Citizens Financial,17,22,1,40,0.025000
2025-08-22,Cleveland-Cliffs,13,21,6,40,0.150000
2025-08-22,Coca-Cola,18,19,3,40,0.075000
2025-08-22,Cognizant Technology,21,12,7,40,0.175000
2025-08-22,Colgate-Palmolive,18,17,5,40,0.125000
2025-08-22,Comcast,15,21,4,40,0.100000
2025-08-22,Commercial Metals,9,22,9,40,0.225000
2025-08-22,Community Health Systems,15,17,8,40,0.200000
2025-08-22,Conagra Brands,12,23,5,40,0.125000
2025-08-22,Concentrix,19,18,3,40,0.075000
2025-08-22,ConocoPhillips,16,21,3,40,0.075000
2025-08-22,Consolidated Edison,6,30,4,40,0.100000
2025-08-22,Constellation Brands,10,19,11,40,0.275000
2025-08-22,Constellation Energy,36,2,2,40,0.050000
2025-08-22,Core & Main,16,20,4,40,0.100000
2025-08-22,Corebridge Financial,14,23,3,40,0.075000
2025-08-22,Corning,14,21,5,40,0.125000
2025-08-22,Corteva,20,15,5,40,0.125000
2025-08-22,Costco,19,16,5,40,0.125000
2025-08-22,Coupang,16,21,3,40,0.075000
2025-08-22,Cummins,23,12,5,40,0.125000
2025-08-22,D.R. Horton,13,22,5,40,0.125000
2025-08-22,DTE Energy,36,1,3,40,0.075000
2025-08-22,DXC Technology,12,27,1,40,0.025000
2025-08-22,DaVita,11,14,15,40,0.375000
2025-08-22,Danaher,17,21,2,40,0.050000
2025-08-22,Darden Restaurants,13,21,6,40,0.150000
2025-08-22,Deere,10,24,6,40,0.150000
2025-08-22,Delek US,15,15,10,40,0.250000
2025-08-22,Dell Technologies,16,22,2,40,0.050000
2025-08-22,Delta Airlines,17,17,6,40,0.150000
2025-08-22,Devon Energy,37,2,1,40,0.025000
2025-08-22,Diamondback Energy,37,0,3,40,0.075000
2025-08-22,Dick's Sporting Goods,14,25,1,40,0.025000
2025-08-22,Discover Financial,14,21,5,40,0.125000
2025-08-22,Dollar General,9,19,12,40,0.300000
2025-08-22,Dollar Tree,20,15,5,40,0.125000
2025-08-22,Dominion Energy,33,3,4,40,0.100000
2025-08-22,DoorDash,15,13,12,40,0.300000
2025-08-22,Dover,11,17,12,40,0.300000
2025-08-22,DuPont,14,19,7,40,0.175000
2025-08-22,Duke Energy,35,3,2,40,0.050000
2025-08-22,EMCOR,16,23,1,40,0.025000
2025-08-22,EOG Resources,20,19,1,40,0.025000
2025-08-22,Eastman Chemical,6,21,13,40,0.325000
2025-08-22,Ebay,21,14,5,40,0.125000
2025-08-22,EchoStar,12,22,6,40,0.150000
2025-08-22,Ecolab,17,18,5,40,0.125000
2025-08-22,Edison International,9,25,6,40,0.150000
2025-08-22,Edward Jones,14,24,2,40,0.050000
2025-08-22,Electronic Arts,11,25,4,40,0.100000
2025-08-22,Elevance Health,17,7,16,40,0.400000
2025-08-22,Eli Lilly,8,22,10,40,0.250000
2025-08-22,Emerson Electric,18,14,8,40,0.200000
2025-08-22,Endeavor,10,25,5,40,0.125000
2025-08-22,Energy Transfer,31,4,5,40,0.125000
2025-08-22,Entergy,21,15,4,40,0.100000
2025-08-22,Enterprise Products Partners,19,16,5,40,0.125000
2025-08-22,Equinix,24,14,2,40,0.050000
2025-08-22,Equitable,18,18,4,40,0.100000
2025-08-22,Erie Insurance,16,14,10,40,0.250000
2025-08-22,Estée Lauder,11,14,15,40,0.375000
2025-08-22,Eversource Energy,30,6,4,40,0.100000
2025-08-22,Exelon,17,20,3,40,0.075000
2025-08-22,Expedia,18,19,3,40,0.075000
2025-08-22,Expeditors International of Washington,14,22,4,40,0.100000
2025-08-22,Exxon Mobil,22,15,3,40,0.075000
2025-08-22,Fannie Mae,8,26,6,40,0.150000
2025-08-22,Farmers Insurance,8,31,1,40,0.025000
2025-08-22,Fastenal,23,13,4,40,0.100000
2025-08-22,FedEx,33,3,4,40,0.100000
2025-08-22,Ferguson Enterprises,13,23,4,40,0.100000
2025-08-22,Fidelity National Financial,14,24,2,40,0.050000
2025-08-22,Fidelity National Information,20,17,3,40,0.075000
2025-08-22,Fifth Third Bancorp,21,19,0,40,0.000000
2025-08-22,First Citizens BancShares,16,22,2,40,0.050000
2025-08-22,FirstEnergy,12,15,13,40,0.325000
2025-08-22,Fiserv,16,17,7,40,0.175000
2025-08-22,Fluor,13,20,7,40,0.175000
2025-08-22,Foot Locker,11,21,8,40,0.200000
2025-08-22,Ford Motor,18,18,4,40,0.100000
2025-08-22,Franklin Resources,17,18,5,40,0.125000
2025-08-22,Freddie Mac,8,23,9,40,0.225000
2025-08-22,Freeport-McMoRan,18,14,8,40,0.200000
2025-08-22,GE HealthCare Technologies,15,22,3,40,0.075000
2025-08-22,GE Vernova,18,21,1,40,0.025000
2025-08-22,GXO Logistics,14,23,3,40,0.075000
2025-08-22,General Dynamics,36,4,0,40,0.000000
2025-08-22,General Electric,12,27,1,40,0.025000
2025-08-22,General Mills,15,21,4,40,0.100000
2025-08-22,General Motors,16,17,7,40,0.175000
2025-08-22,Genuine Parts,19,17,4,40,0.100000
2025-08-22,Gilead Sciences,14,20,6,40,0.150000
2025-08-22,Global Partners,22,12,6,40,0.150000
2025-08-22,Global Payments,12,28,0,40,0.000000
2025-08-22,Goldman Sachs,11,20,9,40,0.225000
2025-08-22,Goodyear Tire & Rubber,14,25,1,40,0.025000
2025-08-22,Graphic Packaging,10,27,3,40,0.075000
2025-08-22,Graybar Electric,15,18,7,40,0.175000
2025-08-22,Guardian Life,16,22,2,40,0.050000
2025-08-22,GuideWell Mutual,19,20,1,40,0.025000
2025-08-22,HCA Healthcare,23,11,6,40,0.150000
2025-08-22,HF Sinclair,19,15,6,40,0.150000
2025-08-22,HP,14,18,8,40,0.200000
2025-08-22,Halliburton,18,13,9,40,0.225000
2025-08-22,Hartford Insurance,22,14,4,40,0.100000
2025-08-22,Henry Schein,13,25,2,40,0.050000
2025-08-22,Hershey,15,20,5,40,0.125000
2025-08-22,Hertz,32,5,3,40,0.075000
2025-08-22,Hewlett Packard,17,18,5,40,0.125000
2025-08-22,Hilton,12,25,3,40,0.075000
2025-08-22,Home Depot,11,18,11,40,0.275000
2025-08-22,Honeywell,16,22,2,40,0.050000
2025-08-22,Hormel Foods,12,23,5,40,0.125000
2025-08-22,Howmet Aerospace,15,16,9,40,0.225000
2025-08-22,Humana,22,13,5,40,0.125000
2025-08-22,Huntington Bancshares,15,23,2,40,0.050000
2025-08-22,Huntington Ingalls Industries,19,15,6,40,0.150000
2025-08-22,IBM,18,18,4,40,0.100000
2025-08-22,IQVIA,20,13,7,40,0.175000
2025-08-22,Icahn Enterprises,9,22,9,40,0.225000
2025-08-22,Illinois Tool Works,15,19,6,40,0.150000
2025-08-22,Ingram Micro,13,13,14,40,0.350000
2025-08-22,Ingredion,19,16,5,40,0.125000
2025-08-22,Insight Enterprises,16,19,5,40,0.125000
2025-08-22,Intel,15,23,2,40,0.050000
2025-08-22,Interactive Brokers,16,18,6,40,0.150000
2025-08-22,Intercontinental Exchange,18,20,2,40,0.050000
2025-08-22,International Flavors & Fragrances,16,14,10,40,0.250000
2025-08-22,International Paper,3,33,4,40,0.100000
2025-08-22,Interpublic,14,19,7,40,0.175000
2025-08-22,Intuit,18,16,6,40,0.150000
2025-08-22,Intuitive Surgical,13,20,7,40,0.175000
2025-08-22,J.B. Hunt Transport Services,16,18,6,40,0.150000
2025-08-22,J.M. Smucker,12,23,5,40,0.125000
2025-08-22,JPMorgan Chase,11,20,9,40,0.225000
2025-08-22,Jabil,19,18,3,40,0.075000
2025-08-22,Jacobs Solutions,35,2,3,40,0.075000
2025-08-22,Jefferies Financial,15,18,7,40,0.175000
2025-08-22,JetBlue Airways,14,17,9,40,0.225000
2025-08-22,Johnson & Johnson,15,22,3,40,0.075000
2025-08-22,Jones Lang LaSalle,22,18,0,40,0.000000
2025-08-22,KBR,29,8,3,40,0.075000
2025-08-22,KKR,18,16,6,40,0.150000
2025-08-22,KLA,15,15,10,40,0.250000
2025-08-22,Kellanova,17,17,6,40,0.150000
2025-08-22,Kenvue,22,13,5,40,0.125000
2025-08-22,Keurig Dr Pepper,18,13,9,40,0.225000
2025-08-22,KeyCorp,16,17,7,40,0.175000
2025-08-22,Kimberly-Clark,15,19,6,40,0.150000
2025-08-22,Kinder Morgan,39,0,1,40,0.025000
2025-08-22,Kohl's,9,21,10,40,0.250000
2025-08-22,Kraft Heinz,11,22,7,40,0.175000
2025-08-22,Kroger,10,27,3,40,0.075000
2025-08-22,Kyndryl s,8,5,0,13,0.000000
2025-08-22,L3Harris Technologies,23,14,3,40,0.075000
2025-08-22,LKQ,14,18,8,40,0.200000
2025-08-22,LPL Financial,28,11,1,40,0.025000
2025-08-22,Labcorp,17,20,3,40,0.075000
2025-08-22,Lam Research,21,14,5,40,0.125000
2025-08-22,Land O'Lakes,10,29,1,40,0.025000
2025-08-22,Las Vegas Sands,15,23,2,40,0.050000
2025-08-22,Lear Corporation,20,17,3,40,0.075000
2025-08-22,Leidos,22,16,2,40,0.050000
2025-08-22,Lennar,13,23,4,40,0.100000
2025-08-22,Liberty Mutual Insurance,33,1,6,40,0.150000
2025-08-22,Lincoln National,11,19,10,40,0.250000
2025-08-22,Lithia Motors,23,17,0,40,0.000000
2025-08-22,Live Nation Entertainment,28,12,0,40,0.000000
2025-08-22,Lockheed Martin,22,11,7,40,0.175000
2025-08-22,Loews,22,16,2,40,0.050000
2025-08-22,Lowe's,17,17,6,40,0.150000
2025-08-22,Lululemon athletica,17,16,7,40,0.175000
2025-08-22,Lumen Technologies,7,27,6,40,0.150000
2025-08-22,M&T Bank,18,16,6,40,0.150000
2025-08-22,MGM Resorts International,22,14,4,40,0.100000
2025-08-22,Macy's,16,22,2,40,0.050000
2025-08-22,ManpowerGroup,15,20,5,40,0.125000
2025-08-22,Marathon Petroleum,14,24,2,40,0.050000
2025-08-22,Markel Group,15,21,4,40,0.100000
2025-08-22,Marriott International,14,19,7,40,0.175000
2025-08-22,Marsh & McLennan,25,11,4,40,0.100000
2025-08-22,MasTec,17,20,3,40,0.075000
2025-08-22,Masco,11,26,3,40,0.075000
2025-08-22,Mass Mutual,13,25,2,40,0.050000
2025-08-22,Mastercard,13,20,7,40,0.175000
2025-08-22,McDonald's,16,13,11,40,0.275000
2025-08-22,McKesson,17,21,2,40,0.050000
2025-08-22,Merck,15,16,9,40,0.225000
2025-08-22,MetLife,17,22,1,40,0.025000
2025-08-22,Meta,11,23,6,40,0.150000
2025-08-22,Microchip Technology,14,22,4,40,0.100000
2025-08-22,Micron Technology,9,23,8,40,0.200000
2025-08-22,Microsoft,12,17,11,40,0.275000
2025-08-22,Mohawk Industries,17,19,4,40,0.100000
2025-08-22,Molina Healthcare,16,15,9,40,0.225000
2025-08-22,Molson Coors Beverage,20,12,8,40,0.200000
2025-08-22,Mondelez,16,12,12,40,0.300000
2025-08-22,Monster Beverage,19,19,2,40,0.050000
2025-08-22,Morgan Stanley,13,22,5,40,0.125000
2025-08-22,Mosaic,16,24,0,40,0.000000
2025-08-22,Motorola Solutions,40,0,0,40,0.000000
2025-08-22,Murphy USA,18,21,1,40,0.025000
2025-08-22,Mutual of Omaha Insurance,22,18,0,40,0.000000
2025-08-22,NOV,6,25,9,40,0.225000
2025-08-22,NRG Energy,37,2,1,40,0.025000
2025-08-22,NVR,18,15,7,40,0.175000
2025-08-22,Nationwide Insurance,10,19,11,40,0.275000
2025-08-22,Netflix,10,17,13,40,0.325000
2025-08-22,New York Life Insurance,13,24,3,40,0.075000
2025-08-22,Newell Brands,12,23,5,40,0.125000
2025-08-22,Newmont,24,13,3,40,0.075000
2025-08-22,News Corp.,15,18,7,40,0.175000
2025-08-22,NextEra Energy,30,4,6,40,0.150000
2025-08-22,Nike,12,23,5,40,0.125000
2025-08-22,Nordstrom,8,30,2,40,0.050000
2025-08-22,Norfolk Southern,17,16,7,40,0.175000
2025-08-22,Northern Trust,39,0,1,40,0.025000
2025-08-22,Northrop Grumman,18,19,3,40,0.075000
2025-08-22,Northwestern Mutual,20,11,9,40,0.225000
2025-08-22,Nucor,17,18,5,40,0.125000
2025-08-22,Nvidia,9,26,5,40,0.125000
2025-08-22,O'Reilly Automotive,12,23,5,40,0.125000
2025-08-22,Occidental Petroleum,11,21,8,40,0.200000
2025-08-22,Old Republic International,22,16,2,40,0.050000
2025-08-22,Omnicom,20,13,7,40,0.175000
2025-08-22,Oneok,17,20,3,40,0.075000
2025-08-22,Oracle,12,22,6,40,0.150000
2025-08-22,Oscar Health,10,19,11,40,0.275000
2025-08-22,Oshkosh,11,19,10,40,0.250000
2025-08-22,Otis Worldwide,19,17,4,40,0.100000
2025-08-22,Ovintiv,23,14,3,40,0.075000
2025-08-22,Owens & Minor,7,24,9,40,0.225000
2025-08-22,Owens Corning,20,14,6,40,0.150000
2025-08-22,PBF Energy,33,1,6,40,0.150000
2025-08-22,PG&E,17,11,12,40,0.300000
2025-08-22,PNC,17,16,7,40,0.175000
2025-08-22,PPG Industries,19,15,6,40,0.150000
2025-08-22,PPL,13,19,8,40,0.200000
2025-08-22,PVH,11,16,13,40,0.325000
2025-08-22,Paccar,20,16,4,40,0.100000
2025-08-22,Pacific Life,18,21,1,40,0.025000
2025-08-22,Packaging Corp. of America,9,25,6,40,0.150000
2025-08-22,Palo Alto Networks,16,20,4,40,0.100000
2025-08-22,Par Pacific,18,20,2,40,0.050000
2025-08-22,Paramount Global,9,27,4,40,0.100000
2025-08-22,Parker-Hannifin,23,15,2,40,0.050000
2025-08-22,PayPal,14,17,9,40,0.225000
2025-08-22,Penske Automotive,17,21,2,40,0.050000
2025-08-22,PepsiCo,15,18,7,40,0.175000
2025-08-22,Performance Food,17,21,2,40,0.050000
2025-08-22,Peter Kiewit Sons',4,22,14,40,0.350000
2025-08-22,Pfizer,10,21,9,40,0.225000
2025-08-22,Philip Morris,9,24,7,40,0.175000
2025-08-22,Phillips 66,18,17,5,40,0.125000
2025-08-22,Plains GP,19,17,4,40,0.100000
2025-08-22,Principal Financial,9,27,4,40,0.100000
2025-08-22,Procter & Gamble,14,15,11,40,0.275000
2025-08-22,Progressive Insurance,17,20,3,40,0.075000
2025-08-22,Prologis,18,18,4,40,0.100000
2025-08-22,Prudential Financial,23,13,4,40,0.100000
2025-08-22,Public Service Enterprise,16,21,3,40,0.075000
2025-08-22,Publix Super Markets,17,18,5,40,0.125000
2025-08-22,PulteGroup,16,19,5,40,0.125000
2025-08-22,QVC,11,28,1,40,0.025000
2025-08-22,QXO Building Products,2,5,3,10,0.300000
2025-08-22,Qualcomm,19,16,5,40,0.125000
2025-08-22,Quanta Services,21,10,9,40,0.225000
2025-08-22,Quest Diagnostics,12,28,0,40,0.000000
2025-08-22,RTX,18,14,8,40,0.200000
2025-08-22,Raymond James Financial,19,19,2,40,0.050000
2025-08-22,Regeneron Pharmaceuticals,21,15,4,40,0.100000
2025-08-22,Regions Financial,21,16,3,40,0.075000
2025-08-22,Reinsurance of America,0,4,1,5,0.200000
2025-08-22,Reliance,8,17,15,40,0.375000
2025-08-22,Republic Services,11,12,17,40,0.425000
2025-08-22,Rockwell Automation,18,21,1,40,0.025000
2025-08-22,Ross Stores,20,19,1,40,0.025000
2025-08-22,Rush Enterprises,17,20,3,40,0.075000
2025-08-22,Ryder System,27,10,3,40,0.075000
2025-08-22,S&P Global,14,25,1,40,0.025000
2025-08-22,Salesforce,15,18,7,40,0.175000
2025-08-22,Sanmina,17,21,2,40,0.050000
2025-08-22,Science Applications International,16,20,4,40,0.100000
2025-08-22,Seaboard,10,20,10,40,0.250000
2025-08-22,Securian Financial,13,24,3,40,0.075000
2025-08-22,Sempra,19,20,1,40,0.025000
2025-08-22,ServiceNow,8,28,4,40,0.100000
2025-08-22,Sherwin-Williams,13,18,9,40,0.225000
2025-08-22,Sirius XM,16,19,5,40,0.125000
2025-08-22,Skechers,19,18,3,40,0.075000
2025-08-22,Solventum,14,22,4,40,0.100000
2025-08-22,Sonic Automotive,10,26,4,40,0.100000
2025-08-22,Southern Company,16,22,2,40,0.050000
2025-08-22,Southwest Airlines,5,26,9,40,0.225000
2025-08-22,SpartanNash,15,22,3,40,0.075000
2025-08-22,Sprouts Farmers Market,19,20,1,40,0.025000
2025-08-22,Stanley Black & Decker,12,25,3,40,0.075000
2025-08-22,Starbucks,10,27,3,40,0.075000
2025-08-22,State Farm Insurance,15,17,8,40,0.200000
2025-08-22,State Street,7,16,17,40,0.425000
2025-08-22,Steel Dynamics,34,5,1,40,0.025000
2025-08-22,StoneX,18,20,2,40,0.050000
2025-08-22,Stryker,14,19,7,40,0.175000
2025-08-22,Synchrony Financial,20,19,1,40,0.025000
2025-08-22,Sysco,20,16,4,40,0.100000
2025-08-22,TD Synnex,19,21,0,40,0.000000
2025-08-22,THOR Industries,16,18,6,40,0.150000
2025-08-22,TIAA,14,24,2,40,0.050000
2025-08-22,TJX,12,22,6,40,0.150000
2025-08-22,Targa Resources,20,13,7,40,0.175000
2025-08-22,Target,3,23,14,40,0.350000
2025-08-22,Taylor Morrison Home,15,24,1,40,0.025000
2025-08-22,Tenet Healthcare,16,16,8,40,0.200000
2025-08-22,Tesla,8,14,18,40,0.450000
2025-08-22,Texas Instruments,10,22,8,40,0.200000
2025-08-22,Textron,20,17,3,40,0.075000
2025-08-22,The Andersons,11,29,0,40,0.000000
2025-08-22,Thermo Fisher Scientific,16,21,3,40,0.075000
2025-08-22,Thrivent Financial for Lutherans,20,18,2,40,0.050000
2025-08-22,Toll Brothers,15,22,3,40,0.075000
2025-08-22,Tractor Supply,23,15,2,40,0.050000
2025-08-22,TransDigm,27,9,4,40,0.100000
2025-08-22,Travelers Insurance,10,20,10,40,0.250000
2025-08-22,Truist Financial,20,17,3,40,0.075000
2025-08-22,Tyson Foods,10,26,4,40,0.100000
2025-08-22,U.S. Bancorp,21,17,2,40,0.050000
2025-08-22,UPS,7,19,14,40,0.350000
2025-08-22,US Foods,16,23,1,40,0.025000
2025-08-22,USAA,17,15,8,40,0.200000
2025-08-22,Uber,12,8,20,40,0.500000
2025-08-22,Ulta Beauty,32,5,3,40,0.075000
2025-08-22,Union Pacific,13,18,9,40,0.225000
2025-08-22,United Airlines,33,1,6,40,0.150000
2025-08-22,United Natural Foods,40,0,0,40,0.000000
2025-08-22,United Rentals,34,6,0,40,0.000000
2025-08-22,United States Steel,27,11,2,40,0.050000
2025-08-22,UnitedHealth,10,23,7,40,0.175000
2025-08-22,Universal Health Services,17,20,3,40,0.075000
2025-08-22,Unum,16,17,7,40,0.175000
2025-08-22,VF Corporation,14,21,5,40,0.125000
2025-08-22,Valero Energy,37,1,2,40,0.050000
2025-08-22,Verizon,23,12,5,40,0.125000
2025-08-22,Vertex Pharmaceuticals,13,14,13,40,0.325000
2025-08-22,Vertiv,24,14,2,40,0.050000
2025-08-22,Viatris,13,21,6,40,0.150000
2025-08-22,Vistra,21,13,6,40,0.150000
2025-08-22,Voya Financial,13,24,3,40,0.075000
2025-08-22,Vulcan Materials,14,16,10,40,0.250000
2025-08-22,W.R. Berkley,10,23,7,40,0.175000
2025-08-22,W.W. Grainger,14,19,7,40,0.175000
2025-08-22,WEC Energy,39,1,0,40,0.000000
2025-08-22,WESCO International,21,17,2,40,0.050000
2025-08-22,Walgreens,8,16,16,40,0.400000
2025-08-22,Walmart,11,12,17,40,0.425000
2025-08-22,Walt Disney,21,18,1,40,0.025000
2025-08-22,Warner Bros. Discovery,4,33,3,40,0.075000
2025-08-22,Watsco,14,18,8,40,0.200000
2025-08-22,Wayfair,15,22,3,40,0.075000
2025-08-22,Wells Fargo,34,2,4,40,0.100000
2025-08-22,Welltower,32,8,0,40,0.000000
2025-08-22,Western & Southern Financial,14,24,2,40,0.050000
2025-08-22,Western Digital,15,20,5,40,0.125000
2025-08-22,Westinghouse Air Brake Technologies,18,19,3,40,0.075000
2025-08-22,Whirlpool,13,17,10,40,0.250000
2025-08-22,Williams,22,10,8,40,0.200000
2025-08-22,Williams-Sonoma,14,23,3,40,0.075000
2025-08-22,Workday,12,15,13,40,0.325000
2025-08-22,World Kinect,14,22,4,40,0.100000
2025-08-22,XPO,10,25,5,40,0.125000
2025-08-22,Xcel Energy,28,7,5,40,0.125000
2025-08-22,Xylem,18,19,3,40,0.075000
2025-08-22,Yum Brands,21,13,6,40,0.150000
2025-08-22,Yum China,18,16,6,40,0.150000
2025-08-22,Zimmer Biomet,16,20,4,40,0.100000
2025-08-22,Zoetis,25,13,2,40,0.050000
2025-08-23,1 Automotive,15,22,3,40,0.075000
2025-08-23,3M,23,15,2,40,0.050000
2025-08-23,A-Mark Precious Metals,38,2,0,40,0.000000
2025-08-23,ABM Industries,14,21,5,40,0.125000
2025-08-23,AECOM,17,20,3,40,0.075000
2025-08-23,AES,16,15,9,40,0.225000
2025-08-23,AGCO,16,17,7,40,0.175000
2025-08-23,AIG,11,27,2,40,0.050000
2025-08-23,APA,19,14,7,40,0.175000
2025-08-23,ARKO,14,21,5,40,0.125000
2025-08-23,AT&T,12,22,6,40,0.150000
2025-08-23,AbbVie,18,18,4,40,0.100000
2025-08-23,Abbott Laboratories,19,16,5,40,0.125000
2025-08-23,Ace Hardware,17,19,4,40,0.100000
2025-08-23,Adobe,10,25,5,40,0.125000
2025-08-23,Advance Auto Parts,9,16,15,40,0.375000
2025-08-23,Advanced Micro Devices,29,3,8,40,0.200000
2025-08-23,Aflac,14,16,10,40,0.250000
2025-08-23,Air Products & Chemicals,20,15,5,40,0.125000
2025-08-23,Airbnb,13,18,9,40,0.225000
2025-08-23,Alaska Air,26,12,2,40,0.050000
2025-08-23,Albertsons,22,12,6,40,0.150000
2025-08-23,Alcoa,11,21,8,40,0.200000
2025-08-23,Allstate,17,16,7,40,0.175000
2025-08-23,Ally Financial,16,22,2,40,0.050000
2025-08-23,Alphabet,17,20,3,40,0.075000
2025-08-23,Altice,13,21,6,40,0.150000
2025-08-23,Altria,20,16,4,40,0.100000
2025-08-23,Amazon,31,3,6,40,0.150000
2025-08-23,American Airlines,10,15,15,40,0.375000
2025-08-23,American Electric Power,18,18,4,40,0.100000
2025-08-23,American Express,28,9,3,40,0.075000
2025-08-23,American Family Insurance,25,12,3,40,0.075000
2025-08-23,American Financial,21,16,3,40,0.075000
2025-08-23,American International,16,21,3,40,0.075000
2025-08-23,American Tower,17,15,8,40,0.200000
2025-08-23,Ameriprise Financial,22,14,4,40,0.100000
2025-08-23,Amgen,25,7,8,40,0.200000
2025-08-23,Amphenol,20,17,3,40,0.075000
2025-08-23,Analog Devices,20,20,0,40,0.000000
2025-08-23,Apollo Global Management,20,19,1,40,0.025000
2025-08-23,Apple,11,24,5,40,0.125000
2025-08-23,Applied Materials,5,20,15,40,0.375000
2025-08-23,Aramark,24,14,2,40,0.050000
2025-08-23,Archer Daniels Midland,15,23,2,40,0.050000
2025-08-23,Arrow Electronics,18,19,3,40,0.075000
2025-08-23,Arthur J. Gallagher,8,30,2,40,0.050000
2025-08-23,Asbury Automotive,9,25,6,40,0.150000
2025-08-23,Assurant,22,17,1,40,0.025000
2025-08-23,Auto-Owners Insurance,14,21,5,40,0.125000
2025-08-23,AutoNation,14,20,6,40,0.150000
2025-08-23,AutoZone,15,10,15,40,0.375000
2025-08-23,Autoliv,21,17,2,40,0.050000
2025-08-23,Automatic Data Processing,22,15,3,40,0.075000
2025-08-23,Avery Dennison,14,19,7,40,0.175000
2025-08-23,Avis Budget,13,17,10,40,0.250000
2025-08-23,BJ's Wholesale Club,19,16,5,40,0.125000
2025-08-23,Baker Hughes,17,14,9,40,0.225000
2025-08-23,Ball,11,19,10,40,0.250000
2025-08-23,Bank of America,20,12,8,40,0.200000
2025-08-23,Bank of New York,21,15,4,40,0.100000
2025-08-23,Baxter International,16,16,8,40,0.200000
2025-08-23,Becton Dickinson,17,18,5,40,0.125000
2025-08-23,Berkshire Hathaway,11,21,8,40,0.200000
2025-08-23,Berry Global,8,23,9,40,0.225000
2025-08-23,Best Buy,40,0,0,40,0.000000
2025-08-23,Biogen,17,18,5,40,0.125000
2025-08-23,BlackRock,23,13,4,40,0.100000
2025-08-23,Blackstone,19,16,5,40,0.125000
2025-08-23,Boeing,11,20,9,40,0.225000
2025-08-23,Booking s,5,5,4,14,0.285714
2025-08-23,Booz Allen Hamilton,17,19,4,40,0.100000
2025-08-23,BorgWarner,21,16,3,40,0.075000
2025-08-23,Boston Scientific,19,15,6,40,0.150000
2025-08-23,BrightSpring Health Services,25,12,3,40,0.075000
2025-08-23,Bristol-Myers Squibb,11,24,5,40,0.125000
2025-08-23,Broadcom,19,17,4,40,0.100000
2025-08-23,Builders FirstSource,15,19,6,40,0.150000
2025-08-23,Burlington Stores,17,20,3,40,0.075000
2025-08-23,C.H. Robinson Worldwide,17,20,3,40,0.075000
2025-08-23,CACI International,21,17,2,40,0.050000
2025-08-23,CBRE,18,21,1,40,0.025000
2025-08-23,CDW,25,15,0,40,0.000000
2025-08-23,CHS,22,14,4,40,0.100000
2025-08-23,CMS Energy,36,1,3,40,0.075000
2025-08-23,CSX,10,20,10,40,0.250000
2025-08-23,CVS Health,15,18,7,40,0.175000
2025-08-23,Caesars Entertainment,31,9,0,40,0.000000
2025-08-23,Campbell's,14,23,3,40,0.075000
2025-08-23,Capital One,21,16,3,40,0.075000
2025-08-23,CarMax,9,26,5,40,0.125000
2025-08-23,Cardinal Health,22,10,8,40,0.200000
2025-08-23,Carrier Global,22,14,4,40,0.100000
2025-08-23,Carvana,16,18,6,40,0.150000
2025-08-23,Casey's General Stores,23,14,3,40,0.075000
2025-08-23,Caterpillar,19,17,4,40,0.100000
2025-08-23,Celanese,14,17,9,40,0.225000
2025-08-23,Cencora,21,17,2,40,0.050000
2025-08-23,Centene,14,13,13,40,0.325000
2025-08-23,CenterPoint Energy,28,6,6,40,0.150000
2025-08-23,Charles Schwab,23,16,1,40,0.025000
2025-08-23,Charter Communications,17,12,11,40,0.275000
2025-08-23,Cheniere Energy,39,1,0,40,0.000000
2025-08-23,Chevron,21,16,3,40,0.075000
2025-08-23,Chewy,18,18,4,40,0.100000
2025-08-23,Chipotle Mexican Grill,17,19,4,40,0.100000
2025-08-23,Cigna,26,11,3,40,0.075000
2025-08-23,Cincinnati Financial,15,23,2,40,0.050000
2025-08-23,Cintas,20,20,0,40,0.000000
2025-08-23,Cisco Systems,12,21,7,40,0.175000
2025-08-23,Citigroup,20,15,5,40,0.125000
2025-08-23,Citizens Financial,24,16,0,40,0.000000
2025-08-23,Cleveland-Cliffs,17,20,3,40,0.075000
2025-08-23,Coca-Cola,15,20,5,40,0.125000
2025-08-23,Cognizant Technology,25,8,7,40,0.175000
2025-08-23,Colgate-Palmolive,20,14,6,40,0.150000
2025-08-23,Comcast,23,13,4,40,0.100000
2025-08-23,Commercial Metals,11,20,9,40,0.225000
2025-08-23,Community Health Systems,17,14,9,40,0.225000
2025-08-23,Conagra Brands,14,22,4,40,0.100000
2025-08-23,Concentrix,22,15,3,40,0.075000
2025-08-23,ConocoPhillips,16,22,2,40,0.050000
2025-08-23,Consolidated Edison,10,28,2,40,0.050000
2025-08-23,Constellation Brands,14,16,10,40,0.250000
2025-08-23,Constellation Energy,36,3,1,40,0.025000
2025-08-23,Core & Main,14,22,4,40,0.100000
2025-08-23,Corebridge Financial,27,10,3,40,0.075000
2025-08-23,Corning,11,22,7,40,0.175000
2025-08-23,Corteva,22,14,4,40,0.100000
2025-08-23,Costco,18,15,7,40,0.175000
2025-08-23,Coupang,16,21,3,40,0.075000
2025-08-23,Cummins,26,11,3,40,0.075000
2025-08-23,D.R. Horton,14,19,7,40,0.175000
2025-08-23,DTE Energy,33,4,3,40,0.075000
2025-08-23,DXC Technology,17,21,2,40,0.050000
2025-08-23,DaVita,10,13,17,40,0.425000
2025-08-23,Danaher,21,16,3,40,0.075000
2025-08-23,Darden Restaurants,19,16,5,40,0.125000
2025-08-23,Deere,9,24,7,40,0.175000
2025-08-23,Delek US,21,15,4,40,0.100000
2025-08-23,Dell Technologies,18,21,1,40,0.025000
2025-08-23,Delta Airlines,17,16,7,40,0.175000
2025-08-23,Devon Energy,38,1,1,40,0.025000
2025-08-23,Diamondback Energy,36,1,3,40,0.075000
2025-08-23,Dick's Sporting Goods,11,27,2,40,0.050000
2025-08-23,Discover Financial,15,20,5,40,0.125000
2025-08-23,Dollar General,8,17,15,40,0.375000
2025-08-23,Dollar Tree,20,15,5,40,0.125000
2025-08-23,Dominion Energy,34,3,3,40,0.075000
2025-08-23,DoorDash,17,17,6,40,0.150000
2025-08-23,Dover,9,19,12,40,0.300000
2025-08-23,DuPont,14,20,6,40,0.150000
2025-08-23,Duke Energy,38,1,1,40,0.025000
2025-08-23,EMCOR,19,20,1,40,0.025000
2025-08-23,EOG Resources,21,17,2,40,0.050000
2025-08-23,Eastman Chemical,10,21,9,40,0.225000
2025-08-23,Ebay,19,17,4,40,0.100000
2025-08-23,EchoStar,16,20,4,40,0.100000
2025-08-23,Ecolab,19,17,4,40,0.100000
2025-08-23,Edison International,11,24,5,40,0.125000
2025-08-23,Edward Jones,16,21,3,40,0.075000
2025-08-23,Electronic Arts,17,19,4,40,0.100000
2025-08-23,Elevance Health,14,9,17,40,0.425000
2025-08-23,Eli Lilly,12,18,10,40,0.250000
2025-08-23,Emerson Electric,24,13,3,40,0.075000
2025-08-23,Endeavor,11,24,5,40,0.125000
2025-08-23,Energy Transfer,35,2,3,40,0.075000
2025-08-23,Entergy,24,13,3,40,0.075000
2025-08-23,Enterprise Products Partners,19,9,12,40,0.300000
2025-08-23,Equinix,22,14,4,40,0.100000
2025-08-23,Equitable,13,22,5,40,0.125000
2025-08-23,Erie Insurance,15,15,10,40,0.250000
2025-08-23,Estée Lauder,13,14,13,40,0.325000
2025-08-23,Eversource Energy,30,6,4,40,0.100000
2025-08-23,Exelon,17,20,3,40,0.075000
2025-08-23,Expedia,20,18,2,40,0.050000
2025-08-23,Expeditors International of Washington,18,17,5,40,0.125000
2025-08-23,Exxon Mobil,17,20,3,40,0.075000
2025-08-23,Fannie Mae,3,31,6,40,0.150000
2025-08-23,Farmers Insurance,8,30,2,40,0.050000
2025-08-23,Fastenal,17,18,5,40,0.125000
2025-08-23,FedEx,32,5,3,40,0.075000
2025-08-23,Ferguson Enterprises,18,17,5,40,0.125000
2025-08-23,Fidelity National Financial,20,16,4,40,0.100000
2025-08-23,Fidelity National Information,22,15,3,40,0.075000
2025-08-23,Fifth Third Bancorp,27,11,2,40,0.050000
2025-08-23,First Citizens BancShares,21,19,0,40,0.000000
2025-08-23,FirstEnergy,14,15,11,40,0.275000
2025-08-23,Fiserv,16,19,5,40,0.125000
2025-08-23,Fluor,19,15,6,40,0.150000
2025-08-23,Foot Locker,9,21,10,40,0.250000
2025-08-23,Ford Motor,22,14,4,40,0.100000
2025-08-23,Franklin Resources,16,18,6,40,0.150000
2025-08-23,Freddie Mac,7,25,8,40,0.200000
2025-08-23,Freeport-McMoRan,16,16,8,40,0.200000
2025-08-23,GE HealthCare Technologies,17,21,2,40,0.050000
2025-08-23,GE Vernova,17,20,3,40,0.075000
2025-08-23,GXO Logistics,17,18,5,40,0.125000
2025-08-23,General Dynamics,38,2,0,40,0.000000
2025-08-23,General Electric,11,29,0,40,0.000000
2025-08-23,General Mills,14,20,6,40,0.150000
2025-08-23,General Motors,16,16,8,40,0.200000
2025-08-23,Genuine Parts,20,16,4,40,0.100000
2025-08-23,Gilead Sciences,16,20,4,40,0.100000
2025-08-23,Global Partners,19,16,5,40,0.125000
2025-08-23,Global Payments,17,22,1,40,0.025000
2025-08-23,Goldman Sachs,16,17,7,40,0.175000
2025-08-23,Goodyear Tire & Rubber,13,24,3,40,0.075000
2025-08-23,Graphic Packaging,10,25,5,40,0.125000
2025-08-23,Graybar Electric,15,18,7,40,0.175000
2025-08-23,Guardian Life,17,21,2,40,0.050000
2025-08-23,GuideWell Mutual,20,19,1,40,0.025000
2025-08-23,HCA Healthcare,21,10,9,40,0.225000
2025-08-23,HF Sinclair,20,14,6,40,0.150000
2025-08-23,HP,17,16,7,40,0.175000
2025-08-23,Halliburton,25,12,3,40,0.075000
2025-08-23,Hartford Insurance,21,17,2,40,0.050000
2025-08-23,Henry Schein,13,23,4,40,0.100000
2025-08-23,Hershey,21,14,5,40,0.125000
2025-08-23,Hertz,27,6,7,40,0.175000
2025-08-23,Hewlett Packard,21,15,4,40,0.100000
2025-08-23,Hilton,14,21,5,40,0.125000
2025-08-23,Home Depot,10,19,11,40,0.275000
2025-08-23,Honeywell,12,24,4,40,0.100000
2025-08-23,Hormel Foods,12,23,5,40,0.125000
2025-08-23,Howmet Aerospace,13,18,9,40,0.225000
2025-08-23,Humana,26,12,2,40,0.050000
2025-08-23,Huntington Bancshares,17,20,3,40,0.075000
2025-08-23,Huntington Ingalls Industries,25,11,4,40,0.100000
2025-08-23,IBM,16,19,5,40,0.125000
2025-08-23,IQVIA,21,12,7,40,0.175000
2025-08-23,Icahn Enterprises,17,15,8,40,0.200000
2025-08-23,Illinois Tool Works,14,22,4,40,0.100000
2025-08-23,Ingram Micro,14,15,11,40,0.275000
2025-08-23,Ingredion,21,17,2,40,0.050000
2025-08-23,Insight Enterprises,23,11,6,40,0.150000
2025-08-23,Intel,14,22,4,40,0.100000
2025-08-23,Interactive Brokers,12,20,8,40,0.200000
2025-08-23,Intercontinental Exchange,16,22,2,40,0.050000
2025-08-23,International Flavors & Fragrances,18,15,7,40,0.175000
2025-08-23,International Paper,3,32,5,40,0.125000
2025-08-23,Interpublic,21,11,8,40,0.200000
2025-08-23,Intuit,14,21,5,40,0.125000
2025-08-23,Intuitive Surgical,13,19,8,40,0.200000
2025-08-23,J.B. Hunt Transport Services,21,17,2,40,0.050000
2025-08-23,J.M. Smucker,11,21,8,40,0.200000
2025-08-23,JPMorgan Chase,19,15,6,40,0.150000
2025-08-23,Jabil,17,17,6,40,0.150000
2025-08-23,Jacobs Solutions,38,1,1,40,0.025000
2025-08-23,Jefferies Financial,14,19,7,40,0.175000
2025-08-23,JetBlue Airways,14,15,11,40,0.275000
2025-08-23,Johnson & Johnson,26,12,2,40,0.050000
2025-08-23,Jones Lang LaSalle,21,17,2,40,0.050000
2025-08-23,KBR,29,9,2,40,0.050000
2025-08-23,KKR,18,18,4,40,0.100000
2025-08-23,KLA,15,16,9,40,0.225000
2025-08-23,Kellanova,20,16,4,40,0.100000
2025-08-23,Kenvue,20,14,6,40,0.150000
2025-08-23,Keurig Dr Pepper,15,17,8,40,0.200000
2025-08-23,KeyCorp,22,11,7,40,0.175000
2025-08-23,Kimberly-Clark,18,15,7,40,0.175000
2025-08-23,Kinder Morgan,40,0,0,40,0.000000
2025-08-23,Kohl's,12,18,10,40,0.250000
2025-08-23,Kraft Heinz,12,17,11,40,0.275000
2025-08-23,Kroger,9,25,6,40,0.150000
2025-08-23,Kyndryl s,8,6,0,14,0.000000
2025-08-23,L3Harris Technologies,26,10,4,40,0.100000
2025-08-23,LKQ,21,18,1,40,0.025000
2025-08-23,LPL Financial,24,15,1,40,0.025000
2025-08-23,Labcorp,19,17,4,40,0.100000
2025-08-23,Lam Research,18,17,5,40,0.125000
2025-08-23,Land O'Lakes,10,27,3,40,0.075000
2025-08-23,Las Vegas Sands,13,24,3,40,0.075000
2025-08-23,Lear Corporation,16,17,7,40,0.175000
2025-08-23,Leidos,20,19,1,40,0.025000
2025-08-23,Lennar,13,22,5,40,0.125000
2025-08-23,Liberty Mutual Insurance,32,1,7,40,0.175000
2025-08-23,Lincoln National,17,18,5,40,0.125000
2025-08-23,Lithia Motors,23,15,2,40,0.050000
2025-08-23,Live Nation Entertainment,31,8,1,40,0.025000
2025-08-23,Lockheed Martin,26,8,6,40,0.150000
2025-08-23,Loews,20,17,3,40,0.075000
2025-08-23,Lowe's,18,16,6,40,0.150000
2025-08-23,Lululemon athletica,19,16,5,40,0.125000
2025-08-23,Lumen Technologies,12,25,3,40,0.075000
2025-08-23,M&T Bank,18,16,6,40,0.150000
2025-08-23,MGM Resorts International,21,16,3,40,0.075000
2025-08-23,Macy's,18,21,1,40,0.025000
2025-08-23,ManpowerGroup,15,18,7,40,0.175000
2025-08-23,Marathon Petroleum,19,21,0,40,0.000000
2025-08-23,Markel Group,26,12,2,40,0.050000
2025-08-23,Marriott International,19,15,6,40,0.150000
2025-08-23,Marsh & McLennan,22,12,6,40,0.150000
2025-08-23,MasTec,16,19,5,40,0.125000
2025-08-23,Masco,12,22,6,40,0.150000
2025-08-23,Mass Mutual,14,24,2,40,0.050000
2025-08-23,Mastercard,13,19,8,40,0.200000
2025-08-23,McDonald's,16,14,10,40,0.250000
2025-08-23,McKesson,18,20,2,40,0.050000
2025-08-23,Merck,12,17,11,40,0.275000
2025-08-23,MetLife,18,20,2,40,0.050000
2025-08-23,Meta,10,22,8,40,0.200000
2025-08-23,Microchip Technology,16,20,4,40,0.100000
2025-08-23,Micron Technology,10,23,7,40,0.175000
2025-08-23,Microsoft,7,19,14,40,0.350000
2025-08-23,Mohawk Industries,19,16,5,40,0.125000
2025-08-23,Molina Healthcare,15,14,11,40,0.275000
2025-08-23,Molson Coors Beverage,15,17,8,40,0.200000
2025-08-23,Mondelez,16,12,12,40,0.300000
2025-08-23,Monster Beverage,22,15,3,40,0.075000
2025-08-23,Morgan Stanley,15,16,9,40,0.225000
2025-08-23,Mosaic,14,24,2,40,0.050000
2025-08-23,Motorola Solutions,39,0,1,40,0.025000
2025-08-23,Murphy USA,18,20,2,40,0.050000
2025-08-23,Mutual of Omaha Insurance,19,21,0,40,0.000000
2025-08-23,NOV,5,27,8,40,0.200000
2025-08-23,NRG Energy,36,3,1,40,0.025000
2025-08-23,NVR,18,11,11,40,0.275000
2025-08-23,Nationwide Insurance,10,19,11,40,0.275000
2025-08-23,Netflix,15,21,4,40,0.100000
2025-08-23,New York Life Insurance,14,23,3,40,0.075000
2025-08-23,Newell Brands,15,20,5,40,0.125000
2025-08-23,Newmont,21,17,2,40,0.050000
2025-08-23,News Corp.,14,18,8,40,0.200000
2025-08-23,NextEra Energy,34,3,3,40,0.075000
2025-08-23,Nike,12,22,6,40,0.150000
2025-08-23,Nordstrom,10,29,1,40,0.025000
2025-08-23,Norfolk Southern,17,16,7,40,0.175000
2025-08-23,Northern Trust,40,0,0,40,0.000000
2025-08-23,Northrop Grumman,20,18,2,40,0.050000
2025-08-23,Northwestern Mutual,18,12,10,40,0.250000
2025-08-23,Nucor,18,18,4,40,0.100000
2025-08-23,Nvidia,11,23,6,40,0.150000
2025-08-23,O'Reilly Automotive,15,23,2,40,0.050000
2025-08-23,Occidental Petroleum,11,24,5,40,0.125000
2025-08-23,Old Republic International,22,14,4,40,0.100000
2025-08-23,Omnicom,19,13,8,40,0.200000
2025-08-23,Oneok,21,18,1,40,0.025000
2025-08-23,Oracle,13,20,7,40,0.175000
2025-08-23,Oscar Health,12,17,11,40,0.275000
2025-08-23,Oshkosh,12,21,7,40,0.175000
2025-08-23,Otis Worldwide,18,15,7,40,0.175000
2025-08-23,Ovintiv,27,11,2,40,0.050000
2025-08-23,Owens & Minor,6,21,13,40,0.325000
2025-08-23,Owens Corning,23,12,5,40,0.125000
2025-08-23,PBF Energy,36,2,2,40,0.050000
2025-08-23,PG&E,14,14,12,40,0.300000
2025-08-23,PNC,15,19,6,40,0.150000
2025-08-23,PPG Industries,18,14,8,40,0.200000
2025-08-23,PPL,17,15,8,40,0.200000
2025-08-23,PVH,11,15,14,40,0.350000
2025-08-23,Paccar,26,10,4,40,0.100000
2025-08-23,Pacific Life,18,21,1,40,0.025000
2025-08-23,Packaging Corp. of America,10,25,5,40,0.125000
2025-08-23,Palo Alto Networks,17,19,4,40,0.100000
2025-08-23,Par Pacific,21,16,3,40,0.075000
2025-08-23,Paramount Global,12,21,7,40,0.175000
2025-08-23,Parker-Hannifin,23,15,2,40,0.050000
2025-08-23,PayPal,15,19,6,40,0.150000
2025-08-23,Penske Automotive,19,19,2,40,0.050000
2025-08-23,PepsiCo,25,11,4,40,0.100000
2025-08-23,Performance Food,21,15,4,40,0.100000
2025-08-23,Peter Kiewit Sons',4,22,14,40,0.350000
2025-08-23,Pfizer,10,16,14,40,0.350000
2025-08-23,Philip Morris,12,21,7,40,0.175000
2025-08-23,Phillips 66,16,18,6,40,0.150000
2025-08-23,Plains GP,17,14,9,40,0.225000
2025-08-23,Principal Financial,12,23,5,40,0.125000
2025-08-23,Procter & Gamble,19,15,6,40,0.150000
2025-08-23,Progressive Insurance,17,20,3,40,0.075000
2025-08-23,Prologis,22,14,4,40,0.100000
2025-08-23,Prudential Financial,23,13,4,40,0.100000
2025-08-23,Public Service Enterprise,14,24,2,40,0.050000
2025-08-23,Publix Super Markets,17,19,4,40,0.100000
2025-08-23,PulteGroup,19,13,8,40,0.200000
2025-08-23,QVC,14,23,3,40,0.075000
2025-08-23,QXO Building Products,2,5,3,10,0.300000
2025-08-23,Qualcomm,19,14,7,40,0.175000
2025-08-23,Quanta Services,19,12,9,40,0.225000
2025-08-23,Quest Diagnostics,20,17,3,40,0.075000
2025-08-23,RTX,18,14,8,40,0.200000
2025-08-23,Raymond James Financial,24,14,2,40,0.050000
2025-08-23,Regeneron Pharmaceuticals,23,15,2,40,0.050000
2025-08-23,Regions Financial,20,15,5,40,0.125000
2025-08-23,Reinsurance of America,0,5,1,6,0.166667
2025-08-23,Reliance Inc,21,14,5,40,0.125000
2025-08-23,Republic Services,20,9,11,40,0.275000
2025-08-23,Rockwell Automation,19,20,1,40,0.025000
2025-08-23,Ross Stores,23,17,0,40,0.000000
2025-08-23,Rush Enterprises,20,16,4,40,0.100000
2025-08-23,Ryder System,25,8,7,40,0.175000
2025-08-23,S&P Global,13,26,1,40,0.025000
2025-08-23,Salesforce,15,19,6,40,0.150000
2025-08-23,Sanmina,20,16,4,40,0.100000
2025-08-23,Science Applications International,15,20,5,40,0.125000
2025-08-23,Seaboard,8,20,12,40,0.300000
2025-08-23,Securian Financial,10,25,5,40,0.125000
2025-08-23,Sempra,18,21,1,40,0.025000
2025-08-23,ServiceNow,20,18,2,40,0.050000
2025-08-23,Sherwin-Williams,14,20,6,40,0.150000
2025-08-23,Sirius XM,15,22,3,40,0.075000
2025-08-23,Skechers,18,19,3,40,0.075000
2025-08-23,Solventum,13,21,6,40,0.150000
2025-08-23,Sonic Automotive,14,24,2,40,0.050000
2025-08-23,Southern Company,16,21,3,40,0.075000
2025-08-23,Southwest Airlines,9,24,7,40,0.175000
2025-08-23,SpartanNash,16,23,1,40,0.025000
2025-08-23,Sprouts Farmers Market,15,25,0,40,0.000000
2025-08-23,Stanley Black & Decker,12,22,6,40,0.150000
2025-08-23,Starbucks,11,20,9,40,0.225000
2025-08-23,State Farm Insurance,14,17,9,40,0.225000
2025-08-23,State Street,10,16,14,40,0.350000
2025-08-23,Steel Dynamics,34,5,1,40,0.025000
2025-08-23,StoneX,19,19,2,40,0.050000
2025-08-23,Stryker,12,18,10,40,0.250000
2025-08-23,Synchrony Financial,24,15,1,40,0.025000
2025-08-23,Sysco,18,11,11,40,0.275000
2025-08-23,TD Synnex,18,19,3,40,0.075000
2025-08-23,THOR Industries,19,16,5,40,0.125000
2025-08-23,TIAA,13,25,2,40,0.050000
2025-08-23,TJX,20,15,5,40,0.125000
2025-08-23,Targa Resources,21,15,4,40,0.100000
2025-08-23,Target,10,12,18,40,0.450000
2025-08-23,Taylor Morrison Home,13,23,4,40,0.100000
2025-08-23,Tenet Healthcare,18,16,6,40,0.150000
2025-08-23,Tesla,10,15,15,40,0.375000
2025-08-23,Texas Instruments,9,24,7,40,0.175000
2025-08-23,Textron,16,19,5,40,0.125000
2025-08-23,The Andersons,13,26,1,40,0.025000
2025-08-23,Thrivent Financial for Lutherans,18,19,3,40,0.075000
2025-08-23,Toll Brothers,17,19,4,40,0.100000
2025-08-23,Tractor Supply,21,17,2,40,0.050000
2025-08-23,TransDigm,25,11,4,40,0.100000
2025-08-23,Travelers Insurance,10,22,8,40,0.200000
2025-08-23,Truist Financial,17,20,3,40,0.075000
2025-08-23,Tyson Foods,10,26,4,40,0.100000
2025-08-23,U.S. Bancorp,23,17,0,40,0.000000
2025-08-23,UPS,8,18,14,40,0.350000
2025-08-23,US Foods,23,15,2,40,0.050000
2025-08-23,USAA,17,16,7,40,0.175000
2025-08-23,Uber,11,11,18,40,0.450000
2025-08-23,Ulta Beauty,33,5,2,40,0.050000
2025-08-23,Union Pacific,12,20,8,40,0.200000
2025-08-23,United Airlines,29,4,7,40,0.175000
2025-08-23,United Natural Foods,40,0,0,40,0.000000
2025-08-23,United Rentals,35,5,0,40,0.000000
2025-08-23,United States Steel,32,6,2,40,0.050000
2025-08-23,UnitedHealth,12,22,6,40,0.150000
2025-08-23,Universal Health Services,15,21,4,40,0.100000
2025-08-23,Unum,20,14,6,40,0.150000
2025-08-23,VF Corporation,12,23,5,40,0.125000
2025-08-23,Valero Energy,38,2,0,40,0.000000
2025-08-23,Verizon,20,16,4,40,0.100000
2025-08-23,Vertex Pharmaceuticals,13,17,10,40,0.250000
2025-08-23,Vertiv,21,17,2,40,0.050000
2025-08-23,Viatris,13,16,11,40,0.275000
2025-08-23,Vistra,21,12,7,40,0.175000
2025-08-23,Voya Financial,14,23,3,40,0.075000
2025-08-23,Vulcan Materials,12,14,14,40,0.350000
2025-08-23,W.R. Berkley,13,20,7,40,0.175000
2025-08-23,W.W. Grainger,16,17,7,40,0.175000
2025-08-23,WEC Energy,39,0,1,40,0.025000
2025-08-23,WESCO International,21,17,2,40,0.050000
2025-08-23,Walgreens,10,15,15,40,0.375000
2025-08-23,Walmart,6,16,18,40,0.450000
2025-08-23,Walt Disney,18,22,0,40,0.000000
2025-08-23,Warner Bros. Discovery,5,32,3,40,0.075000
2025-08-23,Watsco,18,15,7,40,0.175000
2025-08-23,Wayfair,19,16,5,40,0.125000
2025-08-23,Wells Fargo,32,3,5,40,0.125000
2025-08-23,Welltower,35,4,1,40,0.025000
2025-08-23,Western & Southern Financial,17,19,4,40,0.100000
2025-08-23,Western Digital,17,18,5,40,0.125000
2025-08-23,Westinghouse Air Brake Technologies,14,20,6,40,0.150000
2025-08-23,Whirlpool,12,19,9,40,0.225000
2025-08-23,Williams,19,15,6,40,0.150000
2025-08-23,Williams-Sonoma,18,20,2,40,0.050000
2025-08-23,Workday,11,17,12,40,0.300000
2025-08-23,World Kinect,11,23,6,40,0.150000
2025-08-23,XPO,10,24,6,40,0.150000
2025-08-23,Xcel Energy,31,5,4,40,0.100000
2025-08-23,Xylem,20,16,4,40,0.100000
2025-08-23,Yum Brands,19,16,5,40,0.125000
2025-08-23,Yum China,17,16,7,40,0.175000
2025-08-23,Zimmer Biomet,19,16,5,40,0.125000
2025-08-23,Zoetis,20,18,2,40,0.050000
2025-08-24,1 Automotive,15,20,5,40,0.125000
2025-08-24,3M,21,16,3,40,0.075000
2025-08-24,A-Mark Precious Metals,37,1,2,40,0.050000
2025-08-24,ABM Industries,17,20,3,40,0.075000
2025-08-24,AECOM,20,18,2,40,0.050000
2025-08-24,AES,16,16,8,40,0.200000
2025-08-24,AGCO,16,18,6,40,0.150000
2025-08-24,AIG,11,27,2,40,0.050000
2025-08-24,APA,16,14,10,40,0.250000
2025-08-24,ARKO,10,21,9,40,0.225000
2025-08-24,AT&T,10,23,7,40,0.175000
2025-08-24,AbbVie,14,21,5,40,0.125000
2025-08-24,Abbott Laboratories,19,16,5,40,0.125000
2025-08-24,Ace Hardware,18,17,5,40,0.125000
2025-08-24,Adobe,8,28,4,40,0.100000
2025-08-24,Advance Auto Parts,11,14,15,40,0.375000
2025-08-24,Advanced Micro Devices,30,3,7,40,0.175000
2025-08-24,Aflac,17,14,9,40,0.225000
2025-08-24,Air Products & Chemicals,21,13,6,40,0.150000
2025-08-24,Airbnb,11,22,7,40,0.175000
2025-08-24,Alaska Air,24,15,1,40,0.025000
2025-08-24,Albertsons,23,9,8,40,0.200000
2025-08-24,Alcoa,8,21,11,40,0.275000
2025-08-24,Allstate,22,15,3,40,0.075000
2025-08-24,Ally Financial,16,22,2,40,0.050000
2025-08-24,Alphabet,15,20,5,40,0.125000
2025-08-24,Altice,15,19,6,40,0.150000
2025-08-24,Altria,19,16,5,40,0.125000
2025-08-24,Amazon,29,2,9,40,0.225000
2025-08-24,American Airlines,9,15,16,40,0.400000
2025-08-24,American Electric Power,21,18,1,40,0.025000
2025-08-24,American Express,30,6,4,40,0.100000
2025-08-24,American Family Insurance,26,12,2,40,0.050000
2025-08-24,American Financial,18,15,7,40,0.175000
2025-08-24,American International,21,17,2,40,0.050000
2025-08-24,American Tower,20,13,7,40,0.175000
2025-08-24,Ameriprise Financial,24,15,1,40,0.025000
2025-08-24,Amgen,23,10,7,40,0.175000
2025-08-24,Amphenol,19,17,4,40,0.100000
2025-08-24,Analog Devices,18,22,0,40,0.000000
2025-08-24,Apollo Global Management,22,14,4,40,0.100000
2025-08-24,Apple,11,21,8,40,0.200000
2025-08-24,Applied Materials,7,17,16,40,0.400000
2025-08-24,Aramark,25,14,1,40,0.025000
2025-08-24,Archer Daniels Midland,17,20,3,40,0.075000
2025-08-24,Arrow Electronics,19,14,7,40,0.175000
2025-08-24,Arthur J. Gallagher,7,32,1,40,0.025000
2025-08-24,Asbury Automotive,15,23,2,40,0.050000
2025-08-24,Assurant,18,18,4,40,0.100000
2025-08-24,Auto-Owners Insurance,13,22,5,40,0.125000
2025-08-24,AutoNation,15,20,5,40,0.125000
2025-08-24,AutoZone,19,9,12,40,0.300000
2025-08-24,Autoliv,21,15,4,40,0.100000
2025-08-24,Automatic Data Processing,20,15,5,40,0.125000
2025-08-24,Avery Dennison,14,18,8,40,0.200000
2025-08-24,Avis Budget,13,20,7,40,0.175000
2025-08-24,Avnet,22,18,0,40,0.000000
2025-08-24,BJ's Wholesale Club,19,16,5,40,0.125000
2025-08-24,Baker Hughes,15,20,5,40,0.125000
2025-08-24,Ball,13,20,7,40,0.175000
2025-08-24,Bank of America,18,14,8,40,0.200000
2025-08-24,Bank of New York,22,14,4,40,0.100000
2025-08-24,Baxter International,17,16,7,40,0.175000
2025-08-24,Becton Dickinson,20,16,4,40,0.100000
2025-08-24,Berkshire Hathaway,13,15,12,40,0.300000
2025-08-24,Berry Global,9,22,9,40,0.225000
2025-08-24,Best Buy,39,1,0,40,0.000000
2025-08-24,Biogen,19,18,3,40,0.075000
2025-08-24,BlackRock,28,10,2,40,0.050000
2025-08-24,Blackstone,18,17,5,40,0.125000
2025-08-24,Boeing,10,22,8,40,0.200000
2025-08-24,Booking s,5,5,4,14,0.285714
2025-08-24,Booz Allen Hamilton,21,15,4,40,0.100000
2025-08-24,BorgWarner,19,17,4,40,0.100000
2025-08-24,Boston Scientific,21,13,6,40,0.150000
2025-08-24,BrightSpring Health Services,30,8,2,40,0.050000
2025-08-24,Bristol-Myers Squibb,12,21,7,40,0.175000
2025-08-24,Broadcom,19,17,4,40,0.100000
2025-08-24,Builders FirstSource,19,14,7,40,0.175000
2025-08-24,Burlington Stores,15,24,1,40,0.025000
2025-08-24,C.H. Robinson Worldwide,14,20,6,40,0.150000
2025-08-24,CACI International,22,16,2,40,0.050000
2025-08-24,CBRE,18,21,1,40,0.025000
2025-08-24,CDW,23,15,2,40,0.050000
2025-08-24,CHS,24,12,4,40,0.100000
2025-08-24,CMS Energy,37,0,3,40,0.075000
2025-08-24,CSX,10,22,8,40,0.200000
2025-08-24,CVS Health,12,20,8,40,0.200000
2025-08-24,Caesars Entertainment,31,9,0,40,0.000000
2025-08-24,Campbell's,14,24,2,40,0.050000
2025-08-24,Capital One,24,14,2,40,0.050000
2025-08-24,CarMax,13,24,3,40,0.075000
2025-08-24,Cardinal Health,21,11,8,40,0.200000
2025-08-24,Carrier Global,20,14,6,40,0.150000
2025-08-24,Carvana,18,14,8,40,0.200000
2025-08-24,Casey's General Stores,21,16,3,40,0.075000
2025-08-24,Caterpillar,21,16,3,40,0.075000
2025-08-24,Celanese,18,13,9,40,0.225000
2025-08-24,Cencora,20,16,4,40,0.100000
2025-08-24,Centene,14,14,12,40,0.300000
2025-08-24,CenterPoint Energy,25,10,5,40,0.125000
2025-08-24,Charles Schwab,24,15,1,40,0.025000
2025-08-24,Charter Communications,19,10,11,40,0.275000
2025-08-24,Cheniere Energy,38,2,0,40,0.000000
2025-08-24,Chevron,21,15,4,40,0.100000
2025-08-24,Chewy,20,17,3,40,0.075000
2025-08-24,Chipotle Mexican Grill,18,20,2,40,0.050000
2025-08-24,Cigna,26,11,3,40,0.075000
2025-08-24,Cincinnati Financial,21,17,2,40,0.050000
2025-08-24,Cintas,24,14,2,40,0.050000
2025-08-24,Cisco Systems,15,19,6,40,0.150000
2025-08-24,Citigroup,23,12,5,40,0.125000
2025-08-24,Citizens Financial,24,16,0,40,0.000000
2025-08-24,Cleveland-Cliffs,18,19,3,40,0.075000
2025-08-24,Coca-Cola,19,16,5,40,0.125000
2025-08-24,Cognizant Technology,34,2,4,40,0.100000
2025-08-24,Colgate-Palmolive,23,13,4,40,0.100000
2025-08-24,Comcast,22,14,4,40,0.100000
2025-08-24,Commercial Metals,15,18,7,40,0.175000
2025-08-24,Community Health Systems,19,14,7,40,0.175000
2025-08-24,Conagra Brands,17,19,4,40,0.100000
2025-08-24,Concentrix,22,14,4,40,0.100000
2025-08-24,ConocoPhillips,13,24,3,40,0.075000
2025-08-24,Consolidated Edison,11,25,4,40,0.100000
2025-08-24,Constellation Brands,15,17,8,40,0.200000
2025-08-24,Constellation Energy,35,4,1,40,0.025000
2025-08-24,Core & Main,13,23,4,40,0.100000
2025-08-24,Corebridge Financial,25,10,5,40,0.125000
2025-08-24,Corning,10,23,7,40,0.175000
2025-08-24,Corteva,17,18,5,40,0.125000
2025-08-24,Costco,15,20,5,40,0.125000
2025-08-24,Coupang,17,18,5,40,0.125000
2025-08-24,Cummins,22,13,5,40,0.125000
2025-08-24,D.R. Horton,13,18,9,40,0.225000
2025-08-24,DTE Energy,34,5,1,40,0.025000
2025-08-24,DXC Technology,20,18,2,40,0.050000
2025-08-24,DaVita,8,13,19,40,0.475000
2025-08-24,Danaher,21,14,5,40,0.125000
2025-08-24,Darden Restaurants,16,20,4,40,0.100000
2025-08-24,Deere,11,21,8,40,0.200000
2025-08-24,Delek US,21,16,3,40,0.075000
2025-08-24,Dell Technologies,20,20,0,40,0.000000
2025-08-24,Delta Airlines,19,15,6,40,0.150000
2025-08-24,Devon Energy,38,1,1,40,0.025000
2025-08-24,Diamondback Energy,38,0,2,40,0.050000
2025-08-24,Dick's Sporting Goods,12,25,3,40,0.075000
2025-08-24,Discover Financial,14,21,5,40,0.125000
2025-08-24,Dollar General,11,17,12,40,0.300000
2025-08-24,Dollar Tree,19,15,6,40,0.150000
2025-08-24,Dominion Energy,34,2,4,40,0.100000
2025-08-24,DoorDash,20,11,9,40,0.225000
2025-08-24,Dover,7,20,13,40,0.325000
2025-08-24,DuPont,16,19,5,40,0.125000
2025-08-24,Duke Energy,38,2,0,40,0.000000
2025-08-24,EMCOR,20,18,2,40,0.050000
2025-08-24,EOG Resources,24,15,1,40,0.025000
2025-08-24,Eastman Chemical,10,20,10,40,0.250000
2025-08-24,Ebay,19,16,5,40,0.125000
2025-08-24,EchoStar,16,20,4,40,0.100000
2025-08-24,Ecolab,21,15,4,40,0.100000
2025-08-24,Edison International,14,22,4,40,0.100000
2025-08-24,Edward Jones,13,22,5,40,0.125000
2025-08-24,Electronic Arts,17,18,5,40,0.125000
2025-08-24,Elevance Health,16,9,15,40,0.375000
2025-08-24,Eli Lilly,8,20,12,40,0.300000
2025-08-24,Emerson Electric,24,10,6,40,0.150000
2025-08-24,Endeavor,10,23,7,40,0.175000
2025-08-24,Energy Transfer,35,2,3,40,0.075000
2025-08-24,Entergy,23,14,3,40,0.075000
2025-08-24,Enterprise Products Partners,18,10,12,40,0.300000
2025-08-24,Equinix,17,16,7,40,0.175000
2025-08-24,Equitable,14,19,7,40,0.175000
2025-08-24,Erie Insurance,16,14,10,40,0.250000
2025-08-24,Estée Lauder,14,13,13,40,0.325000
2025-08-24,Eversource Energy,33,7,0,40,0.000000
2025-08-24,Exelon,21,14,5,40,0.125000
2025-08-24,Expedia,20,19,1,40,0.025000
2025-08-24,Expeditors International of Washington,18,17,5,40,0.125000
2025-08-24,Exxon Mobil,23,16,1,40,0.025000
2025-08-24,Fannie Mae,3,31,6,40,0.150000
2025-08-24,Farmers Insurance,9,28,3,40,0.075000
2025-08-24,Fastenal,18,15,7,40,0.175000
2025-08-24,FedEx,34,3,3,40,0.075000
2025-08-24,Ferguson Enterprises,16,16,8,40,0.200000
2025-08-24,Fidelity National Financial,20,12,8,40,0.200000
2025-08-24,Fidelity National Information,23,15,2,40,0.050000
2025-08-24,Fifth Third Bancorp,28,9,3,40,0.075000
2025-08-24,First Citizens BancShares,24,15,1,40,0.025000
2025-08-24,FirstEnergy,16,16,8,40,0.200000
2025-08-24,Fiserv,17,17,6,40,0.150000
2025-08-24,Fluor,19,14,7,40,0.175000
2025-08-24,Foot Locker,13,17,10,40,0.250000
2025-08-24,Ford Motor,23,14,3,40,0.075000
2025-08-24,Franklin Resources,21,11,8,40,0.200000
2025-08-24,Freddie Mac,7,25,8,40,0.200000
2025-08-24,Freeport-McMoRan,20,16,4,40,0.100000
2025-08-24,GE HealthCare Technologies,17,20,3,40,0.075000
2025-08-24,GE Vernova,19,19,2,40,0.050000
2025-08-24,GXO Logistics,20,16,4,40,0.100000
2025-08-24,General Dynamics,39,1,0,40,0.000000
2025-08-24,General Electric,13,27,0,40,0.000000
2025-08-24,General Mills,17,18,5,40,0.125000
2025-08-24,General Motors,18,17,5,40,0.125000
2025-08-24,Genuine Parts,20,16,4,40,0.100000
2025-08-24,Gilead Sciences,15,19,6,40,0.150000
2025-08-24,Global Partners,21,13,6,40,0.150000
2025-08-24,Global Payments,16,22,2,40,0.050000
2025-08-24,Goldman Sachs,12,18,10,40,0.250000
2025-08-24,Goodyear Tire & Rubber,12,24,4,40,0.100000
2025-08-24,Graphic Packaging,14,22,4,40,0.100000
2025-08-24,Graybar Electric,16,17,7,40,0.175000
2025-08-24,Guardian Life,16,22,2,40,0.050000
2025-08-24,GuideWell Mutual,20,19,1,40,0.025000
2025-08-24,HCA Healthcare,19,12,9,40,0.225000
2025-08-24,HF Sinclair,20,15,5,40,0.125000
2025-08-24,HP,19,16,5,40,0.125000
2025-08-24,Halliburton,23,13,4,40,0.100000
2025-08-24,Hartford Insurance,24,15,1,40,0.025000
2025-08-24,Henry Schein,16,20,4,40,0.100000
2025-08-24,Hershey,18,18,4,40,0.100000
2025-08-24,Hertz,29,6,5,40,0.125000
2025-08-24,Hewlett Packard,20,16,4,40,0.100000
2025-08-24,Hilton,14,22,4,40,0.100000
2025-08-24,Home Depot,11,22,7,40,0.175000
2025-08-24,Honeywell,14,20,6,40,0.150000
2025-08-24,Hormel Foods,12,24,4,40,0.100000
2025-08-24,Howmet Aerospace,14,20,6,40,0.150000
2025-08-24,Humana,29,9,2,40,0.050000
2025-08-24,Huntington Bancshares,17,21,2,40,0.050000
2025-08-24,Huntington Ingalls Industries,22,11,7,40,0.175000
2025-08-24,IBM,12,21,7,40,0.175000
2025-08-24,IQVIA,21,13,6,40,0.150000
2025-08-24,Icahn Enterprises,17,14,9,40,0.225000
2025-08-24,Illinois Tool Works,15,21,4,40,0.100000
2025-08-24,Ingram Micro,13,17,10,40,0.250000
2025-08-24,Ingredion,18,18,4,40,0.100000
2025-08-24,Insight Enterprises,24,12,4,40,0.100000
2025-08-24,Intel,12,22,6,40,0.150000
2025-08-24,Interactive Brokers,12,21,7,40,0.175000
2025-08-24,Intercontinental Exchange,17,21,2,40,0.050000
2025-08-24,International Flavors & Fragrances,19,13,8,40,0.200000
2025-08-24,International Paper,4,32,4,40,0.100000
2025-08-24,Interpublic,22,12,6,40,0.150000
2025-08-24,Intuit,18,14,8,40,0.200000
2025-08-24,Intuitive Surgical,14,16,10,40,0.250000
2025-08-24,J.B. Hunt Transport Services,22,15,3,40,0.075000
2025-08-24,J.M. Smucker,14,18,8,40,0.200000
2025-08-24,JPMorgan Chase,20,13,7,40,0.175000
2025-08-24,Jabil,16,19,5,40,0.125000
2025-08-24,Jacobs Solutions,37,0,3,40,0.075000
2025-08-24,Jefferies Financial,16,18,6,40,0.150000
2025-08-24,JetBlue Airways,14,16,10,40,0.250000
2025-08-24,Johnson & Johnson,18,19,3,40,0.075000
2025-08-24,Jones Lang LaSalle,22,14,4,40,0.100000
2025-08-24,KBR,26,11,3,40,0.075000
2025-08-24,KKR,20,17,3,40,0.075000
2025-08-24,KLA,16,16,8,40,0.200000
2025-08-24,Kellanova,20,16,4,40,0.100000
2025-08-24,Kenvue,22,13,5,40,0.125000
2025-08-24,Keurig Dr Pepper,20,16,4,40,0.100000
2025-08-24,KeyCorp,22,12,6,40,0.150000
2025-08-24,Kimberly-Clark,17,16,7,40,0.175000
2025-08-24,Kinder Morgan,40,0,0,40,0.000000
2025-08-24,Kohl's,8,22,10,40,0.250000
2025-08-24,Kraft Heinz,12,17,11,40,0.275000
2025-08-24,Kroger,10,25,5,40,0.125000
2025-08-24,Kyndryl s,8,7,0,15,0.000000
2025-08-24,L3Harris Technologies,23,11,6,40,0.150000
2025-08-24,LKQ,18,21,1,40,0.025000
2025-08-24,LPL Financial,25,14,1,40,0.025000
2025-08-24,Labcorp,20,16,4,40,0.100000
2025-08-24,Lam Research,18,17,5,40,0.125000
2025-08-24,Land O'Lakes,10,26,4,40,0.100000
2025-08-24,Las Vegas Sands,16,22,2,40,0.050000
2025-08-24,Lear Corporation,17,16,7,40,0.175000
2025-08-24,Leidos,17,20,3,40,0.075000
2025-08-24,Lennar,13,23,4,40,0.100000
2025-08-24,Liberty Mutual Insurance,32,2,6,40,0.150000
2025-08-24,Lincoln National,19,18,3,40,0.075000
2025-08-24,Lithia Motors,22,13,5,40,0.125000
2025-08-24,Live Nation Entertainment,33,7,0,40,0.000000
2025-08-24,Lockheed Martin,24,10,6,40,0.150000
2025-08-24,Loews,24,15,1,40,0.025000
2025-08-24,Lowe's,16,13,11,40,0.275000
2025-08-24,Lululemon athletica,17,13,10,40,0.250000
2025-08-24,Lumen Technologies,8,26,6,40,0.150000
2025-08-24,M&T Bank,18,18,4,40,0.100000
2025-08-24,MGM Resorts International,19,16,5,40,0.125000
2025-08-24,Macy's,21,18,1,40,0.025000
2025-08-24,ManpowerGroup,16,18,6,40,0.150000
2025-08-24,Marathon Petroleum,21,19,0,40,0.000000
2025-08-24,Markel Group,28,10,2,40,0.050000
2025-08-24,Marriott International,17,17,6,40,0.150000
2025-08-24,Marsh & McLennan,24,10,6,40,0.150000
2025-08-24,MasTec,19,16,5,40,0.125000
2025-08-24,Masco,10,24,6,40,0.150000
2025-08-24,Mass Mutual,12,27,1,40,0.025000
2025-08-24,Mastercard,16,17,7,40,0.175000
2025-08-24,McDonald's,16,11,13,40,0.325000
2025-08-24,McKesson,16,20,4,40,0.100000
2025-08-24,Merck,14,19,7,40,0.175000
2025-08-24,MetLife,22,16,2,40,0.050000
2025-08-24,Meta,13,21,6,40,0.150000
2025-08-24,Microchip Technology,17,17,6,40,0.150000
2025-08-24,Micron Technology,12,23,5,40,0.125000
2025-08-24,Microsoft,3,23,14,40,0.350000
2025-08-24,Mohawk Industries,19,16,5,40,0.125000
2025-08-24,Molina Healthcare,16,13,11,40,0.275000
2025-08-24,Molson Coors Beverage,23,15,2,40,0.050000
2025-08-24,Mondelez,17,12,11,40,0.275000
2025-08-24,Monster Beverage,25,10,5,40,0.125000
2025-08-24,Morgan Stanley,15,19,6,40,0.150000
2025-08-24,Mosaic,17,22,1,40,0.025000
2025-08-24,Motorola Solutions,39,0,1,40,0.025000
2025-08-24,Murphy USA,24,14,2,40,0.050000
2025-08-24,Mutual of Omaha Insurance,18,22,0,40,0.000000
2025-08-24,NOV,5,25,10,40,0.250000
2025-08-24,NRG Energy,36,3,1,40,0.025000
2025-08-24,NVR,19,12,9,40,0.225000
2025-08-24,Nationwide Insurance,10,18,12,40,0.300000
2025-08-24,Netflix,12,19,9,40,0.225000
2025-08-24,New York Life Insurance,13,25,2,40,0.050000
2025-08-24,Newell Brands,13,21,6,40,0.150000
2025-08-24,Newmont,20,17,3,40,0.075000
2025-08-24,News Corp.,16,17,7,40,0.175000
2025-08-24,NextEra Energy,29,4,7,40,0.175000
2025-08-24,Nike,15,21,4,40,0.100000
2025-08-24,Nordstrom,11,25,4,40,0.100000
2025-08-24,Norfolk Southern,18,16,6,40,0.150000
2025-08-24,Northern Trust,38,1,1,40,0.025000
2025-08-24,Northrop Grumman,18,20,2,40,0.050000
2025-08-24,Northwestern Mutual,20,10,10,40,0.250000
2025-08-24,Nucor,17,22,1,40,0.025000
2025-08-24,Nvidia,10,22,8,40,0.200000
2025-08-24,O'Reilly Automotive,16,19,5,40,0.125000
2025-08-24,Occidental Petroleum,14,22,4,40,0.100000
2025-08-24,Old Republic International,25,9,6,40,0.150000
2025-08-24,Omnicom,18,12,10,40,0.250000
2025-08-24,Oneok,22,14,4,40,0.100000
2025-08-24,Oracle,12,23,5,40,0.125000
2025-08-24,Oscar Health,13,15,12,40,0.300000
2025-08-24,Oshkosh,17,18,5,40,0.125000
2025-08-24,Otis Worldwide,22,12,6,40,0.150000
2025-08-24,Ovintiv,24,13,3,40,0.075000
2025-08-24,Owens & Minor,7,21,12,40,0.300000
2025-08-24,Owens Corning,22,14,4,40,0.100000
2025-08-24,PBF Energy,38,1,1,40,0.025000
2025-08-24,PG&E,13,14,13,40,0.325000
2025-08-24,PNC,17,16,7,40,0.175000
2025-08-24,PPG Industries,20,12,8,40,0.200000
2025-08-24,PPL,19,14,7,40,0.175000
2025-08-24,PVH,11,16,13,40,0.325000
2025-08-24,Paccar,24,12,4,40,0.100000
2025-08-24,Pacific Life,16,23,1,40,0.025000
2025-08-24,Packaging Corp. of America,10,24,6,40,0.150000
2025-08-24,Palo Alto Networks,15,21,4,40,0.100000
2025-08-24,Par Pacific,22,14,4,40,0.100000
2025-08-24,Paramount Global,14,12,14,40,0.350000
2025-08-24,Parker-Hannifin,24,12,4,40,0.100000
2025-08-24,PayPal,14,17,9,40,0.225000
2025-08-24,Penske Automotive,20,17,3,40,0.075000
2025-08-24,PepsiCo,19,15,6,40,0.150000
2025-08-24,Performance Food,20,15,5,40,0.125000
2025-08-24,Peter Kiewit Sons',4,21,15,40,0.375000
2025-08-24,Pfizer,12,17,11,40,0.275000
2025-08-24,Philip Morris,12,21,7,40,0.175000
2025-08-24,Phillips 66,19,18,3,40,0.075000
2025-08-24,Plains GP,16,14,10,40,0.250000
2025-08-24,Principal Financial,15,21,4,40,0.100000
2025-08-24,Procter & Gamble,20,13,7,40,0.175000
2025-08-24,Progressive Insurance,16,20,4,40,0.100000
2025-08-24,Prologis,21,16,3,40,0.075000
2025-08-24,Prudential Financial,21,15,4,40,0.100000
2025-08-24,Public Service Enterprise,21,15,4,40,0.100000
2025-08-24,Publix Super Markets,17,18,5,40,0.125000
2025-08-24,PulteGroup,21,14,5,40,0.125000
2025-08-24,QVC,15,23,2,40,0.050000
2025-08-24,QXO Building Products,2,5,3,10,0.300000
2025-08-24,Qualcomm,19,12,9,40,0.225000
2025-08-24,Quanta Services,16,15,9,40,0.225000
2025-08-24,Quest Diagnostics,19,18,3,40,0.075000
2025-08-24,RTX,20,13,7,40,0.175000
2025-08-24,Raymond James Financial,24,10,6,40,0.150000
2025-08-24,Regeneron Pharmaceuticals,20,16,4,40,0.100000
2025-08-24,Regions Financial,16,21,3,40,0.075000
2025-08-24,Reinsurance of America,0,5,1,6,0.166667
2025-08-24,Reliance Inc,22,12,6,40,0.150000
2025-08-24,Republic Services,21,8,11,40,0.275000
2025-08-24,Rockwell Automation,19,19,2,40,0.050000
2025-08-24,Ross Stores,22,16,2,40,0.050000
2025-08-24,Rush Enterprises,19,17,4,40,0.100000
2025-08-24,Ryder System,26,9,5,40,0.125000
2025-08-24,S&P Global,14,24,2,40,0.050000
2025-08-24,Salesforce,14,20,6,40,0.150000
2025-08-24,Sanmina,22,13,5,40,0.125000
2025-08-24,Science Applications International,12,26,2,40,0.050000
2025-08-24,Seaboard,9,20,11,40,0.275000
2025-08-24,Securian Financial,11,24,5,40,0.125000
2025-08-24,Sempra,22,18,0,40,0.000000
2025-08-24,ServiceNow,19,19,2,40,0.050000
2025-08-24,Sherwin-Williams,13,20,7,40,0.175000
2025-08-24,Sirius XM,17,20,3,40,0.075000
2025-08-24,Skechers,15,19,6,40,0.150000
2025-08-24,Solventum,13,18,9,40,0.225000
2025-08-24,Sonic Automotive,16,18,6,40,0.150000
2025-08-24,Southern Company,21,17,2,40,0.050000
2025-08-24,Southwest Airlines,7,25,8,40,0.200000
2025-08-24,SpartanNash,17,22,1,40,0.025000
2025-08-24,Sprouts Farmers Market,11,28,1,40,0.025000
2025-08-24,Stanley Black & Decker,12,23,5,40,0.125000
2025-08-24,Starbucks,7,27,6,40,0.150000
2025-08-24,State Farm Insurance,14,18,8,40,0.200000
2025-08-24,State Street,11,18,11,40,0.275000
2025-08-24,Steel Dynamics,32,7,1,40,0.025000
2025-08-24,StoneX,19,17,4,40,0.100000
2025-08-24,Stryker,11,18,11,40,0.275000
2025-08-24,Synchrony Financial,22,17,1,40,0.025000
2025-08-24,Sysco,17,12,11,40,0.275000
2025-08-24,TD Synnex,16,21,3,40,0.075000
2025-08-24,THOR Industries,17,19,4,40,0.100000
2025-08-24,TIAA,12,24,4,40,0.100000
2025-08-24,TJX,22,13,5,40,0.125000
2025-08-24,Targa Resources,23,16,1,40,0.025000
2025-08-24,Target,7,16,17,40,0.425000
2025-08-24,Taylor Morrison Home,11,25,4,40,0.100000
2025-08-24,Tenet Healthcare,18,15,7,40,0.175000
2025-08-24,Tesla,11,14,15,40,0.375000
2025-08-24,Texas Instruments,9,24,7,40,0.175000
2025-08-24,Textron,15,22,3,40,0.075000
2025-08-24,The Andersons,14,24,2,40,0.050000
2025-08-24,Thermo Fisher Scientific,19,19,2,40,0.050000
2025-08-24,Thrivent Financial for Lutherans,18,20,2,40,0.050000
2025-08-24,Toll Brothers,19,18,3,40,0.075000
2025-08-24,Tractor Supply,18,19,3,40,0.075000
2025-08-24,TransDigm,22,13,5,40,0.125000
2025-08-24,Travelers Insurance,10,21,9,40,0.225000
2025-08-24,Truist Financial,19,18,3,40,0.075000
2025-08-24,Tyson Foods,9,26,5,40,0.125000
2025-08-24,U.S. Bancorp,22,18,0,40,0.000000
2025-08-24,UPS,12,17,11,40,0.275000
2025-08-24,US Foods,24,15,1,40,0.025000
2025-08-24,USAA,17,16,7,40,0.175000
2025-08-24,Uber,11,14,15,40,0.375000
2025-08-24,Ulta Beauty,35,4,1,40,0.025000
2025-08-24,Union Pacific,14,18,8,40,0.200000
2025-08-24,United Airlines,30,5,5,40,0.125000
2025-08-24,United Natural Foods,40,0,0,40,0.000000
2025-08-24,United Rentals,35,5,0,40,0.000000
2025-08-24,United States Steel,32,6,2,40,0.050000
2025-08-24,UnitedHealth,16,18,6,40,0.150000
2025-08-24,Universal Health Services,16,18,6,40,0.150000
2025-08-24,Unum,19,14,7,40,0.175000
2025-08-24,VF Corporation,14,21,5,40,0.125000
2025-08-24,Valero Energy,39,1,0,40,0.000000
2025-08-24,Verizon,18,17,5,40,0.125000
2025-08-24,Vertex Pharmaceuticals,12,16,12,40,0.300000
2025-08-24,Vertiv,21,19,0,40,0.000000
2025-08-24,Viatris,14,16,10,40,0.250000
2025-08-24,Vistra,18,14,8,40,0.200000
2025-08-24,Voya Financial,15,22,3,40,0.075000
2025-08-24,Vulcan Materials,12,18,10,40,0.250000
2025-08-24,W.R. Berkley,17,17,6,40,0.150000
2025-08-24,W.W. Grainger,18,15,7,40,0.175000
2025-08-24,WEC Energy,38,1,1,40,0.025000
2025-08-24,WESCO International,19,18,3,40,0.075000
2025-08-24,Walgreens,8,16,16,40,0.400000
2025-08-24,Walmart,8,14,18,40,0.450000
2025-08-24,Walt Disney,15,24,1,40,0.025000
2025-08-24,Warner Bros. Discovery,10,25,5,40,0.125000
2025-08-24,Watsco,25,12,3,40,0.075000
2025-08-24,Wayfair,20,16,4,40,0.100000
2025-08-24,Wells Fargo,32,3,5,40,0.125000
2025-08-24,Welltower,35,3,2,40,0.050000
2025-08-24,Western & Southern Financial,14,22,4,40,0.100000
2025-08-24,Western Digital,17,18,5,40,0.125000
2025-08-24,Westinghouse Air Brake Technologies,11,24,5,40,0.125000
2025-08-24,Whirlpool,15,17,8,40,0.200000
2025-08-24,Williams,20,12,8,40,0.200000
2025-08-24,Williams-Sonoma,18,20,2,40,0.050000
2025-08-24,Workday,11,15,14,40,0.350000
2025-08-24,World Kinect,14,23,3,40,0.075000
2025-08-24,XPO,12,23,5,40,0.125000
2025-08-24,Xcel Energy,32,4,4,40,0.100000
2025-08-24,Xylem,20,15,5,40,0.125000
2025-08-24,Yum Brands,18,14,8,40,0.200000
2025-08-24,Yum China,19,18,3,40,0.075000
2025-08-24,Zimmer Biomet,21,12,7,40,0.175000
2025-08-24,Zoetis,25,13,2,40,0.050000
2025-08-26,1 Automotive,21,17,2,40,0.050000
2025-08-26,3M,25,10,5,40,0.125000
2025-08-26,A-Mark Precious Metals,40,0,0,40,0.000000
2025-08-26,ABM Industries,21,15,4,40,0.100000
2025-08-26,AECOM,18,19,3,40,0.075000
2025-08-26,AES,21,12,7,40,0.175000
2025-08-26,AGCO,15,17,8,40,0.200000
2025-08-26,AIG,14,21,5,40,0.125000
2025-08-26,APA,19,13,8,40,0.200000
2025-08-26,ARKO,13,22,5,40,0.125000
2025-08-26,AT&T,15,21,4,40,0.100000
2025-08-26,AbbVie,12,18,10,40,0.250000
2025-08-26,Abbott Laboratories,20,15,5,40,0.125000
2025-08-26,Ace Hardware,18,17,5,40,0.125000
2025-08-26,Adobe,10,27,3,40,0.075000
2025-08-26,Advance Auto Parts,9,18,13,40,0.325000
2025-08-26,Advanced Micro Devices,32,4,4,40,0.100000
2025-08-26,Aflac,19,15,6,40,0.150000
2025-08-26,Air Products & Chemicals,18,17,5,40,0.125000
2025-08-26,Airbnb,10,20,10,40,0.250000
2025-08-26,Alaska Air,17,17,6,40,0.150000
2025-08-26,Albertsons,22,11,7,40,0.175000
2025-08-26,Alcoa,16,16,8,40,0.200000
2025-08-26,Allstate,22,16,2,40,0.050000
2025-08-26,Ally Financial,11,27,2,40,0.050000
2025-08-26,Alphabet,14,20,6,40,0.150000
2025-08-26,Altice,17,15,8,40,0.200000
2025-08-26,Altria,21,14,5,40,0.125000
2025-08-26,Amazon,28,6,6,40,0.150000
2025-08-26,American Airlines,8,9,23,40,0.575000
2025-08-26,American Electric Power,18,19,3,40,0.075000
2025-08-26,American Express,30,7,3,40,0.075000
2025-08-26,American Family Insurance,24,14,2,40,0.050000
2025-08-26,American Financial,18,15,7,40,0.175000
2025-08-26,American International,17,18,5,40,0.125000
2025-08-26,American Tower,20,18,2,40,0.050000
2025-08-26,Ameriprise Financial,25,12,3,40,0.075000
2025-08-26,Amgen,23,11,6,40,0.150000
2025-08-26,Amphenol,22,12,6,40,0.150000
2025-08-26,Analog Devices,21,16,3,40,0.075000
2025-08-26,Apollo Global Management,19,17,4,40,0.100000
2025-08-26,Apple,8,20,12,40,0.300000
2025-08-26,Applied Materials,8,16,16,40,0.400000
2025-08-26,Aramark,25,14,1,40,0.025000
2025-08-26,Archer Daniels Midland,17,21,2,40,0.050000
2025-08-26,Arrow Electronics,25,13,2,40,0.050000
2025-08-26,Arthur J. Gallagher,9,28,3,40,0.075000
2025-08-26,Asbury Automotive,19,15,6,40,0.150000
2025-08-26,Assurant,19,18,3,40,0.075000
2025-08-26,Auto-Owners Insurance,14,21,5,40,0.125000
2025-08-26,AutoNation,16,19,5,40,0.125000
2025-08-26,AutoZone,23,8,9,40,0.225000
2025-08-26,Autoliv,20,14,6,40,0.150000
2025-08-26,Automatic Data Processing,16,21,3,40,0.075000
2025-08-26,Avery Dennison,15,22,3,40,0.075000
2025-08-26,Avis Budget,16,19,5,40,0.125000
2025-08-26,Avnet,21,18,1,40,0.025000
2025-08-26,BJ's Wholesale Club,15,16,9,40,0.225000
2025-08-26,Baker Hughes,18,14,8,40,0.200000
2025-08-26,Ball,22,11,7,40,0.175000
2025-08-26,Bank of America,21,15,4,40,0.100000
2025-08-26,Bank of New York,26,10,4,40,0.100000
2025-08-26,Baxter International,18,16,6,40,0.150000
2025-08-26,Becton Dickinson,20,15,5,40,0.125000
2025-08-26,Berkshire Hathaway,11,16,13,40,0.325000
2025-08-26,Berry Global,9,23,8,40,0.200000
2025-08-26,Best Buy,39,0,1,40,0.025000
2025-08-26,Biogen,15,22,3,40,0.075000
2025-08-26,BlackRock,17,18,5,40,0.125000
2025-08-26,Blackstone,23,15,2,40,0.050000
2025-08-26,Boeing,12,23,5,40,0.125000
2025-08-26,Booking s,4,5,4,13,0.307692
2025-08-26,Booz Allen Hamilton,18,16,6,40,0.150000
2025-08-26,BorgWarner,20,19,1,40,0.025000
2025-08-26,Boston Scientific,13,19,8,40,0.200000
2025-08-26,BrightSpring Health Services,29,9,2,40,0.050000
2025-08-26,Bristol-Myers Squibb,10,23,7,40,0.175000
2025-08-26,Broadcom,24,12,4,40,0.100000
2025-08-26,Builders FirstSource,22,13,5,40,0.125000
2025-08-26,Burlington Stores,13,23,4,40,0.100000
2025-08-26,C.H. Robinson Worldwide,14,20,6,40,0.150000
2025-08-26,CACI International,26,11,3,40,0.075000
2025-08-26,CBRE,18,21,1,40,0.025000
2025-08-26,CDW,21,18,1,40,0.025000
2025-08-26,CHS,22,13,5,40,0.125000
2025-08-26,CMS Energy,36,0,4,40,0.100000
2025-08-26,CSX,15,15,10,40,0.250000
2025-08-26,CVS Health,21,12,7,40,0.175000
2025-08-26,Caesars Entertainment,32,8,0,40,0.000000
2025-08-26,Campbell's,17,18,5,40,0.125000
2025-08-26,Capital One,23,14,3,40,0.075000
2025-08-26,CarMax,13,24,3,40,0.075000
2025-08-26,Cardinal Health,14,14,12,40,0.300000
2025-08-26,Carrier Global,16,17,7,40,0.175000
2025-08-26,Carvana,17,15,8,40,0.200000
2025-08-26,Casey's General Stores,19,17,4,40,0.100000
2025-08-26,Caterpillar,19,11,10,40,0.250000
2025-08-26,Celanese,14,10,16,40,0.400000
2025-08-26,Cencora,18,17,5,40,0.125000
2025-08-26,Centene,18,11,11,40,0.275000
2025-08-26,CenterPoint Energy,27,6,7,40,0.175000
2025-08-26,Charles Schwab,26,11,3,40,0.075000
2025-08-26,Charter Communications,15,15,10,40,0.250000
2025-08-26,Cheniere Energy,37,3,0,40,0.000000
2025-08-26,Chevron,22,17,1,40,0.025000
2025-08-26,Chewy,20,18,2,40,0.050000
2025-08-26,Chipotle Mexican Grill,13,25,2,40,0.050000
2025-08-26,Cigna,23,10,7,40,0.175000
2025-08-26,Cincinnati Financial,20,20,0,40,0.000000
2025-08-26,Cintas,29,10,1,40,0.025000
2025-08-26,Cisco Systems,13,23,4,40,0.100000
2025-08-26,Citigroup,24,10,6,40,0.150000
2025-08-26,Citizens Financial,25,12,3,40,0.075000
2025-08-26,Cleveland-Cliffs,17,21,2,40,0.050000
2025-08-26,Coca-Cola,14,19,7,40,0.175000
2025-08-26,Cognizant Technology,32,4,4,40,0.100000
2025-08-26,Colgate-Palmolive,25,10,5,40,0.125000
2025-08-26,Comcast,17,16,7,40,0.175000
2025-08-26,Commercial Metals,19,11,10,40,0.250000
2025-08-26,Community Health Systems,16,17,7,40,0.175000
2025-08-26,Conagra Brands,19,18,3,40,0.075000
2025-08-26,Concentrix,20,17,3,40,0.075000
2025-08-26,ConocoPhillips,17,18,5,40,0.125000
2025-08-26,Consolidated Edison,12,22,6,40,0.150000
2025-08-26,Constellation Brands,14,15,11,40,0.275000
2025-08-26,Constellation Energy,38,1,1,40,0.025000
2025-08-26,Core & Main,15,20,5,40,0.125000
2025-08-26,Corebridge Financial,23,12,5,40,0.125000
2025-08-26,Corning,15,21,4,40,0.100000
2025-08-26,Corteva,17,19,4,40,0.100000
2025-08-26,Costco,20,17,3,40,0.075000
2025-08-26,Coupang,22,14,4,40,0.100000
2025-08-26,Cummins,16,18,6,40,0.150000
2025-08-26,D.R. Horton,16,19,5,40,0.125000
2025-08-26,DTE Energy,30,3,7,40,0.175000
2025-08-26,DXC Technology,16,21,3,40,0.075000
2025-08-26,DaVita,10,10,20,40,0.500000
2025-08-26,Danaher,24,11,5,40,0.125000
2025-08-26,Darden Restaurants,18,16,6,40,0.150000
2025-08-26,Deere,11,22,7,40,0.175000
2025-08-26,Delek US,18,21,1,40,0.025000
2025-08-26,Dell Technologies,19,20,1,40,0.025000
2025-08-26,Delta Airlines,18,17,5,40,0.125000
2025-08-26,Devon Energy,38,0,2,40,0.050000
2025-08-26,Diamondback Energy,37,1,2,40,0.050000
2025-08-26,Dick's Sporting Goods,8,29,3,40,0.075000
2025-08-26,Discover Financial,16,19,5,40,0.125000
2025-08-26,Dollar General,10,16,14,40,0.350000
2025-08-26,Dollar Tree,15,19,6,40,0.150000
2025-08-26,Dominion Energy,31,6,3,40,0.075000
2025-08-26,DoorDash,13,18,9,40,0.225000
2025-08-26,Dover,12,16,12,40,0.300000
2025-08-26,DuPont,12,21,7,40,0.175000
2025-08-26,Duke Energy,36,3,1,40,0.025000
2025-08-26,EMCOR,21,17,2,40,0.050000
2025-08-26,EOG Resources,23,14,3,40,0.075000
2025-08-26,Eastman Chemical,5,18,17,40,0.425000
2025-08-26,Ebay,20,14,6,40,0.150000
2025-08-26,EchoStar,13,23,4,40,0.100000
2025-08-26,Ecolab,24,14,2,40,0.050000
2025-08-26,Edison International,9,18,13,40,0.325000
2025-08-26,Edward Jones,13,23,4,40,0.100000
2025-08-26,Electronic Arts,15,18,7,40,0.175000
2025-08-26,Elevance Health,10,15,15,40,0.375000
2025-08-26,Eli Lilly,15,17,8,40,0.200000
2025-08-26,Emerson Electric,21,16,3,40,0.075000
2025-08-26,Endeavor,12,22,6,40,0.150000
2025-08-26,Energy Transfer,33,4,3,40,0.075000
2025-08-26,Entergy,25,11,4,40,0.100000
2025-08-26,Enterprise Products Partners,18,12,10,40,0.250000
2025-08-26,Equinix,20,15,5,40,0.125000
2025-08-26,Equitable,17,13,10,40,0.250000
2025-08-26,Erie Insurance,14,16,10,40,0.250000
2025-08-26,Estée Lauder,16,11,13,40,0.325000
2025-08-26,Eversource Energy,28,7,5,40,0.125000
2025-08-26,Exelon,15,20,5,40,0.125000
2025-08-26,Expedia,22,16,2,40,0.050000
2025-08-26,Expeditors International of Washington,16,20,4,40,0.100000
2025-08-26,Exxon Mobil,24,15,1,40,0.025000
2025-08-26,Fannie Mae,7,30,3,40,0.075000
2025-08-26,Farmers Insurance,12,24,4,40,0.100000
2025-08-26,Fastenal,15,18,7,40,0.175000
2025-08-26,FedEx,25,10,5,40,0.125000
2025-08-26,Ferguson Enterprises,19,9,12,40,0.300000
2025-08-26,Fidelity National Financial,22,12,6,40,0.150000
2025-08-26,Fidelity National Information,26,11,3,40,0.075000
2025-08-26,Fifth Third Bancorp,26,11,3,40,0.075000
2025-08-26,First Citizens BancShares,29,11,0,40,0.000000
2025-08-26,FirstEnergy,14,16,10,40,0.250000
2025-08-26,Fiserv,18,18,4,40,0.100000
2025-08-26,Fluor,10,22,8,40,0.200000
2025-08-26,Foot Locker,16,15,9,40,0.225000
2025-08-26,Ford Motor,19,19,2,40,0.050000
2025-08-26,Franklin Resources,23,10,7,40,0.175000
2025-08-26,Freddie Mac,9,25,6,40,0.150000
2025-08-26,Freeport-McMoRan,19,14,7,40,0.175000
2025-08-26,GE HealthCare Technologies,19,17,4,40,0.100000
2025-08-26,GE Vernova,19,18,3,40,0.075000
2025-08-26,GXO Logistics,15,19,6,40,0.150000
2025-08-26,General Dynamics,39,1,0,40,0.000000
2025-08-26,General Electric,12,25,3,40,0.075000
2025-08-26,General Mills,19,18,3,40,0.075000
2025-08-26,General Motors,14,15,11,40,0.275000
2025-08-26,Genuine Parts,21,13,6,40,0.150000
2025-08-26,Gilead Sciences,17,20,3,40,0.075000
2025-08-26,Global Partners,23,10,7,40,0.175000
2025-08-26,Global Payments,15,22,3,40,0.075000
2025-08-26,Goldman Sachs,14,24,2,40,0.050000
2025-08-26,Goodyear Tire & Rubber,14,21,5,40,0.125000
2025-08-26,Graphic Packaging,16,21,3,40,0.075000
2025-08-26,Graybar Electric,16,17,7,40,0.175000
2025-08-26,Guardian Life,17,21,2,40,0.050000
2025-08-26,GuideWell Mutual,18,21,1,40,0.025000
2025-08-26,HCA Healthcare,24,11,5,40,0.125000
2025-08-26,HF Sinclair,13,20,7,40,0.175000
2025-08-26,HP,19,14,7,40,0.175000
2025-08-26,Halliburton,16,19,5,40,0.125000
2025-08-26,Hartford Insurance,24,13,3,40,0.075000
2025-08-26,Henry Schein,13,23,4,40,0.100000
2025-08-26,Hershey,16,20,4,40,0.100000
2025-08-26,Hertz,23,12,5,40,0.125000
2025-08-26,Hewlett Packard,15,23,2,40,0.050000
2025-08-26,Hilton,11,21,8,40,0.200000
2025-08-26,Home Depot,15,16,9,40,0.225000
2025-08-26,Honeywell,12,21,7,40,0.175000
2025-08-26,Hormel Foods,12,24,4,40,0.100000
2025-08-26,Howmet Aerospace,15,17,8,40,0.200000
2025-08-26,Humana,27,10,3,40,0.075000
2025-08-26,Huntington Bancshares,16,16,8,40,0.200000
2025-08-26,Huntington Ingalls Industries,23,13,4,40,0.100000
2025-08-26,IBM,16,23,1,40,0.025000
2025-08-26,IQVIA,19,15,6,40,0.150000
2025-08-26,Icahn Enterprises,14,16,10,40,0.250000
2025-08-26,Illinois Tool Works,15,21,4,40,0.100000
2025-08-26,Ingram Micro,16,17,7,40,0.175000
2025-08-26,Ingredion,23,13,4,40,0.100000
2025-08-26,Insight Enterprises,18,17,5,40,0.125000
2025-08-26,Intel,9,22,9,40,0.225000
2025-08-26,Interactive Brokers,15,20,5,40,0.125000
2025-08-26,Intercontinental Exchange,19,21,0,40,0.000000
2025-08-26,International Flavors & Fragrances,19,15,6,40,0.150000
2025-08-26,International Paper,3,33,4,40,0.100000
2025-08-26,Interpublic,19,18,3,40,0.075000
2025-08-26,Intuit,20,13,7,40,0.175000
2025-08-26,Intuitive Surgical,16,15,9,40,0.225000
2025-08-26,J.B. Hunt Transport Services,18,19,3,40,0.075000
2025-08-26,J.M. Smucker,16,16,8,40,0.200000
2025-08-26,JPMorgan Chase,19,14,7,40,0.175000
2025-08-26,Jabil,21,16,3,40,0.075000
2025-08-26,Jacobs Solutions,36,1,3,40,0.075000
2025-08-26,Jefferies Financial,14,20,6,40,0.150000
2025-08-26,JetBlue Airways,19,16,5,40,0.125000
2025-08-26,Johnson & Johnson,17,20,3,40,0.075000
2025-08-26,Jones Lang LaSalle,19,16,5,40,0.125000
2025-08-26,KBR,25,12,3,40,0.075000
2025-08-26,KKR,24,11,5,40,0.125000
2025-08-26,KLA,19,15,6,40,0.150000
2025-08-26,Kellanova,23,13,4,40,0.100000
2025-08-26,Kenvue,20,17,3,40,0.075000
2025-08-26,Keurig Dr Pepper,2,34,4,40,0.100000
2025-08-26,KeyCorp,22,15,3,40,0.075000
2025-08-26,Kimberly-Clark,17,15,8,40,0.200000
2025-08-26,Kinder Morgan,39,0,1,40,0.025000
2025-08-26,Kohl's,17,15,8,40,0.200000
2025-08-26,Kraft Heinz,12,17,11,40,0.275000
2025-08-26,Kroger,9,23,8,40,0.200000
2025-08-26,Kyndryl s,8,7,0,15,0.000000
2025-08-26,L3Harris Technologies,22,14,4,40,0.100000
2025-08-26,LKQ,23,15,2,40,0.050000
2025-08-26,LPL Financial,25,15,0,40,0.000000
2025-08-26,Labcorp,23,14,3,40,0.075000
2025-08-26,Lam Research,25,12,3,40,0.075000
2025-08-26,Land O'Lakes,8,29,3,40,0.075000
2025-08-26,Las Vegas Sands,14,25,1,40,0.025000
2025-08-26,Lear Corporation,23,13,4,40,0.100000
2025-08-26,Leidos,26,12,2,40,0.050000
2025-08-26,Lennar,12,25,3,40,0.075000
2025-08-26,Liberty Mutual Insurance,33,2,5,40,0.125000
2025-08-26,Lincoln National,20,14,6,40,0.150000
2025-08-26,Lithia Motors,22,17,1,40,0.025000
2025-08-26,Live Nation Entertainment,37,2,1,40,0.025000
2025-08-26,Lockheed Martin,21,14,5,40,0.125000
2025-08-26,Loews,19,18,3,40,0.075000
2025-08-26,Lowe's,14,16,10,40,0.250000
2025-08-26,Lululemon athletica,17,17,6,40,0.150000
2025-08-26,Lumen Technologies,11,25,4,40,0.100000
2025-08-26,M&T Bank,17,16,7,40,0.175000
2025-08-26,MGM Resorts International,20,17,3,40,0.075000
2025-08-26,Macy's,20,17,3,40,0.075000
2025-08-26,ManpowerGroup,20,15,5,40,0.125000
2025-08-26,Marathon Petroleum,19,18,3,40,0.075000
2025-08-26,Markel Group,26,11,3,40,0.075000
2025-08-26,Marriott International,18,14,8,40,0.200000
2025-08-26,Marsh & McLennan,20,17,3,40,0.075000
2025-08-26,MasTec,19,14,7,40,0.175000
2025-08-26,Masco,17,18,5,40,0.125000
2025-08-26,Mass Mutual,11,27,2,40,0.050000
2025-08-26,Mastercard,17,19,4,40,0.100000
2025-08-26,McDonald's,15,12,13,40,0.325000
2025-08-26,McKesson,18,19,3,40,0.075000
2025-08-26,Merck,13,17,10,40,0.250000
2025-08-26,MetLife,16,19,5,40,0.125000
2025-08-26,Meta,15,21,4,40,0.100000
2025-08-26,Microchip Technology,19,16,5,40,0.125000
2025-08-26,Micron Technology,12,21,7,40,0.175000
2025-08-26,Microsoft,17,16,7,40,0.175000
2025-08-26,Mohawk Industries,21,13,6,40,0.150000
2025-08-26,Molina Healthcare,16,16,8,40,0.200000
2025-08-26,Molson Coors Beverage,18,21,1,40,0.025000
2025-08-26,Mondelez,23,10,7,40,0.175000
2025-08-26,Monster Beverage,25,12,3,40,0.075000
2025-08-26,Morgan Stanley,11,21,8,40,0.200000
2025-08-26,Mosaic,19,19,2,40,0.050000
2025-08-26,Motorola Solutions,39,0,1,40,0.025000
2025-08-26,Murphy USA,24,16,0,40,0.000000
2025-08-26,Mutual of Omaha Insurance,18,22,0,40,0.000000
2025-08-26,NOV,9,22,9,40,0.225000
2025-08-26,NRG Energy,37,0,3,40,0.075000
2025-08-26,NVR,20,16,4,40,0.100000
2025-08-26,Nationwide Insurance,10,17,13,40,0.325000
2025-08-26,Netflix,12,20,8,40,0.200000
2025-08-26,New York Life Insurance,15,22,3,40,0.075000
2025-08-26,Newell Brands,20,17,3,40,0.075000
2025-08-26,Newmont,23,13,4,40,0.100000
2025-08-26,News Corp.,15,18,7,40,0.175000
2025-08-26,NextEra Energy,29,8,3,40,0.075000
2025-08-26,Nike,13,22,5,40,0.125000
2025-08-26,Nordstrom,11,21,8,40,0.200000
2025-08-26,Norfolk Southern,16,18,6,40,0.150000
2025-08-26,Northern Trust,40,0,0,40,0.000000
2025-08-26,Northrop Grumman,15,21,4,40,0.100000
2025-08-26,Northwestern Mutual,29,7,4,40,0.100000
2025-08-26,Nucor,14,20,6,40,0.150000
2025-08-26,Nvidia,10,22,8,40,0.200000
2025-08-26,O'Reilly Automotive,18,16,6,40,0.150000
2025-08-26,Occidental Petroleum,13,23,4,40,0.100000
2025-08-26,Old Republic International,25,11,4,40,0.100000
2025-08-26,Omnicom,18,16,6,40,0.150000
2025-08-26,Oneok,23,12,5,40,0.125000
2025-08-26,Oracle,9,27,4,40,0.100000
2025-08-26,Oscar Health,13,15,12,40,0.300000
2025-08-26,Oshkosh,19,13,8,40,0.200000
2025-08-26,Otis Worldwide,26,10,4,40,0.100000
2025-08-26,Ovintiv,26,12,2,40,0.050000
2025-08-26,Owens & Minor,8,21,11,40,0.275000
2025-08-26,Owens Corning,22,15,3,40,0.075000
2025-08-26,PBF Energy,34,2,4,40,0.100000
2025-08-26,PG&E,13,17,10,40,0.250000
2025-08-26,PNC,16,14,10,40,0.250000
2025-08-26,PPG Industries,17,16,7,40,0.175000
2025-08-26,PPL,20,13,7,40,0.175000
2025-08-26,PVH,13,24,3,40,0.075000
2025-08-26,Paccar,28,8,4,40,0.100000
2025-08-26,Pacific Life,15,24,1,40,0.025000
2025-08-26,Packaging Corp. of America,10,24,6,40,0.150000
2025-08-26,Palo Alto Networks,14,22,4,40,0.100000
2025-08-26,Par Pacific,19,15,6,40,0.150000
2025-08-26,Paramount Global,10,17,13,40,0.325000
2025-08-26,Parker-Hannifin,23,16,1,40,0.025000
2025-08-26,PayPal,14,16,10,40,0.250000
2025-08-26,Penske Automotive,20,16,4,40,0.100000
2025-08-26,PepsiCo,18,16,6,40,0.150000
2025-08-26,Performance Food,18,14,8,40,0.200000
2025-08-26,Peter Kiewit Sons',5,20,15,40,0.375000
2025-08-26,Pfizer,8,16,16,40,0.400000
2025-08-26,Philip Morris,19,16,5,40,0.125000
2025-08-26,Phillips 66,17,17,6,40,0.150000
2025-08-26,Plains GP,26,7,7,40,0.175000
2025-08-26,Principal Financial,17,19,4,40,0.100000
2025-08-26,Procter & Gamble,22,11,7,40,0.175000
2025-08-26,Progressive Insurance,16,21,3,40,0.075000
2025-08-26,Prologis,19,18,3,40,0.075000
2025-08-26,Prudential Financial,17,17,6,40,0.150000
2025-08-26,Public Service Enterprise,20,18,2,40,0.050000
2025-08-26,Publix Super Markets,17,20,3,40,0.075000
2025-08-26,PulteGroup,20,14,6,40,0.150000
2025-08-26,QVC,16,19,5,40,0.125000
2025-08-26,QXO Building Products,2,6,2,10,0.200000
2025-08-26,Qualcomm,18,17,5,40,0.125000
2025-08-26,Quanta Services,19,13,8,40,0.200000
2025-08-26,Quest Diagnostics,17,15,8,40,0.200000
2025-08-26,RTX,22,13,5,40,0.125000
2025-08-26,Raymond James Financial,22,16,2,40,0.050000
2025-08-26,Regeneron Pharmaceuticals,21,13,6,40,0.150000
2025-08-26,Regions Financial,20,17,3,40,0.075000
2025-08-26,Reinsurance of America,0,5,1,6,0.166667
2025-08-26,Reliance Inc,20,15,5,40,0.125000
2025-08-26,Rockwell Automation,21,19,0,40,0.000000
2025-08-26,Ross Stores,17,20,3,40,0.075000
2025-08-26,Rush Enterprises,22,14,4,40,0.100000
2025-08-26,Ryder System,23,13,4,40,0.100000
2025-08-26,S&P Global,13,21,6,40,0.150000
2025-08-26,Salesforce,9,25,6,40,0.150000
2025-08-26,Sanmina,19,16,5,40,0.125000
2025-08-26,Science Applications International,18,20,2,40,0.050000
2025-08-26,Seaboard,10,23,7,40,0.175000
2025-08-26,Securian Financial,12,25,3,40,0.075000
2025-08-26,Sempra,23,15,2,40,0.050000
2025-08-26,ServiceNow,18,20,2,40,0.050000
2025-08-26,Sherwin-Williams,13,19,8,40,0.200000
2025-08-26,Sirius XM,13,22,5,40,0.125000
2025-08-26,Skechers,13,21,6,40,0.150000
2025-08-26,Solventum,9,25,6,40,0.150000
2025-08-26,Sonic Automotive,26,11,3,40,0.075000
2025-08-26,Southern Company,17,21,2,40,0.050000
2025-08-26,Southwest Airlines,7,27,6,40,0.150000
2025-08-26,SpartanNash,19,20,1,40,0.025000
2025-08-26,Sprouts Farmers Market,14,25,1,40,0.025000
2025-08-26,Stanley Black & Decker,13,18,9,40,0.225000
2025-08-26,Starbucks,8,28,4,40,0.100000
2025-08-26,State Farm Insurance,15,19,6,40,0.150000
2025-08-26,State Street,13,16,11,40,0.275000
2025-08-26,Steel Dynamics,33,6,1,40,0.025000
2025-08-26,StoneX,20,16,4,40,0.100000
2025-08-26,Stryker,12,22,6,40,0.150000
2025-08-26,Synchrony Financial,25,14,1,40,0.025000
2025-08-26,Sysco,16,14,10,40,0.250000
2025-08-26,TD Synnex,17,20,3,40,0.075000
2025-08-26,THOR Industries,21,17,2,40,0.050000
2025-08-26,TIAA,13,24,3,40,0.075000
2025-08-26,TJX,20,15,5,40,0.125000
2025-08-26,Targa Resources,25,11,4,40,0.100000
2025-08-26,Target,14,14,12,40,0.300000
2025-08-26,Taylor Morrison Home,12,22,6,40,0.150000
2025-08-26,Tenet Healthcare,16,17,7,40,0.175000
2025-08-26,Tesla,16,13,11,40,0.275000
2025-08-26,Texas Instruments,14,22,4,40,0.100000
2025-08-26,Textron,19,19,2,40,0.050000
2025-08-26,The Andersons,12,24,4,40,0.100000
2025-08-26,Thermo Fisher Scientific,18,19,3,40,0.075000
2025-08-26,Thrivent Financial for Lutherans,16,21,3,40,0.075000
2025-08-26,Toll Brothers,17,22,1,40,0.025000
2025-08-26,Tractor Supply,15,21,4,40,0.100000
2025-08-26,TransDigm,15,18,7,40,0.175000
2025-08-26,Travelers Insurance,11,20,9,40,0.225000
2025-08-26,Truist Financial,19,18,3,40,0.075000
2025-08-26,Tyson Foods,11,26,3,40,0.075000
2025-08-26,U.S. Bancorp,30,7,3,40,0.075000
2025-08-26,UPS,15,13,12,40,0.300000
2025-08-26,US Foods,26,11,3,40,0.075000
2025-08-26,USAA,15,15,10,40,0.250000
2025-08-26,Uber,13,10,17,40,0.425000
2025-08-26,Ulta Beauty,30,7,3,40,0.075000
2025-08-26,Union Pacific,15,17,8,40,0.200000
2025-08-26,United Airlines,31,1,8,40,0.200000
2025-08-26,United Natural Foods,40,0,0,40,0.000000
2025-08-26,United Rentals,36,4,0,40,0.000000
2025-08-26,United States Steel,29,10,1,40,0.025000
2025-08-26,UnitedHealth,13,20,7,40,0.175000
2025-08-26,Universal Health Services,15,19,6,40,0.150000
2025-08-26,Unum,24,13,3,40,0.075000
2025-08-26,VF Corporation,18,18,4,40,0.100000
2025-08-26,Valero Energy,39,1,0,40,0.000000
2025-08-26,Verizon,18,19,3,40,0.075000
2025-08-26,Vertex Pharmaceuticals,19,8,13,40,0.325000
2025-08-26,Vertiv,21,17,2,40,0.050000
2025-08-26,Viatris,15,19,6,40,0.150000
2025-08-26,Vistra,16,16,8,40,0.200000
2025-08-26,Voya Financial,17,18,5,40,0.125000
2025-08-26,Vulcan Materials,18,16,6,40,0.150000
2025-08-26,W.R. Berkley,17,19,4,40,0.100000
2025-08-26,W.W. Grainger,23,10,7,40,0.175000
2025-08-26,WEC Energy,38,1,1,40,0.025000
2025-08-26,WESCO International,23,15,2,40,0.050000
2025-08-26,Walgreens,9,17,14,40,0.350000
2025-08-26,Walmart,14,20,6,40,0.150000
2025-08-26,Walt Disney,20,17,3,40,0.075000
2025-08-26,Warner Bros. Discovery,11,23,6,40,0.150000
2025-08-26,Watsco,18,14,8,40,0.200000
2025-08-26,Wayfair,15,15,10,40,0.250000
2025-08-26,Wells Fargo,28,7,5,40,0.125000
2025-08-26,Welltower,35,5,0,40,0.000000
2025-08-26,Western & Southern Financial,15,23,2,40,0.050000
2025-08-26,Western Digital,21,16,3,40,0.075000
2025-08-26,Westinghouse Air Brake Technologies,12,22,6,40,0.150000
2025-08-26,Whirlpool,17,14,9,40,0.225000
2025-08-26,Williams,13,17,10,40,0.250000
2025-08-26,Williams-Sonoma,15,19,6,40,0.150000
2025-08-26,Workday,17,12,11,40,0.275000
2025-08-26,World Kinect,19,15,6,40,0.150000
2025-08-26,XPO,15,19,6,40,0.150000
2025-08-26,Xcel Energy,33,3,4,40,0.100000
2025-08-26,Xylem,23,13,4,40,0.100000
2025-08-26,Yum Brands,18,14,8,40,0.200000
2025-08-26,Yum China,19,19,2,40,0.050000
2025-08-26,Zimmer Biomet,16,21,3,40,0.075000
2025-08-26,Zoetis,26,10,4,40,0.100000
2025-08-27,3M,15,19,6,40,0.150000
2025-08-27,A O Smith,11,24,5,40,0.125000
2025-08-27,A-Mark Precious Metals,40,0,0,40,0.000000
2025-08-27,ABM Industries,21,14,5,40,0.125000
2025-08-27,ADT,21,15,4,40,0.100000
2025-08-27,AECOM,18,18,4,40,0.100000
2025-08-27,AES,19,13,8,40,0.200000
2025-08-27,AGCO,22,12,6,40,0.150000
2025-08-27,AGNC Investment,17,15,8,40,0.200000
2025-08-27,AMC Entertainment,33,5,2,40,0.050000
2025-08-27,AMC Networks,14,17,9,40,0.225000
2025-08-27,AMN Healthcare Services,13,22,5,40,0.125000
2025-08-27,APA,17,15,8,40,0.200000
2025-08-27,APi Group,21,14,5,40,0.125000
2025-08-27,ARKO,18,14,8,40,0.200000
2025-08-27,ASGN,15,18,7,40,0.175000
2025-08-27,AT&T,13,21,6,40,0.150000
2025-08-27,ATI inc,22,12,6,40,0.150000
2025-08-27,AbbVie,16,19,5,40,0.125000
2025-08-27,Abbott Laboratories,20,14,6,40,0.150000
2025-08-27,Abercrombie & Fitch,21,17,2,40,0.050000
2025-08-27,Academy Sports and Outdoors,14,19,7,40,0.175000
2025-08-27,Acadia Healthcare,20,17,3,40,0.075000
2025-08-27,Acuity Brands,11,27,2,40,0.050000
2025-08-27,AdaptHealth,17,20,3,40,0.075000
2025-08-27,Adobe,16,20,4,40,0.100000
2025-08-27,Advance Auto Parts,14,16,10,40,0.250000
2025-08-27,Advanced Drainage Systems,35,4,1,40,0.025000
2025-08-27,Advanced Micro Devices,28,8,4,40,0.100000
2025-08-27,Advantage Solutions,36,0,4,40,0.100000
2025-08-27,Aflac,17,15,8,40,0.200000
2025-08-27,Agilent Technologies,17,17,6,40,0.150000
2025-08-27,Agilon Health,18,16,6,40,0.150000
2025-08-27,Air Lease,22,15,3,40,0.075000
2025-08-27,Air Products & Chemicals,19,17,4,40,0.100000
2025-08-27,Airbnb,15,19,6,40,0.150000
2025-08-27,Akamai Technologies,17,17,6,40,0.150000
2025-08-27,Alaska Air,18,20,2,40,0.050000
2025-08-27,Albemarle,6,15,19,40,0.475000
2025-08-27,Albertsons,20,11,9,40,0.225000
2025-08-27,Alcoa,11,12,17,40,0.425000
2025-08-27,Alexandria Real Estate Equities,15,18,7,40,0.175000
2025-08-27,Alight Solutions,16,20,4,40,0.100000
2025-08-27,Align Technology,11,14,15,40,0.375000
2025-08-27,Allegiant Travel Company,19,15,6,40,0.150000
2025-08-27,Alliance Resource Partners,14,12,14,40,0.350000
2025-08-27,Alliant Energy,37,2,1,40,0.025000
2025-08-27,Allison Transmission,19,15,6,40,0.150000
2025-08-27,Allstate,27,11,2,40,0.050000
2025-08-27,Ally Financial,14,24,2,40,0.050000
2025-08-27,Alpha Metallurgical Resources,16,16,8,40,0.200000
2025-08-27,Alphabet,14,20,6,40,0.150000
2025-08-27,Altice,19,16,5,40,0.125000
2025-08-27,Altria,22,12,6,40,0.150000
2025-08-27,Amazon,30,4,6,40,0.150000
2025-08-27,Ameren,24,14,2,40,0.050000
2025-08-27,American Airlines,7,18,15,40,0.375000
2025-08-27,American Axle & Manufacturing,14,23,3,40,0.075000
2025-08-27,American Eagle Outfitters,17,20,3,40,0.075000
2025-08-27,American Electric Power,17,21,2,40,0.050000
2025-08-27,American Express,26,7,7,40,0.175000
2025-08-27,American Family Insurance,26,12,2,40,0.050000
2025-08-27,American Financial,18,16,6,40,0.150000
2025-08-27,American International Group,21,17,2,40,0.050000
2025-08-27,American Tower,24,11,5,40,0.125000
2025-08-27,American Water Works,22,10,8,40,0.200000
2025-08-27,Americold Realty Trust,33,7,0,40,0.000000
2025-08-27,Ameriprise Financial,24,11,5,40,0.125000
2025-08-27,Ametek,24,14,2,40,0.050000
2025-08-27,Amgen,18,15,7,40,0.175000
2025-08-27,Amica Mutual Insurance,15,23,2,40,0.050000
2025-08-27,Amkor Technology,14,23,3,40,0.075000
2025-08-27,Amphenol,24,12,4,40,0.100000
2025-08-27,Analog Devices,19,17,4,40,0.100000
2025-08-27,Andersons,10,12,18,40,0.450000
2025-08-27,Antero Resources,15,20,5,40,0.125000
2025-08-27,Anywhere Real Estate Inc,17,16,7,40,0.175000
2025-08-27,Apollo Global Management,15,22,3,40,0.075000
2025-08-27,AppLovin,18,16,6,40,0.150000
2025-08-27,Apple,11,23,6,40,0.150000
2025-08-27,Applied Industrial Technologies,16,22,2,40,0.050000
2025-08-27,Applied Materials,8,18,14,40,0.350000
2025-08-27,AptarGroup,18,15,7,40,0.175000
2025-08-27,Aramark,22,15,3,40,0.075000
2025-08-27,ArcBest,18,18,4,40,0.100000
2025-08-27,Arch Resources,30,5,5,40,0.125000
2025-08-27,Archer Daniels Midland,23,17,0,40,0.000000
2025-08-27,Ares Management,29,9,2,40,0.050000
2025-08-27,Arista Networks,21,16,3,40,0.075000
2025-08-27,Arrow Electronics,24,11,5,40,0.125000
2025-08-27,Arthur J Gallagher,9,26,5,40,0.125000
2025-08-27,Asbury Automotive Group,19,16,5,40,0.125000
2025-08-27,Assurant,18,18,4,40,0.100000
2025-08-27,Atkore,17,19,4,40,0.100000
2025-08-27,Atlassian,14,17,9,40,0.225000
2025-08-27,Atmos Energy,32,5,3,40,0.075000
2025-08-27,Auto-Owners Insurance,14,21,5,40,0.125000
2025-08-27,AutoNation,14,21,5,40,0.125000
2025-08-27,AutoZone,20,12,8,40,0.200000
2025-08-27,Autodesk,19,17,4,40,0.100000
2025-08-27,Autoliv,21,14,5,40,0.125000
2025-08-27,Automatic Data Processing,23,14,3,40,0.075000
2025-08-27,AvalonBay Communities,19,17,4,40,0.100000
2025-08-27,Avantor,16,20,4,40,0.100000
2025-08-27,Avery Dennison,11,20,9,40,0.225000
2025-08-27,Avient,19,17,4,40,0.100000
2025-08-27,Avis Budget,13,20,7,40,0.175000
2025-08-27,Avnet,18,22,0,40,0.000000
2025-08-27,BJs Wholesale Club,11,24,5,40,0.125000
2025-08-27,BOK Financial,18,15,7,40,0.175000
2025-08-27,BWX Technologies,23,16,1,40,0.025000
2025-08-27,Baker Hughes,21,14,5,40,0.125000
2025-08-27,Ball,17,21,2,40,0.050000
2025-08-27,Bank of America,18,16,6,40,0.150000
2025-08-27,Bank of New York Mellon,30,7,3,40,0.075000
2025-08-27,Bath & Body Works,12,19,9,40,0.225000
2025-08-27,Baxter International,16,20,4,40,0.100000
2025-08-27,Beacon Roofing Supply,9,24,7,40,0.175000
2025-08-27,Becton Dickinson,21,14,5,40,0.125000
2025-08-27,Belden,18,20,2,40,0.050000
2025-08-27,Benchmark Electronics,20,17,3,40,0.075000
2025-08-27,Berkshire Hathaway,8,21,11,40,0.275000
2025-08-27,Best Buy,38,2,0,40,0.000000
2025-08-27,Big Lots,9,28,3,40,0.075000
2025-08-27,Bio-Rad Laboratories,17,21,2,40,0.050000
2025-08-27,Biogen,14,22,4,40,0.100000
2025-08-27,BlackRock,15,19,6,40,0.150000
2025-08-27,Blackstone,21,14,5,40,0.125000
2025-08-27,Block Inc,6,6,28,40,0.700000
2025-08-27,Bloomin Brands,11,20,9,40,0.225000
2025-08-27,BlueLinx,16,21,3,40,0.075000
2025-08-27,Boeing,13,18,9,40,0.225000
2025-08-27,Boise Cascade,16,13,11,40,0.275000
2025-08-27,Booking Holdings,14,20,6,40,0.150000
2025-08-27,Booz Allen Hamilton,19,16,5,40,0.125000
2025-08-27,BorgWarner,21,17,2,40,0.050000
2025-08-27,Boston Properties,19,15,6,40,0.150000
2025-08-27,Boston Scientific,11,20,9,40,0.225000
2025-08-27,Boyd Gaming,12,24,4,40,0.100000
2025-08-27,Bread Financial,22,14,4,40,0.100000
2025-08-27,BrightSpring Health Services,31,8,1,40,0.025000
2025-08-27,BrightView Holdings,17,17,6,40,0.150000
2025-08-27,Brighthouse Financial,18,18,4,40,0.100000
2025-08-27,Brinker International,26,10,4,40,0.100000
2025-08-27,Brinks Company,10,3,4,17,0.235294
2025-08-27,Bristol-Myers Squibb,12,20,8,40,0.200000
2025-08-27,Broadcom,22,18,0,40,0.000000
2025-08-27,Broadridge Financial Solutions,29,4,7,40,0.175000
2025-08-27,Brookdale Senior Living,15,13,12,40,0.300000
2025-08-27,Brown & Brown,15,19,6,40,0.150000
2025-08-27,Brown-Forman,12,22,6,40,0.150000
2025-08-27,Bruker,9,20,11,40,0.275000
2025-08-27,Brunswick,16,16,8,40,0.200000
2025-08-27,Builders FirstSource,25,13,2,40,0.050000
2025-08-27,Burlington Stores,18,21,1,40,0.025000
2025-08-27,CACI International,22,11,7,40,0.175000
2025-08-27,CBRE Group,25,15,0,40,0.000000
2025-08-27,CDW,21,17,2,40,0.050000
2025-08-27,CF Industries,19,19,2,40,0.050000
2025-08-27,CH Robinson Worldwide,16,16,8,40,0.200000
2025-08-27,CHS,16,22,2,40,0.050000
2025-08-27,CME Group,15,22,3,40,0.075000
2025-08-27,CMS Energy,38,1,1,40,0.025000
2025-08-27,CNO Financial Group,12,24,4,40,0.100000
2025-08-27,CNX Resources,21,11,8,40,0.200000
2025-08-27,CSX,12,13,15,40,0.375000
2025-08-27,CVS Health,19,12,9,40,0.225000
2025-08-27,Cabot Corporation,21,15,4,40,0.100000
2025-08-27,Cadence,17,17,6,40,0.150000
2025-08-27,Caesars Entertainment,31,9,0,40,0.000000
2025-08-27,Cal-Maine Foods,16,21,3,40,0.075000
2025-08-27,Caleres inc,19,14,7,40,0.175000
2025-08-27,California Resources,18,17,5,40,0.125000
2025-08-27,Calumet,13,15,12,40,0.300000
2025-08-27,Campbell Soup,13,22,5,40,0.125000
2025-08-27,Camping World,13,21,6,40,0.150000
2025-08-27,Capital One,24,13,3,40,0.075000
2025-08-27,CarMax,7,31,2,40,0.050000
2025-08-27,Cardinal Health,14,16,10,40,0.250000
2025-08-27,Carlisle Companies,18,12,10,40,0.250000
2025-08-27,Carlyle Group,19,18,3,40,0.075000
2025-08-27,Carpenter Technology,17,18,5,40,0.125000
2025-08-27,Carrier Global,18,17,5,40,0.125000
2025-08-27,Carters inc,9,22,2,33,0.060606
2025-08-27,Carvana,23,11,6,40,0.150000
2025-08-27,Caseys General Stores,12,23,5,40,0.125000
2025-08-27,Catalent,9,26,5,40,0.125000
2025-08-27,Caterpillar,22,13,5,40,0.125000
2025-08-27,Cboe Global Markets,24,14,2,40,0.050000
2025-08-27,Celanese,17,11,12,40,0.300000
2025-08-27,Cencora,21,14,5,40,0.125000
2025-08-27,Centene,20,9,11,40,0.275000
2025-08-27,CenterPoint Energy,27,5,8,40,0.200000
2025-08-27,Central Garden & Pet,3,34,3,40,0.075000
2025-08-27,Century Communities,18,19,3,40,0.075000
2025-08-27,ChampionX,21,16,3,40,0.075000
2025-08-27,Charles River Laboratories International,16,18,6,40,0.150000
2025-08-27,Charles Schwab,22,18,0,40,0.000000
2025-08-27,Chart Industries,15,21,4,40,0.100000
2025-08-27,Charter Communications,17,16,7,40,0.175000
2025-08-27,Cheesecake Factory,14,10,16,40,0.400000
2025-08-27,Chefs Warehouse,18,14,8,40,0.200000
2025-08-27,Chemours,15,12,13,40,0.325000
2025-08-27,Cheniere Energy,36,3,1,40,0.025000
2025-08-27,Chevron,19,17,4,40,0.100000
2025-08-27,Chewy,19,20,1,40,0.025000
2025-08-27,Chipotle Mexican Grill,13,22,5,40,0.125000
2025-08-27,Chord Energy,31,3,6,40,0.150000
2025-08-27,Church & Dwight,17,17,6,40,0.150000
2025-08-27,Ciena,21,16,3,40,0.075000
2025-08-27,Cigna,19,11,10,40,0.250000
2025-08-27,Cincinnati Financial,16,23,1,40,0.025000
2025-08-27,Cinemark,14,22,4,40,0.100000
2025-08-27,Cintas,23,15,2,40,0.050000
2025-08-27,Cisco Systems,14,22,4,40,0.100000
2025-08-27,Citigroup,16,18,6,40,0.150000
2025-08-27,Citizens Financial Group,23,15,2,40,0.050000
2025-08-27,Civitas Resources,14,17,9,40,0.225000
2025-08-27,Clean Harbors,38,1,1,40,0.025000
2025-08-27,Clear Channel Outdoor Hldgs,8,0,2,10,0.200000
2025-08-27,Cleveland-Cliffs,20,17,3,40,0.075000
2025-08-27,Clorox,16,20,4,40,0.100000
2025-08-27,Cognizant Technology Solutions,33,3,4,40,0.100000
2025-08-27,Coherent,14,20,6,40,0.150000
2025-08-27,Coinbase Global,12,22,6,40,0.150000
2025-08-27,Colgate-Palmolive,20,12,8,40,0.200000
2025-08-27,Columbia Banking System,22,13,5,40,0.125000
2025-08-27,Columbia Sportswear,16,17,7,40,0.175000
2025-08-27,Comcast,23,15,2,40,0.050000
2025-08-27,Comerica,24,13,3,40,0.075000
2025-08-27,Comfort Systems USA,39,1,0,40,0.000000
2025-08-27,CommScope,15,20,5,40,0.125000
2025-08-27,Commercial Metals,23,8,9,40,0.225000
2025-08-27,Community Health Systems,15,17,8,40,0.200000
2025-08-27,Compass,21,15,4,40,0.100000
2025-08-27,Conagra Brands,21,14,5,40,0.125000
2025-08-27,Concentrix,17,18,5,40,0.125000
2025-08-27,Conduent,25,11,4,40,0.100000
2025-08-27,ConocoPhillips,21,14,5,40,0.125000
2025-08-27,Consol Energy,35,4,1,40,0.025000
2025-08-27,Consolidated Edison,12,21,7,40,0.175000
2025-08-27,Constellation Brands,12,17,11,40,0.275000
2025-08-27,Constellation Energy,37,2,1,40,0.025000
2025-08-27,Continental Resources,17,14,9,40,0.225000
2025-08-27,Cooper Cos,6,31,3,40,0.075000
2025-08-27,Cooper-Standard,17,18,5,40,0.125000
2025-08-27,Copart,24,14,2,40,0.050000
2025-08-27,Core & Main,15,19,6,40,0.150000
2025-08-27,Cornerstone Building Brands,16,19,5,40,0.125000
2025-08-27,Corning,13,19,8,40,0.200000
2025-08-27,Corpay,10,29,1,40,0.025000
2025-08-27,Corteva,16,17,7,40,0.175000
2025-08-27,Costco,20,18,2,40,0.050000
2025-08-27,Coterra Energy,36,1,3,40,0.075000
2025-08-27,Coty,15,16,9,40,0.225000
2025-08-27,Country Financial,14,21,5,40,0.125000
2025-08-27,Coupang,21,17,2,40,0.050000
2025-08-27,Cracker Barrel Old Country Store,9,19,12,40,0.300000
2025-08-27,Crocs,9,29,2,40,0.050000
2025-08-27,CrossAmerica Partners,14,15,11,40,0.275000
2025-08-27,CrowdStrike,12,21,7,40,0.175000
2025-08-27,Crown Castle,17,16,7,40,0.175000
2025-08-27,Crown Holdings,21,14,5,40,0.125000
2025-08-27,Cullen Frost Bankers,17,20,3,40,0.075000
2025-08-27,Cummins,12,21,7,40,0.175000
2025-08-27,Curtiss-Wright,17,16,7,40,0.175000
2025-08-27,DR Horton,15,19,6,40,0.150000
2025-08-27,DTE Energy,32,3,5,40,0.125000
2025-08-27,DXC Technology,17,18,5,40,0.125000
2025-08-27,DaVita,11,10,19,40,0.475000
2025-08-27,Dana Incorporated,21,14,5,40,0.125000
2025-08-27,Danaher,26,13,1,40,0.025000
2025-08-27,Darden Restaurants,19,16,5,40,0.125000
2025-08-27,Darling Ingredients,39,0,1,40,0.025000
2025-08-27,Deckers Outdoor,22,14,4,40,0.100000
2025-08-27,Deere,15,19,6,40,0.150000
2025-08-27,Delek US,14,20,6,40,0.150000
2025-08-27,Dell Technologies,17,20,3,40,0.075000
2025-08-27,Delta Air Lines,8,16,16,40,0.400000
2025-08-27,Dentsply Sirona,17,20,3,40,0.075000
2025-08-27,Designer Brands,12,23,5,40,0.125000
2025-08-27,Devon Energy,37,1,2,40,0.050000
2025-08-27,DexCom,14,22,4,40,0.100000
2025-08-27,Diamondback Energy,39,1,0,40,0.000000
2025-08-27,Dicks Sporting Goods,15,20,5,40,0.125000
2025-08-27,Diebold Nixdorf,18,15,7,40,0.175000
2025-08-27,Digital Realty Trust,38,2,0,40,0.000000
2025-08-27,Dillards,16,21,3,40,0.075000
2025-08-27,DocuSign,19,16,5,40,0.125000
2025-08-27,Dollar General,5,19,16,40,0.400000
2025-08-27,Dollar Tree,16,21,3,40,0.075000
2025-08-27,Dominion Energy,33,4,3,40,0.075000
2025-08-27,Dominos Pizza inc,15,19,6,40,0.150000
2025-08-27,Domtar,8,27,5,40,0.125000
2025-08-27,Donaldson Company,16,20,4,40,0.100000
2025-08-27,DoorDash,12,22,6,40,0.150000
2025-08-27,Dover Corporation,17,14,9,40,0.225000
2025-08-27,DraftKings,28,9,3,40,0.075000
2025-08-27,Dream Finders Homes,34,3,3,40,0.075000
2025-08-27,Dropbox,15,20,5,40,0.125000
2025-08-27,DuPont,10,24,6,40,0.150000
2025-08-27,Duke Energy,37,2,1,40,0.025000
2025-08-27,Dycom Industries,13,20,7,40,0.175000
2025-08-27,EMCOR Group,15,19,6,40,0.150000
2025-08-27,EOG Resources,26,11,3,40,0.075000
2025-08-27,EPAM Systems,19,12,9,40,0.225000
2025-08-27,EQT,13,23,4,40,0.100000
2025-08-27,ESAB,15,19,6,40,0.150000
2025-08-27,East West Bancorp,23,16,1,40,0.025000
2025-08-27,Eastman Chemical,12,19,9,40,0.225000
2025-08-27,Ebay,13,23,4,40,0.100000
2025-08-27,EchoStar,14,23,3,40,0.075000
2025-08-27,Ecolab,25,11,4,40,0.100000
2025-08-27,Edison International,11,18,11,40,0.275000
2025-08-27,Edward Jones,14,22,4,40,0.100000
2025-08-27,Edwards Lifesciences,19,10,11,40,0.275000
2025-08-27,Elanco Animal Health,19,20,1,40,0.025000
2025-08-27,Electronic Arts,14,20,6,40,0.150000
2025-08-27,Elevance Health,12,13,15,40,0.375000
2025-08-27,Eli Lilly,19,11,10,40,0.250000
2025-08-27,Emerson Electric,19,16,5,40,0.125000
2025-08-27,EnLink Midstream,16,19,5,40,0.125000
2025-08-27,Encompass Health,14,20,6,40,0.150000
2025-08-27,Endeavor Group,12,22,6,40,0.150000
2025-08-27,EnerSys,21,17,2,40,0.050000
2025-08-27,Energizer,38,1,1,40,0.025000
2025-08-27,Energy Transfer,35,1,4,40,0.100000
2025-08-27,Ensign Group,19,14,7,40,0.175000
2025-08-27,Entegris,15,16,9,40,0.225000
2025-08-27,Entergy,22,14,4,40,0.100000
2025-08-27,Enterprise Products Partners,17,12,11,40,0.275000
2025-08-27,Envista,18,18,4,40,0.100000
2025-08-27,Equifax,18,17,5,40,0.125000
2025-08-27,Equinix,21,17,2,40,0.050000
2025-08-27,Equitable,18,17,5,40,0.125000
2025-08-27,Equity Residential,17,16,7,40,0.175000
2025-08-27,Erie Insurance,12,17,11,40,0.275000
2025-08-27,Estée Lauder,11,18,11,40,0.275000
2025-08-27,Etsy,13,20,7,40,0.175000
2025-08-27,Euronet Worldwide,19,17,4,40,0.100000
2025-08-27,Evergy,19,14,7,40,0.175000
2025-08-27,Eversource Energy,32,6,2,40,0.050000
2025-08-27,Exact Sciences,13,15,12,40,0.300000
2025-08-27,Exelon,17,19,4,40,0.100000
2025-08-27,Expand Energy,39,0,1,40,0.025000
2025-08-27,Expedia,25,12,3,40,0.075000
2025-08-27,Expeditors International of Washington,15,21,4,40,0.100000
2025-08-27,Extra Space Storage,15,16,9,40,0.225000
2025-08-27,Exxon Mobil,23,17,0,40,0.000000
2025-08-27,F5,18,19,3,40,0.075000
2025-08-27,FM Global,13,15,12,40,0.300000
2025-08-27,FMC Corporation,15,20,5,40,0.125000
2025-08-27,FTI Consulting,18,20,2,40,0.050000
2025-08-27,Fannie Mae,8,31,1,40,0.025000
2025-08-27,Farmers Insurance Exchange,10,18,12,40,0.300000
2025-08-27,Fastenal,19,17,4,40,0.100000
2025-08-27,FedEx,18,17,5,40,0.125000
2025-08-27,Federated Mutual Insurance,18,17,5,40,0.125000
2025-08-27,Fidelity National Financial,20,16,4,40,0.100000
2025-08-27,Fidelity National Information Services,20,19,1,40,0.025000
2025-08-27,Fifth Third Bancorp,25,10,5,40,0.125000
2025-08-27,First American Financial,16,15,9,40,0.225000
2025-08-27,First Citizens BancShares,22,17,1,40,0.025000
2025-08-27,First Horizon,12,26,2,40,0.050000
2025-08-27,First National of Nebraska,16,23,1,40,0.025000
2025-08-27,First Solar,22,13,5,40,0.125000
2025-08-27,FirstCash,18,21,1,40,0.025000
2025-08-27,FirstEnergy,14,16,10,40,0.250000
2025-08-27,Fiserv,12,22,6,40,0.150000
2025-08-27,Five Below,19,16,5,40,0.125000
2025-08-27,Flagstar Financial,11,25,4,40,0.100000
2025-08-27,Floor & Decor,17,22,1,40,0.025000
2025-08-27,Flowers Foods,19,13,8,40,0.200000
2025-08-27,Flowserve,18,17,5,40,0.125000
2025-08-27,Fluor,12,17,11,40,0.275000
2025-08-27,Foot Locker,10,16,14,40,0.350000
2025-08-27,Ford Motor,15,19,6,40,0.150000
2025-08-27,Fortinet,19,16,5,40,0.125000
2025-08-27,Fortive,18,15,7,40,0.175000
2025-08-27,Fortune Brands Innovations,20,16,4,40,0.100000
2025-08-27,Fox,6,14,20,40,0.500000
2025-08-27,Franklin Resources,22,11,7,40,0.175000
2025-08-27,Freddie Mac,10,27,3,40,0.075000
2025-08-27,Freeport-McMoRan,20,15,5,40,0.125000
2025-08-27,Frontier Airlines,13,20,7,40,0.175000
2025-08-27,Frontier Communications,17,16,7,40,0.175000
2025-08-27,G-III Apparel Group,23,15,2,40,0.050000
2025-08-27,GE HealthCare Technologies,19,17,4,40,0.100000
2025-08-27,GMS,12,21,7,40,0.175000
2025-08-27,GXO Logistics,15,20,5,40,0.125000
2025-08-27,GameStop,13,20,7,40,0.175000
2025-08-27,Gannett,19,11,10,40,0.250000
2025-08-27,Garrett Motion inc,14,20,6,40,0.150000
2025-08-27,Gartner,11,21,8,40,0.200000
2025-08-27,Gen Digital,17,17,6,40,0.150000
2025-08-27,Generac,21,17,2,40,0.050000
2025-08-27,General Dynamics,37,1,2,40,0.050000
2025-08-27,General Electric,8,25,7,40,0.175000
2025-08-27,General Mills,17,18,5,40,0.125000
2025-08-27,General Motors,21,10,9,40,0.225000
2025-08-27,Genesis Energy,30,4,6,40,0.150000
2025-08-27,Genuine Parts,20,16,4,40,0.100000
2025-08-27,Genworth Financial,22,14,4,40,0.100000
2025-08-27,Gilead Sciences,20,17,3,40,0.075000
2025-08-27,Global Partners,14,18,8,40,0.200000
2025-08-27,Global Payments,14,25,1,40,0.025000
2025-08-27,Globe Life,15,22,3,40,0.075000
2025-08-27,GoDaddy,17,20,3,40,0.075000
2025-08-27,Goldman Sachs,11,23,6,40,0.150000
2025-08-27,Goodyear Tire & Rubber,13,19,8,40,0.200000
2025-08-27,Graham Holdings Company,17,19,4,40,0.100000
2025-08-27,Granite Construction,22,12,6,40,0.150000
2025-08-27,Graphic Packaging,18,16,6,40,0.150000
2025-08-27,Gray Television,14,17,9,40,0.225000
2025-08-27,Graybar Electric,17,18,5,40,0.125000
2025-08-27,Green Plains inc,18,16,6,40,0.150000
2025-08-27,Greenbrier,14,20,6,40,0.150000
2025-08-27,Greif,12,26,2,40,0.050000
2025-08-27,Griffon Corporation,17,19,4,40,0.100000
2025-08-27,Grocery Outlet Holding,14,22,4,40,0.100000
2025-08-27,Group 1 Automotive,24,14,2,40,0.050000
2025-08-27,Guardian Life insurance,19,21,0,40,0.000000
2025-08-27,Guess inc,16,19,5,40,0.125000
2025-08-27,H B Fuller,16,17,7,40,0.175000
2025-08-27,H&R Block,12,3,25,40,0.625000
2025-08-27,HCA Healthcare,26,8,6,40,0.150000
2025-08-27,HEICO,15,21,4,40,0.100000
2025-08-27,HF Sinclair,9,24,7,40,0.175000
2025-08-27,Halliburton,20,15,5,40,0.125000
2025-08-27,Hanesbrands,11,25,4,40,0.100000
2025-08-27,Hanover Insurance Group,22,14,4,40,0.100000
2025-08-27,Harley-Davidson,9,26,5,40,0.125000
2025-08-27,Hasbro,17,16,7,40,0.175000
2025-08-27,Hawaiian Airlines inc,19,20,1,40,0.025000
2025-08-27,Hawaiian Electric Industries,23,10,7,40,0.175000
2025-08-27,Helmerich & Payne,15,23,2,40,0.050000
2025-08-27,Henry Schein,18,17,5,40,0.125000
2025-08-27,Herc Rentals,21,13,6,40,0.150000
2025-08-27,Hershey,16,17,7,40,0.175000
2025-08-27,Hertz,20,13,7,40,0.175000
2025-08-27,Hewlett Packard,15,22,3,40,0.075000
2025-08-27,Hewlett Packard Enterprise,14,24,2,40,0.050000
2025-08-27,Hillenbrand,19,18,3,40,0.075000
2025-08-27,Hilton Grand Vacations,39,0,1,40,0.025000
2025-08-27,Hilton Worldwide,26,12,2,40,0.050000
2025-08-27,Hologic,16,18,6,40,0.150000
2025-08-27,Home Depot,9,16,15,40,0.375000
2025-08-27,Honeywell,18,16,6,40,0.150000
2025-08-27,Hormel Foods,11,25,4,40,0.100000
2025-08-27,Host Hotels & Resorts,12,23,5,40,0.125000
2025-08-27,Hovnanian Enterprises,24,11,5,40,0.125000
2025-08-27,Howmet Aerospace,16,18,6,40,0.150000
2025-08-27,Hub Group,19,10,11,40,0.275000
2025-08-27,Hubbell,17,20,3,40,0.075000
2025-08-27,Humana,26,9,5,40,0.125000
2025-08-27,Huntington Bancshares,17,15,8,40,0.200000
2025-08-27,Huntington Ingalls Industries,22,12,6,40,0.150000
2025-08-27,Huntsman,10,17,13,40,0.325000
2025-08-27,Hyatt Hotels,17,23,0,40,0.000000
2025-08-27,Hyster-Yale,16,18,6,40,0.150000
2025-08-27,IAC,14,20,6,40,0.150000
2025-08-27,IBM,10,27,3,40,0.075000
2025-08-27,IDEX,22,11,7,40,0.175000
2025-08-27,IDEXX Laboratories,20,11,9,40,0.225000
2025-08-27,IQVIA,20,13,7,40,0.175000
2025-08-27,ITT,22,12,6,40,0.150000
2025-08-27,Icahn Enterprises,19,12,9,40,0.225000
2025-08-27,Illinois Tool Works,13,23,4,40,0.100000
2025-08-27,Illumina inc,12,23,5,40,0.125000
2025-08-27,Incyte,19,18,3,40,0.075000
2025-08-27,Ingersoll Rand,20,17,3,40,0.075000
2025-08-27,Ingles Markets,14,20,6,40,0.150000
2025-08-27,Ingredion,23,14,3,40,0.075000
2025-08-27,Insight Enterprises,21,17,2,40,0.050000
2025-08-27,Insperity,26,11,3,40,0.075000
2025-08-27,Instacart,23,13,4,40,0.100000
2025-08-27,Installed Building Products,19,16,5,40,0.125000
2025-08-27,Intel,13,16,11,40,0.275000
2025-08-27,Interactive Brokers,18,18,4,40,0.100000
2025-08-27,Intercontinental Exchange,21,19,0,40,0.000000
2025-08-27,International Flavors & Fragrances,20,14,6,40,0.150000
2025-08-27,International Paper,4,33,3,40,0.075000
2025-08-27,Interpublic Group,20,14,6,40,0.150000
2025-08-27,Intuit,18,15,7,40,0.175000
2025-08-27,Intuitive Surgical,13,20,7,40,0.175000
2025-08-27,Iron Mountain,10,22,8,40,0.200000
2025-08-27,JB Hunt Transport Services,16,18,6,40,0.150000
2025-08-27,JELD-WEN Holding,25,11,4,40,0.100000
2025-08-27,JM Smucker,15,15,10,40,0.250000
2025-08-27,JPMorgan Chase,19,14,7,40,0.175000
2025-08-27,Jabil,17,18,5,40,0.125000
2025-08-27,Jackson Financial,14,20,6,40,0.150000
2025-08-27,Jacobs Solutions,36,2,2,40,0.050000
2025-08-27,Jefferies Financial,16,16,8,40,0.200000
2025-08-27,JetBlue Airways,24,13,3,40,0.075000
2025-08-27,Johnson & Johnson,21,16,3,40,0.075000
2025-08-27,Jones Lang LaSalle,15,20,5,40,0.125000
2025-08-27,Juniper Networks,21,16,3,40,0.075000
2025-08-27,KB Home,17,17,6,40,0.150000
2025-08-27,KBR,23,14,3,40,0.075000
2025-08-27,KKR,18,17,5,40,0.125000
2025-08-27,KLA,16,17,7,40,0.175000
2025-08-27,Kaiser Aluminum,18,19,3,40,0.075000
2025-08-27,Kellanova,25,12,3,40,0.075000
2025-08-27,Kelly Services inc,17,16,7,40,0.175000
2025-08-27,Kemper,16,13,11,40,0.275000
2025-08-27,Keurig Dr Pepper,5,28,7,40,0.175000
2025-08-27,KeyCorp,16,19,5,40,0.125000
2025-08-27,Keysight Technologies,22,12,6,40,0.150000
2025-08-27,Kimberly-Clark,13,20,7,40,0.175000
2025-08-27,Kinder Morgan,39,0,1,40,0.025000
2025-08-27,Kirby Corporation,26,9,5,40,0.125000
2025-08-27,Knife River Corporation,19,19,2,40,0.050000
2025-08-27,Knight Swift Transportation,24,6,10,40,0.250000
2025-08-27,Kohls,18,13,9,40,0.225000
2025-08-27,Kontoor Brands,20,17,3,40,0.075000
2025-08-27,Korn Ferry,22,10,8,40,0.200000
2025-08-27,Kraft Heinz,12,18,10,40,0.250000
2025-08-27,Kroger,7,24,9,40,0.225000
2025-08-27,Kyndryl,15,21,4,40,0.100000
2025-08-27,L3Harris Technologies,23,12,5,40,0.125000
2025-08-27,LCI Industries,17,18,5,40,0.125000
2025-08-27,LKQ,14,21,5,40,0.125000
2025-08-27,LPL Financial,20,19,1,40,0.025000
2025-08-27,Labcorp Holdings,19,17,4,40,0.100000
2025-08-27,Lam Research,29,7,4,40,0.100000
2025-08-27,Lamb Weston,16,21,3,40,0.075000
2025-08-27,Land O'Lakes,9,28,3,40,0.075000
2025-08-27,Landstar System,15,16,9,40,0.225000
2025-08-27,Las Vegas Sands,18,20,2,40,0.050000
2025-08-27,Lear Corporation,24,14,2,40,0.050000
2025-08-27,Leggett & Platt,19,18,3,40,0.075000
2025-08-27,Leidos,31,9,0,40,0.000000
2025-08-27,Lennar,14,23,3,40,0.075000
2025-08-27,Lennox International,13,15,12,40,0.300000
2025-08-27,Levi Strauss,12,28,0,40,0.000000
2025-08-27,Liberty Energy,38,2,0,40,0.000000
2025-08-27,Liberty Media,40,0,0,40,0.000000
2025-08-27,Liberty Mutual Insurance,32,3,5,40,0.125000
2025-08-27,Light & Wonder,8,26,6,40,0.150000
2025-08-27,Lincoln Electric,14,22,4,40,0.100000
2025-08-27,Lincoln National,17,16,7,40,0.175000
2025-08-27,Lithia Motors,19,16,5,40,0.125000
2025-08-27,Live Nation Entertainment,39,0,1,40,0.025000
2025-08-27,Lockheed Martin,18,15,7,40,0.175000
2025-08-27,Loews,22,16,2,40,0.050000
2025-08-27,Louisiana-Pacific Corporation,17,16,7,40,0.175000
2025-08-27,Lowes,17,18,5,40,0.125000
2025-08-27,Lululemon athletica,15,20,5,40,0.125000
2025-08-27,Lumen Technologies,11,24,5,40,0.125000
2025-08-27,Lyft,11,15,14,40,0.350000
2025-08-27,M&T Bank,15,18,7,40,0.175000
2025-08-27,M/I Homes,17,20,3,40,0.075000
2025-08-27,MDU Resources Group,23,16,1,40,0.025000
2025-08-27,MGM Resorts International,21,16,3,40,0.075000
2025-08-27,MKS Instruments,17,18,5,40,0.125000
2025-08-27,MRC Global,14,20,6,40,0.150000
2025-08-27,MSC Industrial Direct,21,12,7,40,0.175000
2025-08-27,MSCI,22,16,2,40,0.050000
2025-08-27,MYR Group,13,21,6,40,0.150000
2025-08-27,Macys,20,16,4,40,0.100000
2025-08-27,ManpowerGroup,17,18,5,40,0.125000
2025-08-27,Marathon Oil,15,22,3,40,0.075000
2025-08-27,Marathon Petroleum,21,14,5,40,0.125000
2025-08-27,Markel Group,28,8,4,40,0.100000
2025-08-27,Marriott International,20,14,6,40,0.150000
2025-08-27,Marriott Vacations Worldwide,19,19,2,40,0.050000
2025-08-27,Marsh & McLennan,18,19,3,40,0.075000
2025-08-27,Martin Marietta Materials,23,14,3,40,0.075000
2025-08-27,Marvell Technology,16,22,2,40,0.050000
2025-08-27,MasTec,19,11,10,40,0.250000
2025-08-27,Masco,16,18,6,40,0.150000
2025-08-27,Mass Mutual,13,25,2,40,0.050000
2025-08-27,MasterBrand,16,22,2,40,0.050000
2025-08-27,Mastercard,10,25,5,40,0.125000
2025-08-27,Matador Resources,20,14,6,40,0.150000
2025-08-27,Match Group,9,16,15,40,0.375000
2025-08-27,Mativ,15,17,8,40,0.200000
2025-08-27,Matson inc,19,17,4,40,0.100000
2025-08-27,Mattel,16,17,7,40,0.175000
2025-08-27,Maximus,14,21,5,40,0.125000
2025-08-27,McCormick & Company,19,15,6,40,0.150000
2025-08-27,McDonalds,16,17,7,40,0.175000
2025-08-27,McKesson,21,16,3,40,0.075000
2025-08-27,Medical Mutual of Ohio,14,19,7,40,0.175000
2025-08-27,Merck,10,17,13,40,0.325000
2025-08-27,Mercury General,19,17,4,40,0.100000
2025-08-27,Meritage Homes,19,19,2,40,0.050000
2025-08-27,MetLife,19,15,6,40,0.150000
2025-08-27,Meta,19,14,7,40,0.175000
2025-08-27,Mettler-Toledo International,23,17,0,40,0.000000
2025-08-27,Microchip Technology,18,19,3,40,0.075000
2025-08-27,Micron Technology,11,20,9,40,0.225000
2025-08-27,Microsoft,10,14,16,40,0.400000
2025-08-27,Middleby,25,11,4,40,0.100000
2025-08-27,MillerKnoll,20,16,4,40,0.100000
2025-08-27,Moderna,22,9,9,40,0.225000
2025-08-27,ModivCare,9,22,9,40,0.225000
2025-08-27,Mohawk Industries,24,12,4,40,0.100000
2025-08-27,Molina Healthcare,15,18,7,40,0.175000
2025-08-27,Molson Coors Beverage,27,12,1,40,0.025000
2025-08-27,Mondelez,20,12,8,40,0.200000
2025-08-27,Monster Beverage,23,11,6,40,0.150000
2025-08-27,Moodys,12,11,17,40,0.425000
2025-08-27,Moog inc,20,12,8,40,0.200000
2025-08-27,Morgan Stanley,16,18,6,40,0.150000
2025-08-27,Mosaic,21,16,3,40,0.075000
2025-08-27,Motorola Solutions,37,0,3,40,0.075000
2025-08-27,Mueller Industries,24,14,2,40,0.050000
2025-08-27,Murphy Oil,19,16,5,40,0.125000
2025-08-27,Murphy USA,25,15,0,40,0.000000
2025-08-27,Mutual of Omaha,18,19,3,40,0.075000
2025-08-27,NCR Atleos,22,17,1,40,0.025000
2025-08-27,NCR Voyix,19,14,7,40,0.175000
2025-08-27,NGL Energy Partners,38,0,2,40,0.050000
2025-08-27,NLV Financial,4,4,2,10,0.200000
2025-08-27,NOV,12,25,3,40,0.075000
2025-08-27,NRG Energy,37,1,2,40,0.050000
2025-08-27,NVR,20,15,5,40,0.125000
2025-08-27,Nasdaq,11,24,5,40,0.125000
2025-08-27,Nationwide,13,16,11,40,0.275000
2025-08-27,Navient,22,12,6,40,0.150000
2025-08-27,NetApp,16,21,3,40,0.075000
2025-08-27,Netflix,15,17,8,40,0.200000
2025-08-27,NeueHealth,15,18,7,40,0.175000
2025-08-27,New York Life Insurance,15,22,3,40,0.075000
2025-08-27,NewMarket Corporation,18,16,6,40,0.150000
2025-08-27,Newell Brands,19,18,3,40,0.075000
2025-08-27,Newmont,11,9,20,40,0.500000
2025-08-27,News Corp,15,17,8,40,0.200000
2025-08-27,Nexstar Media Group,19,17,4,40,0.100000
2025-08-27,NextEra Energy,30,6,4,40,0.100000
2025-08-27,NiSource,20,16,4,40,0.100000
2025-08-27,Nike,11,27,2,40,0.050000
2025-08-27,Nordson,21,12,7,40,0.175000
2025-08-27,Nordstrom,10,22,8,40,0.200000
2025-08-27,Norfolk Southern,15,19,6,40,0.150000
2025-08-27,Northern Trust,40,0,0,40,0.000000
2025-08-27,Northrop Grumman,18,18,4,40,0.100000
2025-08-27,Northwestern Mutual,30,7,3,40,0.075000
2025-08-27,Nucor,14,22,4,40,0.100000
2025-08-27,Nvidia,9,24,7,40,0.175000
2025-08-27,O'Reilly Automotive,14,19,7,40,0.175000
2025-08-27,O-I Glass,11,25,4,40,0.100000
2025-08-27,ODP Business Solutions,22,17,1,40,0.025000
2025-08-27,OGE Energy,31,8,1,40,0.025000
2025-08-27,ON Semiconductor,10,23,7,40,0.175000
2025-08-27,Occidental Petroleum,17,19,4,40,0.100000
2025-08-27,Old Dominion Freight Line,18,16,6,40,0.150000
2025-08-27,Old National Bancorp,15,19,6,40,0.150000
2025-08-27,Old Republic International,24,12,4,40,0.100000
2025-08-27,Olin,15,19,6,40,0.150000
2025-08-27,Omnicom Group,18,12,10,40,0.250000
2025-08-27,OneMain,23,12,5,40,0.125000
2025-08-27,Oneok,25,9,6,40,0.150000
2025-08-27,Opendoor Technologies,8,23,9,40,0.225000
2025-08-27,Option Care Health,40,0,0,40,0.000000
2025-08-27,Oracle,18,18,4,40,0.100000
2025-08-27,Organon,9,25,6,40,0.150000
2025-08-27,Oscar Health,8,15,17,40,0.425000
2025-08-27,Oshkosh,20,14,6,40,0.150000
2025-08-27,Otis Worldwide,25,10,5,40,0.125000
2025-08-27,Ovintiv,30,8,2,40,0.050000
2025-08-27,Owens & Minor,14,17,9,40,0.225000
2025-08-27,Owens Corning,27,9,4,40,0.100000
2025-08-27,PACS Group,22,13,5,40,0.125000
2025-08-27,PBF Energy,32,5,3,40,0.075000
2025-08-27,PC Connection,19,19,2,40,0.050000
2025-08-27,PENN Entertainment,37,3,0,40,0.000000
2025-08-27,PG&E,12,16,12,40,0.300000
2025-08-27,PNC Financial Services,25,12,3,40,0.075000
2025-08-27,PPG Industries,25,9,6,40,0.150000
2025-08-27,PPL,20,13,7,40,0.175000
2025-08-27,PVH,16,19,5,40,0.125000
2025-08-27,Paccar,26,10,4,40,0.100000
2025-08-27,Pacific Life,16,23,1,40,0.025000
2025-08-27,Packaging Corp of America,11,24,5,40,0.125000
2025-08-27,Palo Alto Networks,17,21,2,40,0.050000
2025-08-27,Par Pacific,23,13,4,40,0.100000
2025-08-27,Paramount Global,12,17,11,40,0.275000
2025-08-27,Park Hotels & Resorts,8,28,4,40,0.100000
2025-08-27,Parker-Hannifin,18,20,2,40,0.050000
2025-08-27,Parsons,13,14,13,40,0.325000
2025-08-27,Patrick Industries,17,20,3,40,0.075000
2025-08-27,Patterson Companies Inc,9,26,5,40,0.125000
2025-08-27,Patterson-UTI Energy,33,4,3,40,0.075000
2025-08-27,PayPal,11,18,11,40,0.275000
2025-08-27,Paychex,19,15,6,40,0.150000
2025-08-27,Peabody Energy,34,4,2,40,0.050000
2025-08-27,Peloton,21,11,8,40,0.200000
2025-08-27,Penn Mutual Life Insurance,20,17,3,40,0.075000
2025-08-27,PennyMac Financial Services,23,14,3,40,0.075000
2025-08-27,Penske Automotive,17,18,5,40,0.125000
2025-08-27,PepsiCo,17,17,6,40,0.150000
2025-08-27,Performance Food,18,19,3,40,0.075000
2025-08-27,Permian Resources,20,18,2,40,0.050000
2025-08-27,Petco Health and Wellness,20,2,1,23,0.043478
2025-08-27,Peter Kiewit Sons',6,20,14,40,0.350000
2025-08-27,Pfizer,17,17,6,40,0.150000
2025-08-27,Philip Morris,20,15,5,40,0.125000
2025-08-27,Phillips 66,21,14,5,40,0.125000
2025-08-27,Pinnacle West Capital,18,13,9,40,0.225000
2025-08-27,Pinterest,9,22,9,40,0.225000
2025-08-27,Pioneer Natural Resources,18,10,12,40,0.300000
2025-08-27,Pitney Bowes,28,5,7,40,0.175000
2025-08-27,Plains GP,22,11,7,40,0.175000
2025-08-27,Playtika Holding,13,19,8,40,0.200000
2025-08-27,Plexus,8,22,10,40,0.250000
2025-08-27,Polaris Inc,23,12,5,40,0.125000
2025-08-27,Pool Corporation,20,16,4,40,0.100000
2025-08-27,Popular inc,39,0,1,40,0.025000
2025-08-27,Portland General Electric,12,21,7,40,0.175000
2025-08-27,Post Holdings,13,21,6,40,0.150000
2025-08-27,PriceSmart,15,18,7,40,0.175000
2025-08-27,Primerica,23,15,2,40,0.050000
2025-08-27,Primoris Services,23,15,2,40,0.050000
2025-08-27,Principal Financial,18,20,2,40,0.050000
2025-08-27,ProFrac Holding,11,23,6,40,0.150000
2025-08-27,Procter & Gamble,21,13,6,40,0.150000
2025-08-27,Progressive Insurance,17,20,3,40,0.075000
2025-08-27,Prologis,18,19,3,40,0.075000
2025-08-27,Prudential Financial,22,15,3,40,0.075000
2025-08-27,Public Service Enterprise Group,22,18,0,40,0.000000
2025-08-27,Public Storage,12,26,2,40,0.050000
2025-08-27,Publix Super Markets,17,20,3,40,0.075000
2025-08-27,Puget Sound Energy,27,9,4,40,0.100000
2025-08-27,PulteGroup,22,12,6,40,0.150000
2025-08-27,Pure Storage,16,18,6,40,0.150000
2025-08-27,QVC,18,18,4,40,0.100000
2025-08-27,Qorvo,20,13,7,40,0.175000
2025-08-27,Quad/Graphics,24,13,3,40,0.075000
2025-08-27,Qualcomm,18,19,3,40,0.075000
2025-08-27,Quanta Services,21,10,9,40,0.225000
2025-08-27,Quest Diagnostics,18,18,4,40,0.100000
2025-08-27,QuidelOrtho,19,14,7,40,0.175000
2025-08-27,REV Group,21,16,3,40,0.075000
2025-08-27,RPM International,18,14,8,40,0.200000
2025-08-27,RTX,18,20,2,40,0.050000
2025-08-27,RXO inc,19,9,12,40,0.300000
2025-08-27,Rackspace Technology,20,15,5,40,0.125000
2025-08-27,Radius Recycling,18,15,7,40,0.175000
2025-08-27,Ralph Lauren,32,7,1,40,0.025000
2025-08-27,Range Resources,17,18,5,40,0.125000
2025-08-27,Raymond James Financial,22,15,3,40,0.075000
2025-08-27,Realty Income,22,9,9,40,0.225000
2025-08-27,Regal Rexnord,19,17,4,40,0.100000
2025-08-27,Regeneron Pharmaceuticals,21,15,4,40,0.100000
2025-08-27,Regions Financial,19,15,6,40,0.150000
2025-08-27,Reinsurance Group of America,23,11,6,40,0.150000
2025-08-27,Reliance Inc,23,13,4,40,0.100000
2025-08-27,Republic Services,18,12,10,40,0.250000
2025-08-27,ResMed,21,17,2,40,0.050000
2025-08-27,Resideo Technologies,20,14,6,40,0.150000
2025-08-27,Restoration Hardware,12,23,5,40,0.125000
2025-08-27,Revvity,18,12,10,40,0.250000
2025-08-27,Rite Aid,5,27,8,40,0.200000
2025-08-27,Rithm Capital,19,17,4,40,0.100000
2025-08-27,Rivian Automotive,13,24,3,40,0.075000
2025-08-27,Robert Half,19,18,3,40,0.075000
2025-08-27,Roblox,13,12,15,40,0.375000
2025-08-27,Rocket Companies,22,15,3,40,0.075000
2025-08-27,Rockwell Automation,24,15,1,40,0.025000
2025-08-27,Roku,18,17,5,40,0.125000
2025-08-27,Rollins inc,20,19,1,40,0.025000
2025-08-27,Roper Technologies,20,17,3,40,0.075000
2025-08-27,Ross Stores,17,19,4,40,0.100000
2025-08-27,Rush Enterprises,23,11,6,40,0.150000
2025-08-27,Ryder System,22,12,6,40,0.150000
2025-08-27,Ryerson Holding,14,20,6,40,0.150000
2025-08-27,S&P Global,11,22,7,40,0.175000
2025-08-27,SBA Communications,16,18,6,40,0.150000
2025-08-27,SS&C Technologies,25,12,3,40,0.075000
2025-08-27,Sabre Corporation,24,10,6,40,0.150000
2025-08-27,Saia inc,20,13,7,40,0.175000
2025-08-27,Salesforce,7,15,18,40,0.450000
2025-08-27,Sallie Mae,16,20,4,40,0.100000
2025-08-27,Sally Beauty,37,3,0,40,0.000000
2025-08-27,Sanmina,22,15,3,40,0.075000
2025-08-27,ScanSource,21,17,2,40,0.050000
2025-08-27,Schneider National,20,17,3,40,0.075000
2025-08-27,Science Applications International,20,17,3,40,0.075000
2025-08-27,Scotts Miracle-Gro,28,8,4,40,0.100000
2025-08-27,Seaboard,8,19,13,40,0.325000
2025-08-27,Sealed Air Corporation,16,17,7,40,0.175000
2025-08-27,Securian Financial,11,24,5,40,0.125000
2025-08-27,Select Medical,16,17,7,40,0.175000
2025-08-27,Selective Insurance Group,18,13,9,40,0.225000
2025-08-27,Sempra,24,15,1,40,0.025000
2025-08-27,Sentry Insurance Group,3,7,0,10,0.000000
2025-08-27,Service Corp International,7,10,9,26,0.346154
2025-08-27,ServiceNow,20,18,2,40,0.050000
2025-08-27,Sherwin-Williams,18,14,8,40,0.200000
2025-08-27,Shift4 Payments,12,20,8,40,0.200000
2025-08-27,Silgan,16,19,5,40,0.125000
2025-08-27,Simon Property Group,19,18,3,40,0.075000
2025-08-27,Sinclair,10,22,8,40,0.200000
2025-08-27,SiteOne Landscape Supply,20,17,3,40,0.075000
2025-08-27,Skechers USA,21,14,5,40,0.125000
2025-08-27,SkyWest,14,17,9,40,0.225000
2025-08-27,Skyline Champion,34,4,2,40,0.050000
2025-08-27,Skyworks Solutions,30,6,4,40,0.100000
2025-08-27,Smurfit Westrock,20,19,1,40,0.025000
2025-08-27,Snap Inc,14,10,16,40,0.400000
2025-08-27,Snap-on,10,26,4,40,0.100000
2025-08-27,Snowflake inc,19,20,1,40,0.025000
2025-08-27,Sonic Automotive,20,20,0,40,0.000000
2025-08-27,Sonoco Products,21,17,2,40,0.050000
2025-08-27,Southern Company,18,19,3,40,0.075000
2025-08-27,Southwest Airlines,8,27,5,40,0.125000
2025-08-27,Southwest Gas,22,15,3,40,0.075000
2025-08-27,Southwestern Energy,34,3,3,40,0.075000
2025-08-27,SpartanNash,19,20,1,40,0.025000
2025-08-27,Spectrum Brands,16,15,9,40,0.225000
2025-08-27,Spire inc,21,10,9,40,0.225000
2025-08-27,Spirit AeroSystems,31,1,8,40,0.200000
2025-08-27,Spirit Airlines,21,5,14,40,0.350000
2025-08-27,Splunk,13,18,9,40,0.225000
2025-08-27,Sprouts Farmers Market,13,22,5,40,0.125000
2025-08-27,Stagwell,14,25,1,40,0.025000
2025-08-27,Stanley Black & Decker,16,17,7,40,0.175000
2025-08-27,Starbucks,11,25,4,40,0.100000
2025-08-27,State Farm Insurance,14,18,8,40,0.200000
2025-08-27,State Street,12,18,10,40,0.250000
2025-08-27,Steel Dynamics,34,4,2,40,0.050000
2025-08-27,Steelcase,13,26,1,40,0.025000
2025-08-27,Stericycle,11,7,22,40,0.550000
2025-08-27,Stifel Financial,17,19,4,40,0.100000
2025-08-27,StoneX,19,19,2,40,0.050000
2025-08-27,Stryker,16,13,11,40,0.275000
2025-08-27,Summit Materials,9,26,5,40,0.125000
2025-08-27,Sun Communities,27,8,5,40,0.125000
2025-08-27,Super Micro Computer,35,4,1,40,0.025000
2025-08-27,Surgery Partners,19,19,2,40,0.050000
2025-08-27,Sylvamo,17,15,8,40,0.200000
2025-08-27,Synchrony Financial,20,17,3,40,0.075000
2025-08-27,Synopsys,15,20,5,40,0.125000
2025-08-27,Synovus Financial,20,15,5,40,0.125000
2025-08-27,Sysco,18,13,9,40,0.225000
2025-08-27,T Rowe Price,26,13,1,40,0.025000
2025-08-27,TD Synnex,25,12,3,40,0.075000
2025-08-27,TEGNA,8,29,3,40,0.075000
2025-08-27,TIAA,13,24,3,40,0.075000
2025-08-27,TJX,22,16,2,40,0.050000
2025-08-27,Take-Two Interactive Software,18,15,7,40,0.175000
2025-08-27,Talen Energy,38,1,1,40,0.025000
2025-08-27,Tapestry,15,17,8,40,0.200000
2025-08-27,Targa Resources,17,16,7,40,0.175000
2025-08-27,Target,8,18,14,40,0.350000
2025-08-27,Taylor Morrison Home,15,17,8,40,0.200000
2025-08-27,Teladoc Health,22,11,7,40,0.175000
2025-08-27,Teledyne Technologies,19,18,3,40,0.075000
2025-08-27,Teleflex,15,19,6,40,0.150000
2025-08-27,Telephone & Data Systems,16,18,6,40,0.150000
2025-08-27,TelevisaUnivision,19,17,4,40,0.100000
2025-08-27,Tempur Sealy International,12,23,5,40,0.125000
2025-08-27,Tenet Healthcare,19,14,7,40,0.175000
2025-08-27,Teradyne,16,21,3,40,0.075000
2025-08-27,Terex,17,19,4,40,0.100000
2025-08-27,Tesla,15,12,13,40,0.325000
2025-08-27,Tetra Tech,18,16,6,40,0.150000
2025-08-27,Texas Instruments,13,22,5,40,0.125000
2025-08-27,Texas Roadhouse,17,17,6,40,0.150000
2025-08-27,Textron,21,18,1,40,0.025000
2025-08-27,The Coca-Cola Company,11,23,6,40,0.150000
2025-08-27,The Hartford,11,16,13,40,0.325000
2025-08-27,Thermo Fisher Scientific,20,18,2,40,0.050000
2025-08-27,Thor Industries,22,13,5,40,0.125000
2025-08-27,Thrivent Financial for Lutherans,15,22,3,40,0.075000
2025-08-27,Timken,12,23,5,40,0.125000
2025-08-27,Titan Machinery,19,14,7,40,0.175000
2025-08-27,Toast inc,21,17,2,40,0.050000
2025-08-27,Toll Brothers,16,24,0,40,0.000000
2025-08-27,TopBuild,13,25,2,40,0.050000
2025-08-27,Topgolf Callaway Brands,20,15,5,40,0.125000
2025-08-27,Toro Company,24,15,1,40,0.025000
2025-08-27,Tractor Supply,23,17,0,40,0.000000
2025-08-27,TransDigm,21,14,5,40,0.125000
2025-08-27,TransUnion,21,12,7,40,0.175000
2025-08-27,Travelers Insurance,11,21,8,40,0.200000
2025-08-27,TreeHouse Foods,16,18,6,40,0.150000
2025-08-27,Tri Pointe Homes,13,23,4,40,0.100000
2025-08-27,TriNet Group,17,15,8,40,0.200000
2025-08-27,Trimble,11,25,4,40,0.100000
2025-08-27,Trinity Industries,17,17,6,40,0.150000
2025-08-27,TruStage,25,13,2,40,0.050000
2025-08-27,Truist Financial,19,17,4,40,0.100000
2025-08-27,Tutor Perini Corporation,22,10,8,40,0.200000
2025-08-27,Twilio,22,14,4,40,0.100000
2025-08-27,Tyson Foods,9,22,9,40,0.225000
2025-08-27,U-Haul,4,17,19,40,0.475000
2025-08-27,UFP Industries,25,12,3,40,0.075000
2025-08-27,UGI Utilities Inc,18,17,5,40,0.125000
2025-08-27,UL Solutions,38,0,2,40,0.050000
2025-08-27,UPS,12,22,6,40,0.150000
2025-08-27,US Bancorp,25,13,2,40,0.050000
2025-08-27,US Foods,27,11,2,40,0.050000
2025-08-27,USAA,14,17,9,40,0.225000
2025-08-27,Uber,12,11,17,40,0.425000
2025-08-27,Ulta Beauty,32,7,1,40,0.025000
2025-08-27,Under Armour,12,22,6,40,0.150000
2025-08-27,Union Pacific,12,19,9,40,0.225000
2025-08-27,United Airlines,27,6,7,40,0.175000
2025-08-27,United Natural Foods,40,0,0,40,0.000000
2025-08-27,United Rentals,35,4,1,40,0.025000
2025-08-27,United States Steel,25,7,8,40,0.200000
2025-08-27,UnitedHealth,15,18,7,40,0.175000
2025-08-27,Universal Corporation,17,15,8,40,0.200000
2025-08-27,Universal Health Services,16,18,6,40,0.150000
2025-08-27,Unum Group,21,18,1,40,0.025000
2025-08-27,Upbound Group,21,14,5,40,0.125000
2025-08-27,Urban Outfitters,14,22,4,40,0.100000
2025-08-27,V2X,29,8,3,40,0.075000
2025-08-27,VF Corporation,20,18,2,40,0.050000
2025-08-27,VICI Properties,25,10,5,40,0.125000
2025-08-27,Vail Resorts,9,20,11,40,0.275000
2025-08-27,Valero Energy,39,0,1,40,0.025000
2025-08-27,Valley National Bancorp,17,19,4,40,0.100000
2025-08-27,Valmont Industries,24,13,3,40,0.075000
2025-08-27,Valvoline inc,21,18,1,40,0.025000
2025-08-27,Ventas inc,26,14,0,40,0.000000
2025-08-27,Verisk,13,12,15,40,0.375000
2025-08-27,Verizon,18,14,8,40,0.200000
2025-08-27,Vertex Pharmaceuticals,18,14,8,40,0.200000
2025-08-27,Vertiv,19,20,1,40,0.025000
2025-08-27,Viasat,18,17,5,40,0.125000
2025-08-27,Viatris,18,18,4,40,0.100000
2025-08-27,Victorias Secret,16,15,9,40,0.225000
2025-08-27,Visa,9,15,16,40,0.400000
2025-08-27,Vishay Intertechnology,17,17,6,40,0.150000
2025-08-27,Vista Outdoor,14,22,4,40,0.100000
2025-08-27,Visteon,21,19,0,40,0.000000
2025-08-27,Vistra,17,15,8,40,0.200000
2025-08-27,Vontier,24,12,4,40,0.100000
2025-08-27,Voya Financial,22,12,6,40,0.150000
2025-08-27,Vulcan Materials,17,18,5,40,0.125000
2025-08-27,WEC Energy,36,3,1,40,0.025000
2025-08-27,WESCO International,26,12,2,40,0.050000
2025-08-27,WEX,18,17,5,40,0.125000
2025-08-27,WR Berkley,19,15,6,40,0.150000
2025-08-27,WW Grainger,20,12,8,40,0.200000
2025-08-27,Wabash National,15,17,8,40,0.200000
2025-08-27,Walgreens,7,17,16,40,0.400000
2025-08-27,Walmart,15,16,9,40,0.225000
2025-08-27,Walt Disney,20,12,8,40,0.200000
2025-08-27,Warner Bros Discovery,8,30,2,40,0.050000
2025-08-27,Warner Music Group,10,28,2,40,0.050000
2025-08-27,Waters Corporation,20,16,4,40,0.100000
2025-08-27,Watsco,19,14,7,40,0.175000
2025-08-27,Wayfair,19,15,6,40,0.150000
2025-08-27,Webster Financial,22,12,6,40,0.150000
2025-08-27,Weis Markets,14,18,8,40,0.200000
2025-08-27,Wells Fargo,26,5,9,40,0.225000
2025-08-27,Welltower,30,6,4,40,0.100000
2025-08-27,Werner Enterprises,18,19,3,40,0.075000
2025-08-27,West Pharmaceutical Services,26,13,1,40,0.025000
2025-08-27,Western & Southern Financial,15,22,3,40,0.075000
2025-08-27,Western Alliance Bancorp,15,14,11,40,0.275000
2025-08-27,Western Digital,23,14,3,40,0.075000
2025-08-27,Western Midstream Partners,17,13,10,40,0.250000
2025-08-27,Western Union,14,24,2,40,0.050000
2025-08-27,Westinghouse Air Brake Technologies,10,25,5,40,0.125000
2025-08-27,Westlake Corporation,22,14,4,40,0.100000
2025-08-27,Weyerhaeuser,16,21,3,40,0.075000
2025-08-27,Whirlpool,16,17,7,40,0.175000
2025-08-27,Williams,11,20,9,40,0.225000
2025-08-27,Williams-Sonoma,10,24,6,40,0.150000
2025-08-27,Winnebago Industries,18,21,1,40,0.025000
2025-08-27,Wintrust Financial,23,13,4,40,0.100000
2025-08-27,Woodward inc,10,25,5,40,0.125000
2025-08-27,Workday,14,13,13,40,0.325000
2025-08-27,World Kinect,19,15,6,40,0.150000
2025-08-27,Worthington Enterprises,19,15,6,40,0.150000
2025-08-27,Wynn Resorts,18,11,11,40,0.275000
2025-08-27,XPO,17,15,8,40,0.200000
2025-08-27,Xcel Energy,30,4,6,40,0.150000
2025-08-27,Xerox,15,18,7,40,0.175000
2025-08-27,Xylem,24,12,4,40,0.100000
2025-08-27,Yum Brands,18,14,8,40,0.200000
2025-08-27,Yum China,18,20,2,40,0.050000
2025-08-27,Zebra Technologies,16,18,6,40,0.150000
2025-08-27,Zimmer Biomet,18,19,3,40,0.075000
2025-08-27,Zions Bancorp,18,16,6,40,0.150000
2025-08-27,Zoetis,24,14,2,40,0.050000
2025-08-27,Zoom Video Communications,14,22,4,40,0.100000
2025-08-27,eXp World,15,21,4,40,0.100000
2025-08-27,iHeartMedia,18,20,2,40,0.050000
2025-08-28,3M,15,20,5,40,0.125000
2025-08-28,A O Smith,14,20,6,40,0.150000
2025-08-28,A-Mark Precious Metals,40,0,0,40,0.000000
2025-08-28,ABM Industries,22,14,4,40,0.100000
2025-08-28,ADT,20,16,4,40,0.100000
2025-08-28,AECOM,19,17,4,40,0.100000
2025-08-28,AES,23,7,10,40,0.250000
2025-08-28,AGCO,18,16,6,40,0.150000
2025-08-28,AGNC Investment,19,14,7,40,0.175000
2025-08-28,AMC Entertainment,33,5,2,40,0.050000
2025-08-28,AMC Networks,15,18,7,40,0.175000
2025-08-28,AMN Healthcare Services,17,19,4,40,0.100000
2025-08-28,APA,18,14,8,40,0.200000
2025-08-28,APi Group,24,13,3,40,0.075000
2025-08-28,ARKO,17,16,7,40,0.175000
2025-08-28,ASGN,20,16,4,40,0.100000
2025-08-28,AT&T,22,13,5,40,0.125000
2025-08-28,ATI inc,22,14,4,40,0.100000
2025-08-28,AbbVie,17,17,6,40,0.150000
2025-08-28,Abbott Laboratories,20,12,8,40,0.200000
2025-08-28,Abercrombie & Fitch,11,27,2,40,0.050000
2025-08-28,Academy Sports and Outdoors,19,18,3,40,0.075000
2025-08-28,Acadia Healthcare,19,16,5,40,0.125000
2025-08-28,Acuity Brands,11,27,2,40,0.050000
2025-08-28,Adams Resources & Energy,22,7,1,30,0.033333
2025-08-28,AdaptHealth,18,16,6,40,0.150000
2025-08-28,Adobe,18,15,7,40,0.175000
2025-08-28,Advance Auto Parts,16,15,9,40,0.225000
2025-08-28,Advanced Drainage Systems,35,4,1,40,0.025000
2025-08-28,Advanced Micro Devices,30,8,2,40,0.050000
2025-08-28,Advantage Solutions,38,0,2,40,0.050000
2025-08-28,Aflac,14,17,9,40,0.225000
2025-08-28,Agilent Technologies,22,14,4,40,0.100000
2025-08-28,Agilon Health,19,14,7,40,0.175000
2025-08-28,Air Lease,22,13,5,40,0.125000
2025-08-28,Air Products & Chemicals,18,17,5,40,0.125000
2025-08-28,Airbnb,15,17,8,40,0.200000
2025-08-28,Akamai Technologies,24,10,6,40,0.150000
2025-08-28,Alaska Air,18,20,2,40,0.050000
2025-08-28,Albemarle Corporation,15,18,7,40,0.175000
2025-08-28,Albertsons,20,11,9,40,0.225000
2025-08-28,Alcoa Corporation,19,10,11,40,0.275000
2025-08-28,Alexandria Real Estate Equities,15,22,3,40,0.075000
2025-08-28,Alight Solutions,17,19,4,40,0.100000
2025-08-28,Align Technology,13,15,12,40,0.300000
2025-08-28,Allegiant Travel Company,13,19,8,40,0.200000
2025-08-28,Alliance Resource Partners,13,8,19,40,0.475000
2025-08-28,Alliant Energy,36,1,3,40,0.075000
2025-08-28,Allison Transmission,18,14,8,40,0.200000
2025-08-28,Allstate,25,12,3,40,0.075000
2025-08-28,Ally Financial,16,21,3,40,0.075000
2025-08-28,Alpha Metallurgical Resources,21,15,4,40,0.100000
2025-08-28,Alphabet,13,20,7,40,0.175000
2025-08-28,Altice,14,17,9,40,0.225000
2025-08-28,Altria,23,11,6,40,0.150000
2025-08-28,Amazon,26,2,12,40,0.300000
2025-08-28,Ameren,23,15,2,40,0.050000
2025-08-28,American Airlines,11,14,15,40,0.375000
2025-08-28,American Axle & Manufacturing,13,23,4,40,0.100000
2025-08-28,American Eagle Outfitters,15,21,4,40,0.100000
2025-08-28,American Electric Power,22,15,3,40,0.075000
2025-08-28,American Express,20,11,9,40,0.225000
2025-08-28,American Family Insurance,25,13,2,40,0.050000
2025-08-28,American Financial,23,11,6,40,0.150000
2025-08-28,American International Group,26,12,2,40,0.050000
2025-08-28,American Tower,23,13,4,40,0.100000
2025-08-28,American Water Works,19,14,7,40,0.175000
2025-08-28,Americold Realty Trust,34,6,0,40,0.000000
2025-08-28,Ameriprise Financial,26,11,3,40,0.075000
2025-08-28,Ametek,24,11,5,40,0.125000
2025-08-28,Amgen,22,13,5,40,0.125000
2025-08-28,Amica Mutual Insurance,14,24,2,40,0.050000
2025-08-28,Amkor Technology,15,17,8,40,0.200000
2025-08-28,Amphenol,23,14,3,40,0.075000
2025-08-28,Analog Devices,14,19,7,40,0.175000
2025-08-28,Antero Resources,16,21,3,40,0.075000
2025-08-28,Anywhere Real Estate Inc,15,19,6,40,0.150000
2025-08-28,Apollo Global Management,15,21,4,40,0.100000
2025-08-28,AppLovin,22,14,4,40,0.100000
2025-08-28,Apple,13,20,7,40,0.175000
2025-08-28,Applied Industrial Technologies,18,20,2,40,0.050000
2025-08-28,Applied Materials,14,12,14,40,0.350000
2025-08-28,AptarGroup,13,18,9,40,0.225000
2025-08-28,Aramark,17,17,6,40,0.150000
2025-08-28,ArcBest,12,19,9,40,0.225000
2025-08-28,Arch Resources,29,6,5,40,0.125000
2025-08-28,Archer Daniels Midland,23,14,3,40,0.075000
2025-08-28,Ares Management,30,7,3,40,0.075000
2025-08-28,Arista Networks,23,13,4,40,0.100000
2025-08-28,Arrow Electronics,23,12,5,40,0.125000
2025-08-28,Arthur J Gallagher,8,27,5,40,0.125000
2025-08-28,Asbury Automotive Group,19,15,6,40,0.150000
2025-08-28,Assurant,21,13,6,40,0.150000
2025-08-28,Atkore,16,19,5,40,0.125000
2025-08-28,Atlassian,14,16,10,40,0.250000
2025-08-28,Atmos Energy,33,4,3,40,0.075000
2025-08-28,Auto-Owners Insurance,14,21,5,40,0.125000
2025-08-28,AutoNation,19,17,4,40,0.100000
2025-08-28,AutoZone,21,12,7,40,0.175000
2025-08-28,Autodesk,15,21,4,40,0.100000
2025-08-28,Autoliv,19,15,6,40,0.150000
2025-08-28,Automatic Data Processing,22,15,3,40,0.075000
2025-08-28,AvalonBay Communities,21,16,3,40,0.075000
2025-08-28,Avantor,18,17,5,40,0.125000
2025-08-28,Avery Dennison,16,21,3,40,0.075000
2025-08-28,Avient,22,12,6,40,0.150000
2025-08-28,Avis Budget,13,19,8,40,0.200000
2025-08-28,Avnet,22,17,1,40,0.025000
2025-08-28,BJs Wholesale Club,10,25,5,40,0.125000
2025-08-28,BOK Financial,16,21,3,40,0.075000
2025-08-28,BWX Technologies,22,18,0,40,0.000000
2025-08-28,Baker Hughes,23,15,2,40,0.050000
2025-08-28,Ball,18,18,4,40,0.100000
2025-08-28,Bank of America,16,18,6,40,0.150000
2025-08-28,Bank of New York Mellon,30,8,2,40,0.050000
2025-08-28,Bath & Body Works,12,19,9,40,0.225000
2025-08-28,Baxter International,15,22,3,40,0.075000
2025-08-28,Beacon Roofing Supply,9,24,7,40,0.175000
2025-08-28,Becton Dickinson,21,13,6,40,0.150000
2025-08-28,Belden,15,21,4,40,0.100000
2025-08-28,Benchmark Electronics,22,13,5,40,0.125000
2025-08-28,Berkshire Hathaway,12,20,8,40,0.200000
2025-08-28,Best Buy,40,0,0,40,0.000000
2025-08-28,Big Lots,8,30,2,40,0.050000
2025-08-28,Bio-Rad Laboratories,18,20,2,40,0.050000
2025-08-28,Biogen,18,19,3,40,0.075000
2025-08-28,BlackRock,33,5,2,40,0.050000
2025-08-28,Blackstone,22,15,3,40,0.075000
2025-08-28,Bloomin Brands,16,18,6,40,0.150000
2025-08-28,BlueLinx,17,20,3,40,0.075000
2025-08-28,Boeing,16,19,5,40,0.125000
2025-08-28,Boise Cascade,18,11,11,40,0.275000
2025-08-28,Booking Holdings,12,22,6,40,0.150000
2025-08-28,Booz Allen Hamilton,20,15,5,40,0.125000
2025-08-28,BorgWarner,19,19,2,40,0.050000
2025-08-28,Boston Properties,18,16,6,40,0.150000
2025-08-28,Boston Scientific,18,16,6,40,0.150000
2025-08-28,Boyd Gaming,18,18,4,40,0.100000
2025-08-28,Bread Financial,31,6,3,40,0.075000
2025-08-28,BrightSpring Health Services,27,6,7,40,0.175000
2025-08-28,BrightView Holdings,24,12,4,40,0.100000
2025-08-28,Brighthouse Financial,17,15,8,40,0.200000
2025-08-28,Brinker International,25,12,3,40,0.075000
2025-08-28,Brinks Company,8,4,4,16,0.250000
2025-08-28,Bristol-Myers Squibb,17,15,8,40,0.200000
2025-08-28,Broadcom,18,19,3,40,0.075000
2025-08-28,Broadridge Financial Solutions,30,3,7,40,0.175000
2025-08-28,Brookdale Senior Living,18,15,7,40,0.175000
2025-08-28,Brown & Brown,15,18,7,40,0.175000
2025-08-28,Brown-Forman,11,23,6,40,0.150000
2025-08-28,Bruker,9,20,11,40,0.275000
2025-08-28,Brunswick,12,15,13,40,0.325000
2025-08-28,Builders FirstSource,23,13,4,40,0.100000
2025-08-28,Burlington Stores,15,23,2,40,0.050000
2025-08-28,CACI International,22,12,6,40,0.150000
2025-08-28,CBRE Group,19,20,1,40,0.025000
2025-08-28,CDW,19,14,7,40,0.175000
2025-08-28,CH Robinson Worldwide,17,16,7,40,0.175000
2025-08-28,CHS,12,26,2,40,0.050000
2025-08-28,CME Group,21,18,1,40,0.025000
2025-08-28,CMS Energy,37,2,1,40,0.025000
2025-08-28,CNO Financial Group,14,24,2,40,0.050000
2025-08-28,CNX Resources,21,12,7,40,0.175000
2025-08-28,CSX,17,13,10,40,0.250000
2025-08-28,CVS Health,16,13,11,40,0.275000
2025-08-28,Cabot Corporation,21,17,2,40,0.050000
2025-08-28,Cadence,21,12,7,40,0.175000
2025-08-28,Caesars Entertainment,32,8,0,40,0.000000
2025-08-28,Cal-Maine Foods,17,19,4,40,0.100000
2025-08-28,Caleres inc,22,15,3,40,0.075000
2025-08-28,California Resources,17,18,5,40,0.125000
2025-08-28,Calumet,13,16,11,40,0.275000
2025-08-28,Campbell Soup,13,23,4,40,0.100000
2025-08-28,Camping World,12,20,8,40,0.200000
2025-08-28,Capital One,21,15,4,40,0.100000
2025-08-28,CarMax,12,27,1,40,0.025000
2025-08-28,Cardinal Health,15,18,7,40,0.175000
2025-08-28,Carlisle Companies,15,15,10,40,0.250000
2025-08-28,Carlyle Group,22,14,4,40,0.100000
2025-08-28,Carpenter Technology,16,19,5,40,0.125000
2025-08-28,Carrier Global,15,21,4,40,0.100000
2025-08-28,Carters inc,9,20,2,31,0.064516
2025-08-28,Carvana,25,11,4,40,0.100000
2025-08-28,Caseys General Stores,13,22,5,40,0.125000
2025-08-28,Caterpillar,19,13,8,40,0.200000
2025-08-28,Cboe Global Markets,23,14,3,40,0.075000
2025-08-28,Celanese,16,10,14,40,0.350000
2025-08-28,Cencora,21,15,4,40,0.100000
2025-08-28,Centene,20,8,12,40,0.300000
2025-08-28,CenterPoint Energy,27,6,7,40,0.175000
2025-08-28,Central Garden & Pet,7,31,2,40,0.050000
2025-08-28,Century Communities,21,15,4,40,0.100000
2025-08-28,ChampionX,19,18,3,40,0.075000
2025-08-28,Charles River Laboratories International,21,15,4,40,0.100000
2025-08-28,Charles Schwab,26,14,0,40,0.000000
2025-08-28,Chart Industries,13,20,7,40,0.175000
2025-08-28,Charter Communications,18,13,9,40,0.225000
2025-08-28,Cheesecake Factory,14,10,16,40,0.400000
2025-08-28,Chefs Warehouse,22,13,5,40,0.125000
2025-08-28,Chemours,14,14,12,40,0.300000
2025-08-28,Cheniere Energy,36,4,0,40,0.000000
2025-08-28,Chevron,17,17,6,40,0.150000
2025-08-28,Chewy,23,15,2,40,0.050000
2025-08-28,Chipotle Mexican Grill,14,23,3,40,0.075000
2025-08-28,Chord Energy,34,3,3,40,0.075000
2025-08-28,Church & Dwight,18,15,7,40,0.175000
2025-08-28,Ciena,20,16,4,40,0.100000
2025-08-28,Cigna,18,14,8,40,0.200000
2025-08-28,Cincinnati Financial,20,19,1,40,0.025000
2025-08-28,Cinemark,17,19,4,40,0.100000
2025-08-28,Cintas,24,13,3,40,0.075000
2025-08-28,Cisco Systems,16,18,6,40,0.150000
2025-08-28,Citigroup,26,11,3,40,0.075000
2025-08-28,Citizens Financial Group,27,10,3,40,0.075000
2025-08-28,Civitas Resources,18,15,7,40,0.175000
2025-08-28,Clean Harbors,36,3,1,40,0.025000
2025-08-28,Clear Channel Outdoor Hldgs,7,1,2,10,0.200000
2025-08-28,Cleveland-Cliffs,16,20,4,40,0.100000
2025-08-28,Clorox,17,16,7,40,0.175000
2025-08-28,Cognizant Technology Solutions,36,0,4,40,0.100000
2025-08-28,Coherent,16,19,5,40,0.125000
2025-08-28,Coinbase Global,14,20,6,40,0.150000
2025-08-28,Colgate-Palmolive,21,9,10,40,0.250000
2025-08-28,Columbia Banking System,20,15,5,40,0.125000
2025-08-28,Columbia Sportswear,18,17,5,40,0.125000
2025-08-28,Comcast,24,14,2,40,0.050000
2025-08-28,Comerica,27,9,4,40,0.100000
2025-08-28,Comfort Systems USA,39,0,1,40,0.025000
2025-08-28,CommScope,15,23,2,40,0.050000
2025-08-28,Commercial Metals,26,11,3,40,0.075000
2025-08-28,Community Health Systems,19,16,5,40,0.125000
2025-08-28,Compass,18,20,2,40,0.050000
2025-08-28,Conagra Brands,24,11,5,40,0.125000
2025-08-28,Concentrix,23,13,4,40,0.100000
2025-08-28,Conduent,21,15,4,40,0.100000
2025-08-28,ConocoPhillips,18,16,6,40,0.150000
2025-08-28,Consol Energy,32,4,4,40,0.100000
2025-08-28,Consolidated Edison,18,17,5,40,0.125000
2025-08-28,Constellation Brands,9,19,12,40,0.300000
2025-08-28,Constellation Energy,35,4,1,40,0.025000
2025-08-28,Continental Resources,16,15,9,40,0.225000
2025-08-28,Cooper Cos,6,31,3,40,0.075000
2025-08-28,Cooper-Standard,21,15,4,40,0.100000
2025-08-28,Copart,19,17,4,40,0.100000
2025-08-28,Core & Main,14,21,5,40,0.125000
2025-08-28,Cornerstone Building Brands,17,19,4,40,0.100000
2025-08-28,Corning,15,18,7,40,0.175000
2025-08-28,Corpay,18,21,1,40,0.025000
2025-08-28,Corteva,19,12,9,40,0.225000
2025-08-28,Costco,16,21,3,40,0.075000
2025-08-28,Coterra Energy,38,1,1,40,0.025000
2025-08-28,Coty,14,13,13,40,0.325000
2025-08-28,Country Financial,13,22,5,40,0.125000
2025-08-28,Coupang,27,11,2,40,0.050000
2025-08-28,Cracker Barrel Old Country Store,13,16,11,40,0.275000
2025-08-28,Crocs,8,30,2,40,0.050000
2025-08-28,CrossAmerica Partners,19,11,10,40,0.250000
2025-08-28,CrowdStrike,13,16,11,40,0.275000
2025-08-28,Crown Castle,17,13,10,40,0.250000
2025-08-28,Crown Holdings,18,14,8,40,0.200000
2025-08-28,Cullen Frost Bankers,22,14,4,40,0.100000
2025-08-28,Cummins,15,21,4,40,0.100000
2025-08-28,Curtiss-Wright,17,17,6,40,0.150000
2025-08-28,DR Horton,15,22,3,40,0.075000
2025-08-28,DTE Energy,31,4,5,40,0.125000
2025-08-28,DXC Technology,16,22,2,40,0.050000
2025-08-28,DaVita,16,10,14,40,0.350000
2025-08-28,Dana Incorporated,22,11,7,40,0.175000
2025-08-28,Danaher,24,14,2,40,0.050000
2025-08-28,Darden Restaurants,19,12,9,40,0.225000
2025-08-28,Darling Ingredients,39,1,0,40,0.000000
2025-08-28,Deckers Outdoor,24,13,3,40,0.075000
2025-08-28,Deere,16,16,8,40,0.200000
2025-08-28,Delek US,16,19,5,40,0.125000
2025-08-28,Dell Technologies,17,20,3,40,0.075000
2025-08-28,Delta Air Lines,12,19,9,40,0.225000
2025-08-28,Dentsply Sirona,14,21,5,40,0.125000
2025-08-28,Designer Brands,14,20,6,40,0.150000
2025-08-28,Devon Energy,40,0,0,40,0.000000
2025-08-28,DexCom,16,18,6,40,0.150000
2025-08-28,Diamondback Energy,38,2,0,40,0.000000
2025-08-28,Dicks Sporting Goods,16,20,4,40,0.100000
2025-08-28,Diebold Nixdorf,20,17,3,40,0.075000
2025-08-28,Digital Realty Trust,38,2,0,40,0.000000
2025-08-28,Dillards,19,18,3,40,0.075000
2025-08-28,DocuSign,22,16,2,40,0.050000
2025-08-28,Dollar General,15,18,7,40,0.175000
2025-08-28,Dollar Tree,20,20,0,40,0.000000
2025-08-28,Dominion Energy,33,6,1,40,0.025000
2025-08-28,Dominos Pizza inc,15,19,6,40,0.150000
2025-08-28,Domtar,8,27,5,40,0.125000
2025-08-28,Donaldson Company,20,15,5,40,0.125000
2025-08-28,DoorDash,18,17,5,40,0.125000
2025-08-28,Dover Corporation,21,16,3,40,0.075000
2025-08-28,DraftKings,25,13,2,40,0.050000
2025-08-28,Dream Finders Homes,31,5,4,40,0.100000
2025-08-28,Dropbox,16,20,4,40,0.100000
2025-08-28,DuPont,14,19,7,40,0.175000
2025-08-28,Duke Energy,37,1,2,40,0.050000
2025-08-28,Dycom Industries,12,20,8,40,0.200000
2025-08-28,EMCOR Group,24,12,4,40,0.100000
2025-08-28,EOG Resources,26,9,5,40,0.125000
2025-08-28,EPAM Systems,20,15,5,40,0.125000
2025-08-28,EQT,16,20,4,40,0.100000
2025-08-28,ESAB,16,16,8,40,0.200000
2025-08-28,East West Bancorp,22,16,2,40,0.050000
2025-08-28,Eastman Chemical,12,22,6,40,0.150000
2025-08-28,Ebay,18,14,8,40,0.200000
2025-08-28,EchoStar,11,23,6,40,0.150000
2025-08-28,Ecolab,24,11,5,40,0.125000
2025-08-28,Edison International,14,17,9,40,0.225000
2025-08-28,Edward Jones,16,20,4,40,0.100000
2025-08-28,Edwards Lifesciences,14,13,13,40,0.325000
2025-08-28,Elanco Animal Health,21,18,1,40,0.025000
2025-08-28,Electronic Arts,8,21,11,40,0.275000
2025-08-28,Elevance Health,16,12,12,40,0.300000
2025-08-28,Eli Lilly,17,13,10,40,0.250000
2025-08-28,Emerson Electric,20,16,4,40,0.100000
2025-08-28,EnLink Midstream,16,20,4,40,0.100000
2025-08-28,Encompass Health,12,26,2,40,0.050000
2025-08-28,Endeavor Group,13,22,5,40,0.125000
2025-08-28,EnerSys,22,16,2,40,0.050000
2025-08-28,Energizer,38,1,1,40,0.025000
2025-08-28,Energy Transfer,35,2,3,40,0.075000
2025-08-28,Ensign Group,21,12,7,40,0.175000
2025-08-28,Entegris,21,12,7,40,0.175000
2025-08-28,Entergy,25,12,3,40,0.075000
2025-08-28,Enterprise Products Partners,16,12,12,40,0.300000
2025-08-28,Envista,20,12,8,40,0.200000
2025-08-28,Equifax,17,18,5,40,0.125000
2025-08-28,Equinix,22,17,1,40,0.025000
2025-08-28,Equitable,21,15,4,40,0.100000
2025-08-28,Equity Residential,18,18,4,40,0.100000
2025-08-28,Erie Insurance,13,15,12,40,0.300000
2025-08-28,Estée Lauder,8,19,13,40,0.325000
2025-08-28,Etsy,18,15,7,40,0.175000
2025-08-28,Euronet Worldwide,21,13,6,40,0.150000
2025-08-28,Evergy,22,13,5,40,0.125000
2025-08-28,Eversource Energy,29,6,5,40,0.125000
2025-08-28,Exact Sciences,14,14,12,40,0.300000
2025-08-28,Exelon,17,19,4,40,0.100000
2025-08-28,Expand Energy,39,1,0,40,0.000000
2025-08-28,Expedia,30,9,1,40,0.025000
2025-08-28,Expeditors International of Washington,14,22,4,40,0.100000
2025-08-28,Extra Space Storage,16,12,12,40,0.300000
2025-08-28,Exxon Mobil,22,16,2,40,0.050000
2025-08-28,F5,21,16,3,40,0.075000
2025-08-28,FM Global,11,17,12,40,0.300000
2025-08-28,FMC Corporation,15,18,7,40,0.175000
2025-08-28,FTI Consulting,17,20,3,40,0.075000
2025-08-28,Fannie Mae,10,28,2,40,0.050000
2025-08-28,Farmers Insurance Exchange,9,19,12,40,0.300000
2025-08-28,Fastenal,23,11,6,40,0.150000
2025-08-28,FedEx,21,16,3,40,0.075000
2025-08-28,Federated Mutual Insurance,19,19,2,40,0.050000
2025-08-28,Fidelity National Financial,16,20,4,40,0.100000
2025-08-28,Fidelity National Information Services,19,17,4,40,0.100000
2025-08-28,Fifth Third Bancorp,25,14,1,40,0.025000
2025-08-28,First American Financial,20,13,7,40,0.175000
2025-08-28,First Citizens BancShares,20,18,2,40,0.050000
2025-08-28,First Horizon,11,23,6,40,0.150000
2025-08-28,First National of Nebraska,16,23,1,40,0.025000
2025-08-28,First Solar,25,12,3,40,0.075000
2025-08-28,FirstCash,18,18,4,40,0.100000
2025-08-28,FirstEnergy,16,13,11,40,0.275000
2025-08-28,Fiserv,14,16,10,40,0.250000
2025-08-28,Five Below,22,17,1,40,0.025000
2025-08-28,Flagstar Financial,15,21,4,40,0.100000
2025-08-28,Floor & Decor,17,22,1,40,0.025000
2025-08-28,Flowers Foods,18,14,8,40,0.200000
2025-08-28,Flowserve,19,17,4,40,0.100000
2025-08-28,Fluor,16,16,8,40,0.200000
2025-08-28,Foot Locker,8,20,12,40,0.300000
2025-08-28,Ford Motor,18,13,9,40,0.225000
2025-08-28,Fortinet,20,15,5,40,0.125000
2025-08-28,Fortive,26,11,3,40,0.075000
2025-08-28,Fortune Brands Innovations,17,20,3,40,0.075000
2025-08-28,Franklin Resources,22,13,5,40,0.125000
2025-08-28,Freddie Mac,10,27,3,40,0.075000
2025-08-28,Freeport-McMoRan,21,15,4,40,0.100000
2025-08-28,Frontier Airlines,13,18,9,40,0.225000
2025-08-28,Frontier Communications,20,16,4,40,0.100000
2025-08-28,G-III Apparel Group,28,11,1,40,0.025000
2025-08-28,GE HealthCare Technologies,22,12,6,40,0.150000
2025-08-28,GMS,16,21,3,40,0.075000
2025-08-28,GXO Logistics,15,16,9,40,0.225000
2025-08-28,GameStop,19,18,3,40,0.075000
2025-08-28,Gannett,19,12,9,40,0.225000
2025-08-28,Garrett Motion inc,18,18,4,40,0.100000
2025-08-28,Gartner,11,22,7,40,0.175000
2025-08-28,Gen Digital,21,12,7,40,0.175000
2025-08-28,Generac,18,22,0,40,0.000000
2025-08-28,General Dynamics,36,3,1,40,0.025000
2025-08-28,General Electric,15,17,8,40,0.200000
2025-08-28,General Mills,16,18,6,40,0.150000
2025-08-28,General Motors,19,14,7,40,0.175000
2025-08-28,Genesis Energy,33,4,3,40,0.075000
2025-08-28,Genuine Parts,15,17,8,40,0.200000
2025-08-28,Genworth Financial,17,17,6,40,0.150000
2025-08-28,Gilead Sciences,23,13,4,40,0.100000
2025-08-28,Global Partners,9,20,11,40,0.275000
2025-08-28,Global Payments,15,24,1,40,0.025000
2025-08-28,Globe Life,22,16,2,40,0.050000
2025-08-28,GoDaddy,19,19,2,40,0.050000
2025-08-28,Goldman Sachs,16,19,5,40,0.125000
2025-08-28,Goodyear Tire & Rubber,13,20,7,40,0.175000
2025-08-28,Graham Holdings Company,19,16,5,40,0.125000
2025-08-28,Granite Construction,21,13,6,40,0.150000
2025-08-28,Graphic Packaging,20,14,6,40,0.150000
2025-08-28,Gray Television,13,18,9,40,0.225000
2025-08-28,Graybar Electric,17,18,5,40,0.125000
2025-08-28,Green Plains inc,20,13,7,40,0.175000
2025-08-28,Greenbrier,12,18,10,40,0.250000
2025-08-28,Greif,13,23,4,40,0.100000
2025-08-28,Griffon Corporation,20,16,4,40,0.100000
2025-08-28,Grocery Outlet Holding,13,24,3,40,0.075000
2025-08-28,Group 1 Automotive,13,23,4,40,0.100000
2025-08-28,Guardian Life insurance,18,22,0,40,0.000000
2025-08-28,Guess inc,17,18,5,40,0.125000
2025-08-28,H B Fuller,20,16,4,40,0.100000
2025-08-28,H&R Block,12,2,26,40,0.650000
2025-08-28,HCA Healthcare,16,18,6,40,0.150000
2025-08-28,HEICO,23,16,1,40,0.025000
2025-08-28,HF Sinclair,13,19,8,40,0.200000
2025-08-28,Halliburton,20,17,3,40,0.075000
2025-08-28,Hanesbrands,13,25,2,40,0.050000
2025-08-28,Hanover Insurance Group,18,18,4,40,0.100000
2025-08-28,Harley-Davidson,16,22,2,40,0.050000
2025-08-28,Hasbro,23,13,4,40,0.100000
2025-08-28,Hawaiian Airlines inc,18,22,0,40,0.000000
2025-08-28,Hawaiian Electric Industries,21,14,5,40,0.125000
2025-08-28,Helmerich & Payne,16,22,2,40,0.050000
2025-08-28,Henry Schein,17,17,6,40,0.150000
2025-08-28,Herc Rentals,20,14,6,40,0.150000
2025-08-28,Hershey,17,16,7,40,0.175000
2025-08-28,Hertz,21,10,9,40,0.225000
2025-08-28,Hewlett Packard,16,19,5,40,0.125000
2025-08-28,Hewlett Packard Enterprise,16,20,4,40,0.100000
2025-08-28,Hillenbrand,17,20,3,40,0.075000
2025-08-28,Hilton Grand Vacations,39,0,1,40,0.025000
2025-08-28,Hilton Worldwide,29,8,3,40,0.075000
2025-08-28,Hologic,16,17,7,40,0.175000
2025-08-28,Home Depot,11,13,16,40,0.400000
2025-08-28,Honeywell,20,15,5,40,0.125000
2025-08-28,Hormel Foods,12,20,8,40,0.200000
2025-08-28,Host Hotels & Resorts,12,23,5,40,0.125000
2025-08-28,Hovnanian Enterprises,24,14,2,40,0.050000
2025-08-28,Howmet Aerospace,13,18,9,40,0.225000
2025-08-28,Hub Group,20,15,5,40,0.125000
2025-08-28,Hubbell,11,21,8,40,0.200000
2025-08-28,Humana,29,6,5,40,0.125000
2025-08-28,Huntington Bancshares,21,16,3,40,0.075000
2025-08-28,Huntington Ingalls Industries,25,13,2,40,0.050000
2025-08-28,Huntsman,11,16,13,40,0.325000
2025-08-28,Hyatt Hotels,18,20,2,40,0.050000
2025-08-28,Hyster-Yale,15,20,5,40,0.125000
2025-08-28,IAC,17,16,7,40,0.175000
2025-08-28,IBM,13,22,5,40,0.125000
2025-08-28,IDEX,21,11,8,40,0.200000
2025-08-28,IDEXX Laboratories,21,14,5,40,0.125000
2025-08-28,IQVIA,21,12,7,40,0.175000
2025-08-28,ITT,28,11,1,40,0.025000
2025-08-28,Icahn Enterprises,15,12,13,40,0.325000
2025-08-28,Illinois Tool Works,10,27,3,40,0.075000
2025-08-28,Illumina inc,19,15,6,40,0.150000
2025-08-28,Incyte,18,19,3,40,0.075000
2025-08-28,Ingersoll Rand,18,16,6,40,0.150000
2025-08-28,Ingles Markets,15,18,7,40,0.175000
2025-08-28,Ingram Micro,21,13,6,40,0.150000
2025-08-28,Ingredion,26,10,4,40,0.100000
2025-08-28,Insight Enterprises,18,18,4,40,0.100000
2025-08-28,Insperity,25,10,5,40,0.125000
2025-08-28,Instacart,20,15,5,40,0.125000
2025-08-28,Installed Building Products,16,18,6,40,0.150000
2025-08-28,Intel,13,16,11,40,0.275000
2025-08-28,Interactive Brokers,17,18,5,40,0.125000
2025-08-28,Intercontinental Exchange,22,16,2,40,0.050000
2025-08-28,International Flavors & Fragrances,22,12,6,40,0.150000
2025-08-28,International Paper,14,22,4,40,0.100000
2025-08-28,Interpublic Group,19,13,8,40,0.200000
2025-08-28,Intuit,13,19,8,40,0.200000
2025-08-28,Intuitive Surgical,16,14,10,40,0.250000
2025-08-28,Iron Mountain,11,23,6,40,0.150000
2025-08-28,JB Hunt Transport Services,18,18,4,40,0.100000
2025-08-28,JELD-WEN Holding,19,14,7,40,0.175000
2025-08-28,JM Smucker,10,19,11,40,0.275000
2025-08-28,JPMorgan Chase,27,11,2,40,0.050000
2025-08-28,Jabil,16,17,7,40,0.175000
2025-08-28,Jackson Financial,18,18,4,40,0.100000
2025-08-28,Jacobs Solutions,34,0,6,40,0.150000
2025-08-28,Jefferies Financial,15,16,9,40,0.225000
2025-08-28,JetBlue Airways,23,14,3,40,0.075000
2025-08-28,Johnson & Johnson,15,22,3,40,0.075000
2025-08-28,Jones Lang LaSalle,15,22,3,40,0.075000
2025-08-28,Juniper Networks,17,20,3,40,0.075000
2025-08-28,KB Home,16,19,5,40,0.125000
2025-08-28,KBR,25,10,5,40,0.125000
2025-08-28,KKR,25,13,2,40,0.050000
2025-08-28,KLA,19,16,5,40,0.125000
2025-08-28,Kaiser Aluminum,19,16,5,40,0.125000
2025-08-28,Kellanova,22,13,5,40,0.125000
2025-08-28,Kelly Services inc,19,15,6,40,0.150000
2025-08-28,Kemper,18,13,9,40,0.225000
2025-08-28,Keurig Dr Pepper,5,30,5,40,0.125000
2025-08-28,KeyCorp,22,13,5,40,0.125000
2025-08-28,Keysight Technologies,21,15,4,40,0.100000
2025-08-28,Kimberly-Clark,14,20,6,40,0.150000
2025-08-28,Kinder Morgan,37,1,2,40,0.050000
2025-08-28,Kirby Corporation,23,11,6,40,0.150000
2025-08-28,Knife River Corporation,19,19,2,40,0.050000
2025-08-28,Knight Swift Transportation,27,3,10,40,0.250000
2025-08-28,Kohls,15,11,14,40,0.350000
2025-08-28,Kontoor Brands,19,18,3,40,0.075000
2025-08-28,Korn Ferry,21,11,8,40,0.200000
2025-08-28,Kraft Heinz,16,14,10,40,0.250000
2025-08-28,Kroger,6,30,4,40,0.100000
2025-08-28,Kyndryl,17,19,4,40,0.100000
2025-08-28,L3Harris Technologies,21,11,8,40,0.200000
2025-08-28,LCI Industries,15,20,5,40,0.125000
2025-08-28,LKQ,21,15,4,40,0.100000
2025-08-28,LPL Financial,27,12,1,40,0.025000
2025-08-28,Labcorp Holdings,16,20,4,40,0.100000
2025-08-28,Lam Research,22,15,3,40,0.075000
2025-08-28,Lamb Weston,19,16,5,40,0.125000
2025-08-28,Land O'Lakes,9,27,4,40,0.100000
2025-08-28,Landstar System,16,16,8,40,0.200000
2025-08-28,Las Vegas Sands,15,22,3,40,0.075000
2025-08-28,Lear Corporation,21,15,4,40,0.100000
2025-08-28,Leggett & Platt,18,18,4,40,0.100000
2025-08-28,Leidos,30,8,2,40,0.050000
2025-08-28,Lennar,13,24,3,40,0.075000
2025-08-28,Lennox International,15,15,10,40,0.250000
2025-08-28,Levi Strauss,12,28,0,40,0.000000
2025-08-28,Liberty Energy,40,0,0,40,0.000000
2025-08-28,Liberty Media,40,0,0,40,0.000000
2025-08-28,Liberty Mutual Insurance,32,3,5,40,0.125000
2025-08-28,Light & Wonder,11,24,5,40,0.125000
2025-08-28,Lincoln Electric,18,16,6,40,0.150000
2025-08-28,Lincoln National,16,21,3,40,0.075000
2025-08-28,Lithia Motors,17,16,7,40,0.175000
2025-08-28,Live Nation Entertainment,37,0,3,40,0.075000
2025-08-28,Lockheed Martin,22,12,6,40,0.150000
2025-08-28,Loews,19,17,4,40,0.100000
2025-08-28,Louisiana-Pacific Corporation,19,16,5,40,0.125000
2025-08-28,Lowes,17,19,4,40,0.100000
2025-08-28,Lululemon athletica,17,17,6,40,0.150000
2025-08-28,Lumen Technologies,14,22,4,40,0.100000
2025-08-28,Lyft,13,17,10,40,0.250000
2025-08-28,M&T Bank,17,17,6,40,0.150000
2025-08-28,M/I Homes,16,20,4,40,0.100000
2025-08-28,MDU Resources Group,24,12,4,40,0.100000
2025-08-28,MGM Resorts International,23,13,4,40,0.100000
2025-08-28,MKS Instruments,20,15,5,40,0.125000
2025-08-28,MRC Global,13,21,6,40,0.150000
2025-08-28,MSC Industrial Direct,21,14,5,40,0.125000
2025-08-28,MSCI,31,8,1,40,0.025000
2025-08-28,MYR Group,13,20,7,40,0.175000
2025-08-28,Macys,17,20,3,40,0.075000
2025-08-28,ManpowerGroup,19,16,5,40,0.125000
2025-08-28,Marathon Oil,14,21,5,40,0.125000
2025-08-28,Marathon Petroleum,18,16,6,40,0.150000
2025-08-28,Markel Group,31,7,2,40,0.050000
2025-08-28,Marriott International,21,11,8,40,0.200000
2025-08-28,Marriott Vacations Worldwide,20,18,2,40,0.050000
2025-08-28,Marsh & McLennan,20,18,2,40,0.050000
2025-08-28,Martin Marietta Materials,24,14,2,40,0.050000
2025-08-28,Marvell Technology,11,26,3,40,0.075000
2025-08-28,MasTec,21,12,7,40,0.175000
2025-08-28,Masco,18,13,9,40,0.225000
2025-08-28,Mass Mutual,13,24,3,40,0.075000
2025-08-28,MasterBrand,15,22,3,40,0.075000
2025-08-28,Mastercard,10,25,5,40,0.125000
2025-08-28,Matador Resources,19,13,8,40,0.200000
2025-08-28,Match Group,10,12,18,40,0.450000
2025-08-28,Mativ,15,19,6,40,0.150000
2025-08-28,Matson inc,18,17,5,40,0.125000
2025-08-28,Mattel,16,20,4,40,0.100000
2025-08-28,Maximus,16,16,8,40,0.200000
2025-08-28,McCormick & Company,17,18,5,40,0.125000
2025-08-28,McDonalds,8,21,11,40,0.275000
2025-08-28,McKesson,21,16,3,40,0.075000
2025-08-28,Medical Mutual of Ohio,13,21,6,40,0.150000
2025-08-28,Merck,13,16,11,40,0.275000
2025-08-28,Mercury General,16,19,5,40,0.125000
2025-08-28,Meritage Homes,21,14,5,40,0.125000
2025-08-28,MetLife,22,16,2,40,0.050000
2025-08-28,Meta,17,17,6,40,0.150000
2025-08-28,Mettler-Toledo International,21,15,4,40,0.100000
2025-08-28,Microchip Technology,20,18,2,40,0.050000
2025-08-28,Micron Technology,13,21,6,40,0.150000
2025-08-28,Microsoft,7,14,19,40,0.475000
2025-08-28,Middleby,27,12,1,40,0.025000
2025-08-28,MillerKnoll,17,19,4,40,0.100000
2025-08-28,Moderna,23,10,7,40,0.175000
2025-08-28,ModivCare,11,20,9,40,0.225000
2025-08-28,Mohawk Industries,25,11,4,40,0.100000
2025-08-28,Molina Healthcare,19,14,7,40,0.175000
2025-08-28,Molson Coors Beverage,23,13,4,40,0.100000
2025-08-28,Mondelez,14,16,10,40,0.250000
2025-08-28,Monster Beverage,16,19,5,40,0.125000
2025-08-28,Moodys,11,15,14,40,0.350000
2025-08-28,Moog inc,18,16,6,40,0.150000
2025-08-28,Morgan Stanley,17,18,5,40,0.125000
2025-08-28,Mosaic,22,13,5,40,0.125000
2025-08-28,Motorola Solutions,39,0,1,40,0.025000
2025-08-28,Mueller Industries,21,11,8,40,0.200000
2025-08-28,Murphy Oil,19,14,7,40,0.175000
2025-08-28,Murphy USA,26,12,2,40,0.050000
2025-08-28,Mutual of Omaha,19,18,3,40,0.075000
2025-08-28,NCR Atleos,20,17,3,40,0.075000
2025-08-28,NCR Voyix,16,17,7,40,0.175000
2025-08-28,NGL Energy Partners,38,0,2,40,0.050000
2025-08-28,NLV Financial,4,4,2,10,0.200000
2025-08-28,NOV,10,24,6,40,0.150000
2025-08-28,NRG Energy,33,5,2,40,0.050000
2025-08-28,NVR,23,13,4,40,0.100000
2025-08-28,Nasdaq,10,23,7,40,0.175000
2025-08-28,Nationwide,20,12,8,40,0.200000
2025-08-28,Navient,22,13,5,40,0.125000
2025-08-28,NetApp,17,14,9,40,0.225000
2025-08-28,Netflix,14,16,10,40,0.250000
2025-08-28,NeueHealth,20,16,4,40,0.100000
2025-08-28,New York Life Insurance,13,24,3,40,0.075000
2025-08-28,NewMarket Corporation,19,15,6,40,0.150000
2025-08-28,Newell Brands,19,19,2,40,0.050000
2025-08-28,Newmont,10,14,16,40,0.400000
2025-08-28,News Corp,15,16,9,40,0.225000
2025-08-28,Nexstar Media Group,19,18,3,40,0.075000
2025-08-28,NextEra Energy,38,2,0,40,0.000000
2025-08-28,NiSource,17,17,6,40,0.150000
2025-08-28,Nike,18,19,3,40,0.075000
2025-08-28,Nordson,17,18,5,40,0.125000
2025-08-28,Nordstrom,16,19,5,40,0.125000
2025-08-28,Norfolk Southern,14,18,8,40,0.200000
2025-08-28,Northern Trust,39,1,0,40,0.000000
2025-08-28,Northrop Grumman,15,19,6,40,0.150000
2025-08-28,Northwestern Mutual,32,6,2,40,0.050000
2025-08-28,Nucor,12,24,4,40,0.100000
2025-08-28,Nvidia,7,25,8,40,0.200000
2025-08-28,O'Reilly Automotive,14,20,6,40,0.150000
2025-08-28,O-I Glass,15,17,8,40,0.200000
2025-08-28,ODP Business Solutions,20,19,1,40,0.025000
2025-08-28,OGE Energy,34,6,0,40,0.000000
2025-08-28,ON Semiconductor,9,25,6,40,0.150000
2025-08-28,Occidental Petroleum,22,12,6,40,0.150000
2025-08-28,Old Dominion Freight Line,20,16,4,40,0.100000
2025-08-28,Old National Bancorp,14,21,5,40,0.125000
2025-08-28,Old Republic International,18,17,5,40,0.125000
2025-08-28,Olin,16,18,6,40,0.150000
2025-08-28,Omnicom Group,17,16,7,40,0.175000
2025-08-28,OneMain,25,9,6,40,0.150000
2025-08-28,Oneok,22,12,6,40,0.150000
2025-08-28,Opendoor Technologies,13,20,7,40,0.175000
2025-08-28,Option Care Health,40,0,0,40,0.000000
2025-08-28,Oracle,16,21,3,40,0.075000
2025-08-28,Organon,9,25,6,40,0.150000
2025-08-28,Oscar Health,10,20,10,40,0.250000
2025-08-28,Oshkosh,11,18,11,40,0.275000
2025-08-28,Otis Worldwide,20,12,8,40,0.200000
2025-08-28,Ovintiv,30,8,2,40,0.050000
2025-08-28,Owens & Minor,11,17,12,40,0.300000
2025-08-28,Owens Corning,27,9,4,40,0.100000
2025-08-28,PACS Group,20,14,6,40,0.150000
2025-08-28,PBF Energy,33,7,0,40,0.000000
2025-08-28,PC Connection,16,22,2,40,0.050000
2025-08-28,PENN Entertainment,35,4,1,40,0.025000
2025-08-28,PG&E,16,12,12,40,0.300000
2025-08-28,PNC Financial Services,20,18,2,40,0.050000
2025-08-28,PPG Industries,22,10,8,40,0.200000
2025-08-28,PPL,17,16,7,40,0.175000
2025-08-28,PVH,17,19,4,40,0.100000
2025-08-28,Paccar,25,11,4,40,0.100000
2025-08-28,Pacific Life,16,23,1,40,0.025000
2025-08-28,Packaging Corp of America,11,24,5,40,0.125000
2025-08-28,Palo Alto Networks,12,25,3,40,0.075000
2025-08-28,Par Pacific,24,13,3,40,0.075000
2025-08-28,Paramount Global,12,18,10,40,0.250000
2025-08-28,Park Hotels & Resorts,8,28,4,40,0.100000
2025-08-28,Parker-Hannifin,21,17,2,40,0.050000
2025-08-28,Parsons,10,22,8,40,0.200000
2025-08-28,Patrick Industries,20,19,1,40,0.025000
2025-08-28,Patterson Companies Inc,9,26,5,40,0.125000
2025-08-28,Patterson-UTI Energy,37,1,2,40,0.050000
2025-08-28,PayPal,12,11,17,40,0.425000
2025-08-28,Paychex,21,15,4,40,0.100000
2025-08-28,Peabody Energy,32,6,2,40,0.050000
2025-08-28,Peloton,17,13,10,40,0.250000
2025-08-28,Penn Mutual Life Insurance,19,18,3,40,0.075000
2025-08-28,PennyMac Financial Services,24,13,3,40,0.075000
2025-08-28,Penske Automotive,16,20,4,40,0.100000
2025-08-28,PepsiCo,19,14,7,40,0.175000
2025-08-28,Performance Food,22,14,4,40,0.100000
2025-08-28,Permian Resources,19,19,2,40,0.050000
2025-08-28,Petco Health and Wellness,19,3,0,22,0.000000
2025-08-28,Peter Kiewit Sons',5,20,15,40,0.375000
2025-08-28,Pfizer,19,14,7,40,0.175000
2025-08-28,Philip Morris,22,12,6,40,0.150000
2025-08-28,Phillips 66,18,14,8,40,0.200000
2025-08-28,Pinnacle West Capital,18,11,11,40,0.275000
2025-08-28,Pinterest,14,23,3,40,0.075000
2025-08-28,Pioneer Natural Resources,18,11,11,40,0.275000
2025-08-28,Pitney Bowes,25,10,5,40,0.125000
2025-08-28,Plains GP,21,9,10,40,0.250000
2025-08-28,Playtika Holding,18,17,5,40,0.125000
2025-08-28,Plexus,8,21,11,40,0.275000
2025-08-28,Polaris Inc,21,12,7,40,0.175000
2025-08-28,Pool Corporation,19,16,5,40,0.125000
2025-08-28,Popular inc,38,0,2,40,0.050000
2025-08-28,Portland General Electric,11,23,6,40,0.150000
2025-08-28,Post Holdings,20,15,5,40,0.125000
2025-08-28,PriceSmart,17,15,8,40,0.200000
2025-08-28,Primerica,16,19,5,40,0.125000
2025-08-28,Primoris Services,23,13,4,40,0.100000
2025-08-28,Principal Financial,14,19,7,40,0.175000
2025-08-28,ProFrac Holding,12,27,1,40,0.025000
2025-08-28,Procter & Gamble,21,11,8,40,0.200000
2025-08-28,Progressive Insurance,16,21,3,40,0.075000
2025-08-28,Prologis,23,13,4,40,0.100000
2025-08-28,Prudential Financial,28,8,4,40,0.100000
2025-08-28,Public Service Enterprise Group,24,13,3,40,0.075000
2025-08-28,Public Storage,22,16,2,40,0.050000
2025-08-28,Publix Super Markets,18,18,4,40,0.100000
2025-08-28,Puget Sound Energy,29,9,2,40,0.050000
2025-08-28,PulteGroup,26,10,4,40,0.100000
2025-08-28,Pure Storage,14,22,4,40,0.100000
2025-08-28,QVC,15,21,4,40,0.100000
2025-08-28,Qorvo,16,18,6,40,0.150000
2025-08-28,Quad/Graphics,22,15,3,40,0.075000
2025-08-28,Qualcomm,19,18,3,40,0.075000
2025-08-28,Quanta Services,22,13,5,40,0.125000
2025-08-28,Quest Diagnostics,20,16,4,40,0.100000
2025-08-28,QuidelOrtho,18,15,7,40,0.175000
2025-08-28,REV Group,22,15,3,40,0.075000
2025-08-28,RPM International,21,15,4,40,0.100000
2025-08-28,RTX,18,18,4,40,0.100000
2025-08-28,RXO inc,14,12,14,40,0.350000
2025-08-28,Rackspace Technology,20,12,8,40,0.200000
2025-08-28,Radius Recycling,19,8,13,40,0.325000
2025-08-28,Ralph Lauren,31,9,0,40,0.000000
2025-08-28,Range Resources,19,16,5,40,0.125000
2025-08-28,Raymond James Financial,20,17,3,40,0.075000
2025-08-28,Realty Income,23,12,5,40,0.125000
2025-08-28,Regal Rexnord,18,20,2,40,0.050000
2025-08-28,Regeneron Pharmaceuticals,25,13,2,40,0.050000
2025-08-28,Regions Financial,16,17,7,40,0.175000
2025-08-28,Reinsurance Group of America,20,14,6,40,0.150000
2025-08-28,Reliance Inc,22,15,3,40,0.075000
2025-08-28,Republic Services,18,14,8,40,0.200000
2025-08-28,ResMed,21,13,6,40,0.150000
2025-08-28,Resideo Technologies,19,15,6,40,0.150000
2025-08-28,Restoration Hardware,14,22,4,40,0.100000
2025-08-28,Revvity,19,11,10,40,0.250000
2025-08-28,Rite Aid,6,30,4,40,0.100000
2025-08-28,Rithm Capital,16,18,6,40,0.150000
2025-08-28,Rivian Automotive,17,18,5,40,0.125000
2025-08-28,Robert Half,17,18,5,40,0.125000
2025-08-28,Roblox,9,11,20,40,0.500000
2025-08-28,Rocket Companies,24,11,5,40,0.125000
2025-08-28,Rockwell Automation,23,15,2,40,0.050000
2025-08-28,Roku,17,17,6,40,0.150000
2025-08-28,Rollins inc,20,20,0,40,0.000000
2025-08-28,Roper Technologies,19,17,4,40,0.100000
2025-08-28,Ross Stores,16,18,6,40,0.150000
2025-08-28,Rush Enterprises,23,12,5,40,0.125000
2025-08-28,Ryder System,18,13,9,40,0.225000
2025-08-28,Ryerson Holding,21,17,2,40,0.050000
2025-08-28,S&P Global,13,19,8,40,0.200000
2025-08-28,SBA Communications,16,19,5,40,0.125000
2025-08-28,SS&C Technologies,24,14,2,40,0.050000
2025-08-28,Sabre Corporation,22,14,4,40,0.100000
2025-08-28,Saia inc,16,16,8,40,0.200000
2025-08-28,Salesforce,8,15,17,40,0.425000
2025-08-28,Sallie Mae,14,22,4,40,0.100000
2025-08-28,Sally Beauty,40,0,0,40,0.000000
2025-08-28,Sanmina,26,11,3,40,0.075000
2025-08-28,ScanSource,20,15,5,40,0.125000
2025-08-28,Schneider National,21,13,6,40,0.150000
2025-08-28,Science Applications International,17,15,8,40,0.200000
2025-08-28,Scotts Miracle-Gro,27,10,3,40,0.075000
2025-08-28,Seaboard,18,15,7,40,0.175000
2025-08-28,Sealed Air Corporation,18,17,5,40,0.125000
2025-08-28,Securian Financial,11,25,4,40,0.100000
2025-08-28,Select Medical,21,14,5,40,0.125000
2025-08-28,Selective Insurance Group,19,15,6,40,0.150000
2025-08-28,Sempra,22,17,1,40,0.025000
2025-08-28,Sentry Insurance Group,3,7,0,10,0.000000
2025-08-28,Service Corp International,8,10,9,27,0.333333
2025-08-28,ServiceNow,23,16,1,40,0.025000
2025-08-28,Sherwin-Williams,21,13,6,40,0.150000
2025-08-28,Shift4 Payments,19,17,4,40,0.100000
2025-08-28,Silgan,22,13,5,40,0.125000
2025-08-28,Simon Property Group,16,20,4,40,0.100000
2025-08-28,Sinclair,12,20,8,40,0.200000
2025-08-28,SiteOne Landscape Supply,18,19,3,40,0.075000
2025-08-28,Skechers USA,25,9,6,40,0.150000
2025-08-28,SkyWest,16,16,8,40,0.200000
2025-08-28,Skyline Champion,34,4,2,40,0.050000
2025-08-28,Skyworks Solutions,31,2,7,40,0.175000
2025-08-28,Smurfit Westrock,18,20,2,40,0.050000
2025-08-28,Snap Inc,16,9,15,40,0.375000
2025-08-28,Snap-on,14,25,1,40,0.025000
2025-08-28,Snowflake inc,25,12,3,40,0.075000
2025-08-28,Sonic Automotive,24,15,1,40,0.025000
2025-08-28,Sonoco Products,19,18,3,40,0.075000
2025-08-28,Southern Company,28,10,2,40,0.050000
2025-08-28,Southwest Airlines,13,22,5,40,0.125000
2025-08-28,Southwest Gas,20,15,5,40,0.125000
2025-08-28,Southwestern Energy,34,3,3,40,0.075000
2025-08-28,SpartanNash,16,22,2,40,0.050000
2025-08-28,Spectrum Brands,19,16,5,40,0.125000
2025-08-28,Spire inc,20,11,9,40,0.225000
2025-08-28,Spirit AeroSystems,33,0,7,40,0.175000
2025-08-28,Spirit Airlines,23,3,14,40,0.350000
2025-08-28,Splunk,13,17,10,40,0.250000
2025-08-28,Sprouts Farmers Market,14,24,2,40,0.050000
2025-08-28,Stagwell,16,22,2,40,0.050000
2025-08-28,Stanley Black & Decker,15,18,7,40,0.175000
2025-08-28,Starbucks,10,22,8,40,0.200000
2025-08-28,State Farm Insurance,14,17,9,40,0.225000
2025-08-28,State Street,7,20,13,40,0.325000
2025-08-28,Steel Dynamics,34,4,2,40,0.050000
2025-08-28,Steelcase,22,16,2,40,0.050000
2025-08-28,Stericycle,12,7,21,40,0.525000
2025-08-28,Stifel Financial,17,15,8,40,0.200000
2025-08-28,StoneX,21,17,2,40,0.050000
2025-08-28,Stryker,13,19,8,40,0.200000
2025-08-28,Summit Materials,8,28,4,40,0.100000
2025-08-28,Sun Communities,28,7,5,40,0.125000
2025-08-28,Super Micro Computer,35,4,1,40,0.025000
2025-08-28,Surgery Partners,17,19,4,40,0.100000
2025-08-28,Sylvamo,15,14,11,40,0.275000
2025-08-28,Synchrony Financial,20,13,7,40,0.175000
2025-08-28,Synopsys,18,17,5,40,0.125000
2025-08-28,Synovus Financial,18,18,4,40,0.100000
2025-08-28,Sysco,17,12,11,40,0.275000
2025-08-28,T Rowe Price,24,12,4,40,0.100000
2025-08-28,TD Synnex,25,10,5,40,0.125000
2025-08-28,TEGNA,10,27,3,40,0.075000
2025-08-28,TIAA,12,24,4,40,0.100000
2025-08-28,TJX,20,16,4,40,0.100000
2025-08-28,Take-Two Interactive Software,20,13,7,40,0.175000
2025-08-28,Talen Energy,38,1,1,40,0.025000
2025-08-28,Tapestry,13,21,6,40,0.150000
2025-08-28,Targa Resources,21,10,9,40,0.225000
2025-08-28,Target,7,22,11,40,0.275000
2025-08-28,Taylor Morrison Home,14,19,7,40,0.175000
2025-08-28,Teladoc Health,18,15,7,40,0.175000
2025-08-28,Teledyne Technologies,17,16,7,40,0.175000
2025-08-28,Teleflex,14,19,7,40,0.175000
2025-08-28,TelevisaUnivision,18,18,4,40,0.100000
2025-08-28,Tempur Sealy International,12,23,5,40,0.125000
2025-08-28,Tenet Healthcare,21,15,4,40,0.100000
2025-08-28,Teradyne,19,14,7,40,0.175000
2025-08-28,Terex,13,23,4,40,0.100000
2025-08-28,Tesla,7,17,16,40,0.400000
2025-08-28,Tetra Tech,20,17,3,40,0.075000
2025-08-28,Texas Instruments,13,22,5,40,0.125000
2025-08-28,Texas Roadhouse,19,16,5,40,0.125000
2025-08-28,Textron,19,19,2,40,0.050000
2025-08-28,The Andersons Inc,18,14,8,40,0.200000
2025-08-28,The Coca-Cola Company,17,17,6,40,0.150000
2025-08-28,Thermo Fisher Scientific,18,21,1,40,0.025000
2025-08-28,Thor Industries,16,18,6,40,0.150000
2025-08-28,Thrivent Financial for Lutherans,15,22,3,40,0.075000
2025-08-28,Timken,15,21,4,40,0.100000
2025-08-28,Titan Machinery,19,13,8,40,0.200000
2025-08-28,Toast inc,19,16,5,40,0.125000
2025-08-28,Toll Brothers,12,27,1,40,0.025000
2025-08-28,TopBuild,16,19,5,40,0.125000
2025-08-28,Topgolf Callaway Brands,22,11,7,40,0.175000
2025-08-28,Toro Company,13,21,6,40,0.150000
2025-08-28,Tractor Supply,22,18,0,40,0.000000
2025-08-28,TransDigm,16,19,5,40,0.125000
2025-08-28,TransUnion,15,14,11,40,0.275000
2025-08-28,Travelers Insurance,11,21,8,40,0.200000
2025-08-28,TreeHouse Foods,14,19,7,40,0.175000
2025-08-28,Tri Pointe Homes,16,20,4,40,0.100000
2025-08-28,TriNet Group,20,12,8,40,0.200000
2025-08-28,Trimble,10,27,3,40,0.075000
2025-08-28,Trinity Industries,19,16,5,40,0.125000
2025-08-28,TruStage,25,13,2,40,0.050000
2025-08-28,Truist Financial,12,23,5,40,0.125000
2025-08-28,Tutor Perini Corporation,19,15,6,40,0.150000
2025-08-28,Twilio,22,13,5,40,0.125000
2025-08-28,Tyson Foods,11,23,6,40,0.150000
2025-08-28,U-Haul,9,18,13,40,0.325000
2025-08-28,UFP Industries,23,14,3,40,0.075000
2025-08-28,UGI Utilities Inc,18,17,5,40,0.125000
2025-08-28,UL Solutions,35,0,5,40,0.125000
2025-08-28,UPS,18,14,8,40,0.200000
2025-08-28,US Bancorp,24,14,2,40,0.050000
2025-08-28,US Foods,22,15,3,40,0.075000
2025-08-28,USAA,18,13,9,40,0.225000
2025-08-28,Uber,12,14,14,40,0.350000
2025-08-28,Ulta Beauty,34,6,0,40,0.000000
2025-08-28,Under Armour,13,19,8,40,0.200000
2025-08-28,Union Pacific,12,19,9,40,0.225000
2025-08-28,United Airlines,27,5,8,40,0.200000
2025-08-28,United Natural Foods,40,0,0,40,0.000000
2025-08-28,United Rentals,34,4,2,40,0.050000
2025-08-28,United States Steel,25,7,8,40,0.200000
2025-08-28,UnitedHealth,13,23,4,40,0.100000
2025-08-28,Universal Corporation,21,12,7,40,0.175000
2025-08-28,Universal Health Services,15,19,6,40,0.150000
2025-08-28,Unum Group,17,22,1,40,0.025000
2025-08-28,Upbound Group,18,14,8,40,0.200000
2025-08-28,Urban Outfitters,12,18,10,40,0.250000
2025-08-28,V2X,24,14,2,40,0.050000
2025-08-28,VF Corporation,20,18,2,40,0.050000
2025-08-28,VICI Properties,26,9,5,40,0.125000
2025-08-28,Vail Resorts,11,18,11,40,0.275000
2025-08-28,Valero Energy,37,2,1,40,0.025000
2025-08-28,Valley National Bancorp,15,21,4,40,0.100000
2025-08-28,Valmont Industries,21,15,4,40,0.100000
2025-08-28,Valvoline inc,23,15,2,40,0.050000
2025-08-28,Ventas inc,21,18,1,40,0.025000
2025-08-28,Verisk,12,13,15,40,0.375000
2025-08-28,Verizon,19,13,8,40,0.200000
2025-08-28,Vertex Pharmaceuticals,20,10,10,40,0.250000
2025-08-28,Vertiv,19,18,3,40,0.075000
2025-08-28,Viasat,15,17,8,40,0.200000
2025-08-28,Viatris,21,17,2,40,0.050000
2025-08-28,Victorias Secret,16,16,8,40,0.200000
2025-08-28,Visa,10,19,11,40,0.275000
2025-08-28,Vishay Intertechnology,17,15,8,40,0.200000
2025-08-28,Vista Outdoor,13,23,4,40,0.100000
2025-08-28,Visteon,20,15,5,40,0.125000
2025-08-28,Vistra,17,12,11,40,0.275000
2025-08-28,Vontier,20,17,3,40,0.075000
2025-08-28,Voya Financial,21,14,5,40,0.125000
2025-08-28,Vulcan Materials,13,21,6,40,0.150000
2025-08-28,WEC Energy,33,4,3,40,0.075000
2025-08-28,WESCO International,26,9,5,40,0.125000
2025-08-28,WEX,18,16,6,40,0.150000
2025-08-28,WR Berkley,17,17,6,40,0.150000
2025-08-28,WW Grainger,16,16,8,40,0.200000
2025-08-28,Wabash National,16,19,5,40,0.125000
2025-08-28,Walgreens,6,28,6,40,0.150000
2025-08-28,Walmart,10,16,14,40,0.350000
2025-08-28,Walt Disney,25,10,5,40,0.125000
2025-08-28,Warner Bros Discovery,16,21,3,40,0.075000
2025-08-28,Warner Music Group,16,23,1,40,0.025000
2025-08-28,Waters Corporation,21,11,8,40,0.200000
2025-08-28,Watsco,22,14,4,40,0.100000
2025-08-28,Wayfair,15,20,5,40,0.125000
2025-08-28,Webster Financial,18,16,6,40,0.150000
2025-08-28,Weis Markets,18,17,5,40,0.125000
2025-08-28,Wells Fargo,25,6,9,40,0.225000
2025-08-28,Welltower,31,7,2,40,0.050000
2025-08-28,Werner Enterprises,22,12,6,40,0.150000
2025-08-28,West Pharmaceutical Services,20,16,4,40,0.100000
2025-08-28,Western & Southern Financial,15,22,3,40,0.075000
2025-08-28,Western Alliance Bancorp,15,14,11,40,0.275000
2025-08-28,Western Digital,22,16,2,40,0.050000
2025-08-28,Western Midstream Partners,13,9,18,40,0.450000
2025-08-28,Western Union,14,20,6,40,0.150000
2025-08-28,Westinghouse Air Brake Technologies,13,22,5,40,0.125000
2025-08-28,Westlake Corporation,19,15,6,40,0.150000
2025-08-28,Weyerhaeuser,16,19,5,40,0.125000
2025-08-28,Whirlpool,18,17,5,40,0.125000
2025-08-28,Williams,11,16,13,40,0.325000
2025-08-28,Williams-Sonoma,12,22,6,40,0.150000
2025-08-28,Winnebago Industries,21,12,7,40,0.175000
2025-08-28,Wintrust Financial,22,10,8,40,0.200000
2025-08-28,Woodward inc,12,24,4,40,0.100000
2025-08-28,Workday,19,15,6,40,0.150000
2025-08-28,World Kinect,19,15,6,40,0.150000
2025-08-28,Worthington Enterprises,23,12,5,40,0.125000
2025-08-28,Wynn Resorts,22,7,11,40,0.275000
2025-08-28,XPO,14,19,7,40,0.175000
2025-08-28,Xcel Energy,32,5,3,40,0.075000
2025-08-28,Xerox,14,18,8,40,0.200000
2025-08-28,Xylem,23,12,5,40,0.125000
2025-08-28,Yum Brands,19,15,6,40,0.150000
2025-08-28,Yum China,19,19,2,40,0.050000
2025-08-28,Zebra Technologies,17,15,8,40,0.200000
2025-08-28,Zimmer Biomet,16,21,3,40,0.075000
2025-08-28,Zions Bancorp,18,16,6,40,0.150000
2025-08-28,Zoetis,23,15,2,40,0.050000
2025-08-28,Zoom Video Communications,13,21,6,40,0.150000
2025-08-28,eXp World,16,18,6,40,0.150000
2025-08-28,iHeartMedia,15,21,4,40,0.100000
2025-08-30,3M,17,18,5,40,0.125000
2025-08-30,A O Smith,15,21,4,40,0.100000
2025-08-30,A-Mark Precious Metals,39,1,0,40,0.000000
2025-08-30,ABM Industries,17,19,4,40,0.100000
2025-08-30,ADT,20,14,6,40,0.150000
2025-08-30,AECOM,18,19,3,40,0.075000
2025-08-30,AES,21,12,7,40,0.175000
2025-08-30,AGCO,19,14,7,40,0.175000
2025-08-30,AGNC Investment,16,17,7,40,0.175000
2025-08-30,AMC Entertainment,36,3,1,40,0.025000
2025-08-30,AMC Networks,15,18,7,40,0.175000
2025-08-30,AMN Healthcare Services,17,17,6,40,0.150000
2025-08-30,APA,17,14,9,40,0.225000
2025-08-30,APi Group,22,14,4,40,0.100000
2025-08-30,ARKO,24,12,4,40,0.100000
2025-08-30,ASGN,21,13,6,40,0.150000
2025-08-30,AT&T,9,22,9,40,0.225000
2025-08-30,ATI inc,21,11,8,40,0.200000
2025-08-30,AbbVie,10,20,10,40,0.250000
2025-08-30,Abbott Laboratories,14,16,10,40,0.250000
2025-08-30,Abercrombie & Fitch,13,24,3,40,0.075000
2025-08-30,Academy Sports and Outdoors,17,19,4,40,0.100000
2025-08-30,Acadia Healthcare,21,15,4,40,0.100000
2025-08-30,Acuity Inc,23,12,5,40,0.125000
2025-08-30,Adams Resources & Energy,21,7,1,29,0.034483
2025-08-30,AdaptHealth,13,21,6,40,0.150000
2025-08-30,Adobe,16,20,4,40,0.100000
2025-08-30,Advance Auto Parts,14,19,7,40,0.175000
2025-08-30,Advanced Drainage Systems,39,1,0,40,0.000000
2025-08-30,Advanced Micro Devices,37,3,0,40,0.000000
2025-08-30,Advantage Solutions,40,0,0,40,0.000000
2025-08-30,Aflac,14,19,7,40,0.175000
2025-08-30,Agilent Technologies,26,10,4,40,0.100000
2025-08-30,Agilon Health,17,14,9,40,0.225000
2025-08-30,Air Lease,16,19,5,40,0.125000
2025-08-30,Air Products & Chemicals,19,14,7,40,0.175000
2025-08-30,Airbnb,21,14,5,40,0.125000
2025-08-30,Akamai Technologies,18,20,2,40,0.050000
2025-08-30,Alaska Air,17,18,5,40,0.125000
2025-08-30,Albemarle Corporation,19,19,2,40,0.050000
2025-08-30,Albertsons,21,16,3,40,0.075000
2025-08-30,Alcoa Corporation,19,15,6,40,0.150000
2025-08-30,Alexandria Real Estate Equities,14,19,7,40,0.175000
2025-08-30,Alight Solutions,15,20,5,40,0.125000
2025-08-30,Align Technology,10,20,10,40,0.250000
2025-08-30,Allegiant Travel Company,12,21,7,40,0.175000
2025-08-30,Alliance Resource Partners,11,4,25,40,0.625000
2025-08-30,Alliant Energy,35,4,1,40,0.025000
2025-08-30,Allison Transmission,23,14,3,40,0.075000
2025-08-30,Allstate,27,12,1,40,0.025000
2025-08-30,Ally Financial,21,18,1,40,0.025000
2025-08-30,Alpha Metallurgical Resources,14,18,8,40,0.200000
2025-08-30,Alphabet,14,19,7,40,0.175000
2025-08-30,Altice,14,19,7,40,0.175000
2025-08-30,Altria,19,17,4,40,0.100000
2025-08-30,Amazon,33,2,5,40,0.125000
2025-08-30,Ameren,22,13,5,40,0.125000
2025-08-30,American Airlines,8,14,18,40,0.450000
2025-08-30,American Axle & Manufacturing,15,22,3,40,0.075000
2025-08-30,American Eagle Outfitters,14,22,4,40,0.100000
2025-08-30,American Electric Power,25,10,5,40,0.125000
2025-08-30,American Express,22,9,9,40,0.225000
2025-08-30,American Family Insurance,24,14,2,40,0.050000
2025-08-30,American Financial,23,12,5,40,0.125000
2025-08-30,American International Group,26,12,2,40,0.050000
2025-08-30,American Tower,21,15,4,40,0.100000
2025-08-30,American Water Works,25,12,3,40,0.075000
2025-08-30,Americold Realty Trust,37,3,0,40,0.000000
2025-08-30,Ameriprise Financial,18,19,3,40,0.075000
2025-08-30,Ametek,25,12,3,40,0.075000
2025-08-30,Amgen,20,12,8,40,0.200000
2025-08-30,Amica Mutual Insurance,14,24,2,40,0.050000
2025-08-30,Amkor Technology,20,17,3,40,0.075000
2025-08-30,Amphenol,18,21,1,40,0.025000
2025-08-30,Analog Devices,14,19,7,40,0.175000
2025-08-30,Antero Resources,18,18,4,40,0.100000
2025-08-30,Anywhere Real Estate Inc,18,15,7,40,0.175000
2025-08-30,Apollo Global Management,14,23,3,40,0.075000
2025-08-30,AppLovin,16,20,4,40,0.100000
2025-08-30,Apple,13,21,6,40,0.150000
2025-08-30,Applied Industrial Technologies,16,21,3,40,0.075000
2025-08-30,Applied Materials,8,15,17,40,0.425000
2025-08-30,AptarGroup,13,17,10,40,0.250000
2025-08-30,Aramark,18,15,7,40,0.175000
2025-08-30,ArcBest,11,26,3,40,0.075000
2025-08-30,Arch Resources,29,6,5,40,0.125000
2025-08-30,Archer Daniels Midland,17,19,4,40,0.100000
2025-08-30,Ares Management,29,9,2,40,0.050000
2025-08-30,Arista Networks,18,18,4,40,0.100000
2025-08-30,Arrow Electronics,22,15,3,40,0.075000
2025-08-30,Arthur J Gallagher,8,29,3,40,0.075000
2025-08-30,Asbury Automotive Group,19,16,5,40,0.125000
2025-08-30,Assurant,21,17,2,40,0.050000
2025-08-30,Atkore,13,21,6,40,0.150000
2025-08-30,Atlassian,18,13,9,40,0.225000
2025-08-30,Atmos Energy,35,5,0,40,0.000000
2025-08-30,Auto-Owners Insurance,12,23,5,40,0.125000
2025-08-30,AutoNation,19,18,3,40,0.075000
2025-08-30,AutoZone,18,18,4,40,0.100000
2025-08-30,Autodesk,21,16,3,40,0.075000
2025-08-30,Autoliv,19,16,5,40,0.125000
2025-08-30,Automatic Data Processing,19,12,9,40,0.225000
2025-08-30,AvalonBay Communities,23,14,3,40,0.075000
2025-08-30,Avantor,22,12,6,40,0.150000
2025-08-30,Avery Dennison,12,23,5,40,0.125000
2025-08-30,Avient,17,18,5,40,0.125000
2025-08-30,Avis Budget,15,19,6,40,0.150000
2025-08-30,Avnet,18,19,3,40,0.075000
2025-08-30,BJs Wholesale Club,10,23,7,40,0.175000
2025-08-30,BOK Financial,19,16,5,40,0.125000
2025-08-30,BWX Technologies,23,16,1,40,0.025000
2025-08-30,Baker Hughes,15,17,8,40,0.200000
2025-08-30,Ball,15,20,5,40,0.125000
2025-08-30,Bank of America,17,14,9,40,0.225000
2025-08-30,Bank of New York Mellon,26,13,1,40,0.025000
2025-08-30,Bath & Body Works,8,23,9,40,0.225000
2025-08-30,Baxter International,18,16,6,40,0.150000
2025-08-30,Beacon Roofing Supply,9,23,8,40,0.200000
2025-08-30,Becton Dickinson,12,21,7,40,0.175000
2025-08-30,Belden,15,18,7,40,0.175000
2025-08-30,Benchmark Electronics,20,15,5,40,0.125000
2025-08-30,Berkshire Hathaway,18,18,4,40,0.100000
2025-08-30,Best Buy,40,0,0,40,0.000000
2025-08-30,Big Lots,8,30,2,40,0.050000
2025-08-30,Bio-Rad Laboratories,15,20,5,40,0.125000
2025-08-30,Biogen,28,10,2,40,0.050000
2025-08-30,BlackRock,23,15,2,40,0.050000
2025-08-30,Blackstone,21,15,4,40,0.100000
2025-08-30,Bloomin Brands,10,24,6,40,0.150000
2025-08-30,BlueLinx,32,5,3,40,0.075000
2025-08-30,Boeing,19,15,6,40,0.150000
2025-08-30,Boise Cascade,11,19,10,40,0.250000
2025-08-30,Booking Holdings,21,15,4,40,0.100000
2025-08-30,Booz Allen Hamilton,22,15,3,40,0.075000
2025-08-30,BorgWarner,21,13,6,40,0.150000
2025-08-30,Boston Properties,18,18,4,40,0.100000
2025-08-30,Boston Scientific,14,18,8,40,0.200000
2025-08-30,Boyd Gaming,19,20,1,40,0.025000
2025-08-30,Bread Financial,26,11,3,40,0.075000
2025-08-30,BrightSpring Health Services,25,6,9,40,0.225000
2025-08-30,BrightView Holdings,26,9,5,40,0.125000
2025-08-30,Brighthouse Financial,12,24,4,40,0.100000
2025-08-30,Brinker International,20,15,5,40,0.125000
2025-08-30,Brinks Company,7,3,4,14,0.285714
2025-08-30,Bristol-Myers Squibb,12,23,5,40,0.125000
2025-08-30,Broadcom,13,24,3,40,0.075000
2025-08-30,Broadridge Financial Solutions,34,3,3,40,0.075000
2025-08-30,Brookdale Senior Living,25,12,3,40,0.075000
2025-08-30,Brown & Brown,20,15,5,40,0.125000
2025-08-30,Brown-Forman,12,19,9,40,0.225000
2025-08-30,Bruker,8,24,8,40,0.200000
2025-08-30,Brunswick,9,19,12,40,0.300000
2025-08-30,Builders FirstSource,21,15,4,40,0.100000
2025-08-30,Burlington Stores,15,22,3,40,0.075000
2025-08-30,CACI International,17,14,9,40,0.225000
2025-08-30,CBRE Group,20,19,1,40,0.025000
2025-08-30,CDW,16,17,7,40,0.175000
2025-08-30,CF Industries,20,15,5,40,0.125000
2025-08-30,CH Robinson Worldwide,15,21,4,40,0.100000
2025-08-30,CHS,16,17,7,40,0.175000
2025-08-30,CME Group,15,19,6,40,0.150000
2025-08-30,CMS Energy,34,2,4,40,0.100000
2025-08-30,CNO Financial Group,14,18,8,40,0.200000
2025-08-30,CNX Resources,24,9,7,40,0.175000
2025-08-30,CSX,15,14,11,40,0.275000
2025-08-30,CVS Health,20,14,6,40,0.150000
2025-08-30,Cabot Corporation,21,15,4,40,0.100000
2025-08-30,Cadence,16,21,3,40,0.075000
2025-08-30,Caesars Entertainment,33,7,0,40,0.000000
2025-08-30,Cal-Maine Foods,17,15,8,40,0.200000
2025-08-30,Caleres inc,22,9,9,40,0.225000
2025-08-30,California Resources,22,11,7,40,0.175000
2025-08-30,Calumet,11,18,11,40,0.275000
2025-08-30,Campbell Soup,14,20,6,40,0.150000
2025-08-30,Camping World,14,18,8,40,0.200000
2025-08-30,Capital One,28,10,2,40,0.050000
2025-08-30,CarMax,12,21,7,40,0.175000
2025-08-30,Cardinal Health,15,16,9,40,0.225000
2025-08-30,Carlisle Companies,11,19,10,40,0.250000
2025-08-30,Carlyle Group,20,17,3,40,0.075000
2025-08-30,Carpenter Technology,10,23,7,40,0.175000
2025-08-30,Carrier Global,22,15,3,40,0.075000
2025-08-30,Carters inc,10,21,2,33,0.060606
2025-08-30,Carvana,18,15,7,40,0.175000
2025-08-30,Caseys General Stores,14,22,4,40,0.100000
2025-08-30,Catalent,9,27,4,40,0.100000
2025-08-30,Caterpillar,13,17,10,40,0.250000
2025-08-30,Cboe Global Markets,24,15,1,40,0.025000
2025-08-30,Celanese,16,12,12,40,0.300000
2025-08-30,Cencora,18,19,3,40,0.075000
2025-08-30,Centene,14,10,16,40,0.400000
2025-08-30,CenterPoint Energy,24,8,8,40,0.200000
2025-08-30,Central Garden & Pet,12,26,2,40,0.050000
2025-08-30,Century Communities,22,15,3,40,0.075000
2025-08-30,ChampionX,20,15,5,40,0.125000
2025-08-30,Charles River Laboratories International,20,14,6,40,0.150000
2025-08-30,Charles Schwab,23,15,2,40,0.050000
2025-08-30,Chart Industries,12,22,6,40,0.150000
2025-08-30,Charter Communications,11,19,10,40,0.250000
2025-08-30,Cheesecake Factory,16,14,10,40,0.250000
2025-08-30,Chefs Warehouse,26,8,6,40,0.150000
2025-08-30,Chemours,12,15,13,40,0.325000
2025-08-30,Cheniere Energy,35,4,1,40,0.025000
2025-08-30,Chevron,18,18,4,40,0.100000
2025-08-30,Chewy,22,14,4,40,0.100000
2025-08-30,Chipotle Mexican Grill,12,28,0,40,0.000000
2025-08-30,Chord Energy,31,6,3,40,0.075000
2025-08-30,Church & Dwight,16,14,10,40,0.250000
2025-08-30,Ciena,15,19,6,40,0.150000
2025-08-30,Cigna,15,17,8,40,0.200000
2025-08-30,Cincinnati Financial,21,16,3,40,0.075000
2025-08-30,Cinemark,13,23,4,40,0.100000
2025-08-30,Cintas,24,13,3,40,0.075000
2025-08-30,Cisco Systems,13,22,5,40,0.125000
2025-08-30,Citigroup,30,5,5,40,0.125000
2025-08-30,Citizens Financial Group,21,16,3,40,0.075000
2025-08-30,Civitas Resources,19,13,8,40,0.200000
2025-08-30,Clean Harbors,40,0,0,40,0.000000
2025-08-30,Clear Channel Outdoor Hldgs,7,1,2,10,0.200000
2025-08-30,Cleveland-Cliffs,17,16,7,40,0.175000
2025-08-30,Clorox,25,10,5,40,0.125000
2025-08-30,Cognizant Technology Solutions,32,2,6,40,0.150000
2025-08-30,Coherent,21,17,2,40,0.050000
2025-08-30,Coinbase Global,14,25,1,40,0.025000
2025-08-30,Colgate-Palmolive,16,14,10,40,0.250000
2025-08-30,Columbia Banking System,18,20,2,40,0.050000
2025-08-30,Columbia Sportswear,15,20,5,40,0.125000
2025-08-30,Comcast,28,11,1,40,0.025000
2025-08-30,Comerica,29,9,2,40,0.050000
2025-08-30,Comfort Systems USA,39,0,1,40,0.025000
2025-08-30,CommScope,19,18,3,40,0.075000
2025-08-30,Commercial Metals,23,11,6,40,0.150000
2025-08-30,Community Health Systems,20,15,5,40,0.125000
2025-08-30,Compass,17,21,2,40,0.050000
2025-08-30,Conagra Brands,18,17,5,40,0.125000
2025-08-30,Concentrix,22,11,7,40,0.175000
2025-08-30,Conduent,20,18,2,40,0.050000
2025-08-30,ConocoPhillips,18,15,7,40,0.175000
2025-08-30,Consol Energy,32,4,4,40,0.100000
2025-08-30,Consolidated Edison,26,7,7,40,0.175000
2025-08-30,Constellation Brands,10,20,10,40,0.250000
2025-08-30,Constellation Energy,38,1,1,40,0.025000
2025-08-30,Continental Resources,18,14,8,40,0.200000
2025-08-30,Cooper Cos,7,29,4,40,0.100000
2025-08-30,Cooper-Standard,21,12,7,40,0.175000
2025-08-30,Copart,16,21,3,40,0.075000
2025-08-30,Core & Main,17,18,5,40,0.125000
2025-08-30,Cornerstone Building Brands,17,19,4,40,0.100000
2025-08-30,Corning,16,20,4,40,0.100000
2025-08-30,Corpay,19,17,4,40,0.100000
2025-08-30,Corteva,16,20,4,40,0.100000
2025-08-30,Costco,15,20,5,40,0.125000
2025-08-30,Coterra Energy,34,3,3,40,0.075000
2025-08-30,Coty,22,12,6,40,0.150000
2025-08-30,Country Financial,14,21,5,40,0.125000
2025-08-30,Coupang,21,19,0,40,0.000000
2025-08-30,Cracker Barrel Old Country Store,12,19,9,40,0.225000
2025-08-30,Crocs,7,29,4,40,0.100000
2025-08-30,CrossAmerica Partners,14,5,21,40,0.525000
2025-08-30,CrowdStrike,15,17,8,40,0.200000
2025-08-30,Crown Castle,21,12,7,40,0.175000
2025-08-30,Crown Holdings,20,16,4,40,0.100000
2025-08-30,Cullen Frost Bankers,23,12,5,40,0.125000
2025-08-30,Cummins,16,18,6,40,0.150000
2025-08-30,Curtiss-Wright,16,21,3,40,0.075000
2025-08-30,DR Horton,11,23,6,40,0.150000
2025-08-30,DTE Energy,31,4,5,40,0.125000
2025-08-30,DXC Technology,22,13,5,40,0.125000
2025-08-30,DaVita,15,11,14,40,0.350000
2025-08-30,Dana Incorporated,24,11,5,40,0.125000
2025-08-30,Danaher,23,15,2,40,0.050000
2025-08-30,Darden Restaurants,21,12,7,40,0.175000
2025-08-30,Darling Ingredients,39,1,0,40,0.000000
2025-08-30,Deckers Outdoor,25,12,3,40,0.075000
2025-08-30,Deere,14,23,3,40,0.075000
2025-08-30,Delek US,20,17,3,40,0.075000
2025-08-30,Dell Technologies,14,21,5,40,0.125000
2025-08-30,Delta Air Lines,5,17,18,40,0.450000
2025-08-30,Dentsply Sirona,14,22,4,40,0.100000
2025-08-30,Designer Brands,12,24,4,40,0.100000
2025-08-30,Devon Energy,36,1,3,40,0.075000
2025-08-30,DexCom,14,21,5,40,0.125000
2025-08-30,Diamondback Energy,39,1,0,40,0.000000
2025-08-30,Dicks Sporting Goods,18,18,4,40,0.100000
2025-08-30,Diebold Nixdorf,22,14,4,40,0.100000
2025-08-30,Digital Realty Trust,38,2,0,40,0.000000
2025-08-30,Dillards,26,11,3,40,0.075000
2025-08-30,DocuSign,18,18,4,40,0.100000
2025-08-30,Dollar General,14,21,5,40,0.125000
2025-08-30,Dollar Tree,17,18,5,40,0.125000
2025-08-30,Dominion Energy,34,5,1,40,0.025000
2025-08-30,Dominos Pizza inc,17,17,6,40,0.150000
2025-08-30,Domtar,10,25,5,40,0.125000
2025-08-30,Donaldson Company,22,14,4,40,0.100000
2025-08-30,DoorDash,23,13,4,40,0.100000
2025-08-30,Dover Corporation,18,18,4,40,0.100000
2025-08-30,DraftKings,30,9,1,40,0.025000
2025-08-30,Dream Finders Homes,36,2,2,40,0.050000
2025-08-30,Dropbox,15,22,3,40,0.075000
2025-08-30,DuPont,15,21,4,40,0.100000
2025-08-30,Duke Energy,38,1,1,40,0.025000
2025-08-30,Dycom Industries,15,20,5,40,0.125000
2025-08-30,EMCOR Group,13,20,7,40,0.175000
2025-08-30,EOG Resources,17,15,8,40,0.200000
2025-08-30,EPAM Systems,18,14,8,40,0.200000
2025-08-30,EQT,12,21,7,40,0.175000
2025-08-30,ESAB,18,16,6,40,0.150000
2025-08-30,East West Bancorp,22,14,4,40,0.100000
2025-08-30,Eastman Chemical,16,13,11,40,0.275000
2025-08-30,Ebay,16,15,9,40,0.225000
2025-08-30,EchoStar,13,21,6,40,0.150000
2025-08-30,Ecolab,19,16,5,40,0.125000
2025-08-30,Edison International,10,24,6,40,0.150000
2025-08-30,Edward Jones,15,20,5,40,0.125000
2025-08-30,Edwards Lifesciences,15,15,10,40,0.250000
2025-08-30,Elanco Animal Health,15,22,3,40,0.075000
2025-08-30,Electronic Arts,9,23,8,40,0.200000
2025-08-30,Elevance Health,19,10,11,40,0.275000
2025-08-30,Eli Lilly,16,16,8,40,0.200000
2025-08-30,Emerson Electric,20,17,3,40,0.075000
2025-08-30,EnLink Midstream,15,20,5,40,0.125000
2025-08-30,Encompass Health,17,21,2,40,0.050000
2025-08-30,Endeavor Group,13,22,5,40,0.125000
2025-08-30,EnerSys,17,15,8,40,0.200000
2025-08-30,Energizer,37,2,1,40,0.025000
2025-08-30,Energy Transfer,36,1,3,40,0.075000
2025-08-30,Ensign Group,20,14,6,40,0.150000
2025-08-30,Entegris,20,13,7,40,0.175000
2025-08-30,Entergy,25,14,1,40,0.025000
2025-08-30,Enterprise Products Partners,20,8,12,40,0.300000
2025-08-30,Envista,26,10,4,40,0.100000
2025-08-30,Equifax,17,19,4,40,0.100000
2025-08-30,Equinix,22,17,1,40,0.025000
2025-08-30,Equitable,19,18,3,40,0.075000
2025-08-30,Equity Residential,22,15,3,40,0.075000
2025-08-30,Erie Insurance,12,17,11,40,0.275000
2025-08-30,Estée Lauder,7,24,9,40,0.225000
2025-08-30,Etsy,21,14,5,40,0.125000
2025-08-30,Euronet Worldwide,17,16,7,40,0.175000
2025-08-30,Evergy,20,12,8,40,0.200000
2025-08-30,Eversource Energy,33,7,0,40,0.000000
2025-08-30,Exact Sciences,14,15,11,40,0.275000
2025-08-30,Exelon,18,16,6,40,0.150000
2025-08-30,Expand Energy,39,1,0,40,0.000000
2025-08-30,Expedia,23,14,3,40,0.075000
2025-08-30,Expeditors International of Washington,20,16,4,40,0.100000
2025-08-30,Extra Space Storage,17,14,9,40,0.225000
2025-08-30,Exxon Mobil,18,16,6,40,0.150000
2025-08-30,F5,14,18,8,40,0.200000
2025-08-30,FM Global,11,16,13,40,0.325000
2025-08-30,FMC Corporation,20,14,6,40,0.150000
2025-08-30,FTI Consulting,16,16,8,40,0.200000
2025-08-30,Fannie Mae,11,26,3,40,0.075000
2025-08-30,Farmers Insurance Exchange,8,18,14,40,0.350000
2025-08-30,Fastenal,22,14,4,40,0.100000
2025-08-30,FedEx,16,15,9,40,0.225000
2025-08-30,Federated Mutual Insurance,17,17,6,40,0.150000
2025-08-30,Fidelity National Financial,22,16,2,40,0.050000
2025-08-30,Fidelity National Information Services,27,10,3,40,0.075000
2025-08-30,Fifth Third Bancorp,17,22,1,40,0.025000
2025-08-30,First American Financial,17,17,6,40,0.150000
2025-08-30,First Citizens BancShares,19,18,3,40,0.075000
2025-08-30,First Horizon,16,20,4,40,0.100000
2025-08-30,First National of Nebraska,16,23,1,40,0.025000
2025-08-30,First Solar,19,16,5,40,0.125000
2025-08-30,FirstCash,15,22,3,40,0.075000
2025-08-30,FirstEnergy,13,18,9,40,0.225000
2025-08-30,Fiserv,17,18,5,40,0.125000
2025-08-30,Five Below,18,17,5,40,0.125000
2025-08-30,Flagstar Financial,19,20,1,40,0.025000
2025-08-30,Floor & Decor,19,19,2,40,0.050000
2025-08-30,Flowers Foods,17,19,4,40,0.100000
2025-08-30,Flowserve,21,16,3,40,0.075000
2025-08-30,Fluor,16,16,8,40,0.200000
2025-08-30,Foot Locker,12,17,11,40,0.275000
2025-08-30,Ford Motor,20,15,5,40,0.125000
2025-08-30,Fortinet,17,17,6,40,0.150000
2025-08-30,Fortive,19,15,6,40,0.150000
2025-08-30,Fortune Brands Innovations,19,19,2,40,0.050000
2025-08-30,Franklin Resources,18,16,6,40,0.150000
2025-08-30,Freddie Mac,12,19,9,40,0.225000
2025-08-30,Freeport-McMoRan,21,17,2,40,0.050000
2025-08-30,Frontier Airlines,19,14,7,40,0.175000
2025-08-30,Frontier Communications,22,13,5,40,0.125000
2025-08-30,G-III Apparel Group,25,12,3,40,0.075000
2025-08-30,GE HealthCare Technologies,22,15,3,40,0.075000
2025-08-30,GMS,10,24,6,40,0.150000
2025-08-30,GXO Logistics,22,13,5,40,0.125000
2025-08-30,GameStop,17,18,5,40,0.125000
2025-08-30,Gannett,19,12,9,40,0.225000
2025-08-30,Garrett Motion inc,18,19,3,40,0.075000
2025-08-30,Gartner,12,22,6,40,0.150000
2025-08-30,Gen Digital,19,12,9,40,0.225000
2025-08-30,Generac,19,18,3,40,0.075000
2025-08-30,General Dynamics,34,5,1,40,0.025000
2025-08-30,General Electric,15,21,4,40,0.100000
2025-08-30,General Mills,24,15,1,40,0.025000
2025-08-30,General Motors,23,9,8,40,0.200000
2025-08-30,Genesis Energy,36,1,3,40,0.075000
2025-08-30,Genuine Parts,19,17,4,40,0.100000
2025-08-30,Genworth Financial,18,17,5,40,0.125000
2025-08-30,Gilead Sciences,21,16,3,40,0.075000
2025-08-30,Global Partners,11,19,10,40,0.250000
2025-08-30,Global Payments,14,22,4,40,0.100000
2025-08-30,Globe Life,25,15,0,40,0.000000
2025-08-30,GoDaddy,18,19,3,40,0.075000
2025-08-30,Goldman Sachs,17,13,10,40,0.250000
2025-08-30,Goodyear Tire & Rubber,14,21,5,40,0.125000
2025-08-30,Graham Holdings Company,22,12,6,40,0.150000
2025-08-30,Granite Construction,21,15,4,40,0.100000
2025-08-30,Graphic Packaging,17,17,6,40,0.150000
2025-08-30,Gray Television,11,21,8,40,0.200000
2025-08-30,Graybar Electric,15,20,5,40,0.125000
2025-08-30,Green Plains inc,21,12,7,40,0.175000
2025-08-30,Greenbrier,15,15,10,40,0.250000
2025-08-30,Greif,11,21,8,40,0.200000
2025-08-30,Griffon Corporation,21,15,4,40,0.100000
2025-08-30,Grocery Outlet Holding,17,20,3,40,0.075000
2025-08-30,Group 1 Automotive,14,21,5,40,0.125000
2025-08-30,Guardian Life insurance,18,22,0,40,0.000000
2025-08-30,Guess inc,17,21,2,40,0.050000
2025-08-30,H B Fuller,18,19,3,40,0.075000
2025-08-30,HCA Healthcare,23,12,5,40,0.125000
2025-08-30,HEICO,15,19,6,40,0.150000
2025-08-30,HF Sinclair,17,19,4,40,0.100000
2025-08-30,Halliburton,18,16,6,40,0.150000
2025-08-30,Hanesbrands,16,19,5,40,0.125000
2025-08-30,Hanover Insurance Group,23,13,4,40,0.100000
2025-08-30,Harley-Davidson,17,19,4,40,0.100000
2025-08-30,Hasbro,16,21,3,40,0.075000
2025-08-30,Hawaiian Airlines inc,20,20,0,40,0.000000
2025-08-30,Hawaiian Electric Industries,27,12,1,40,0.025000
2025-08-30,Helmerich & Payne,14,23,3,40,0.075000
2025-08-30,Henry Schein,22,16,2,40,0.050000
2025-08-30,Herc Rentals,19,15,6,40,0.150000
2025-08-30,Hershey,15,21,4,40,0.100000
2025-08-30,Hertz,19,12,9,40,0.225000
2025-08-30,Hewlett Packard,17,19,4,40,0.100000
2025-08-30,Hewlett Packard Enterprise,19,19,2,40,0.050000
2025-08-30,Hillenbrand,15,21,4,40,0.100000
2025-08-30,Hilton Grand Vacations,39,1,0,40,0.000000
2025-08-30,Hilton Worldwide,26,13,1,40,0.025000
2025-08-30,Hologic,15,14,11,40,0.275000
2025-08-30,Home Depot,9,14,17,40,0.425000
2025-08-30,Honeywell,18,19,3,40,0.075000
2025-08-30,Hormel Foods,8,23,9,40,0.225000
2025-08-30,Host Hotels & Resorts,11,26,3,40,0.075000
2025-08-30,Hovnanian Enterprises,28,9,3,40,0.075000
2025-08-30,Howmet Aerospace,15,15,10,40,0.250000
2025-08-30,Hub Group,23,11,6,40,0.150000
2025-08-30,Hubbell,18,16,6,40,0.150000
2025-08-30,Humana,20,16,4,40,0.100000
2025-08-30,Huntington Bancshares,18,19,3,40,0.075000
2025-08-30,Huntington Ingalls Industries,21,10,9,40,0.225000
2025-08-30,Huntsman,18,15,7,40,0.175000
2025-08-30,Hyatt Hotels,21,18,1,40,0.025000
2025-08-30,Hyster-Yale,16,18,6,40,0.150000
2025-08-30,IAC,14,19,7,40,0.175000
2025-08-30,IBM,11,25,4,40,0.100000
2025-08-30,IDEX,19,15,6,40,0.150000
2025-08-30,IDEXX Laboratories,20,11,9,40,0.225000
2025-08-30,IQVIA,21,11,8,40,0.200000
2025-08-30,ITT,23,13,4,40,0.100000
2025-08-30,Icahn Enterprises,15,16,9,40,0.225000
2025-08-30,Illinois Tool Works,11,23,6,40,0.150000
2025-08-30,Illumina inc,14,21,5,40,0.125000
2025-08-30,Incyte,16,18,6,40,0.150000
2025-08-30,Ingersoll Rand,19,17,4,40,0.100000
2025-08-30,Ingles Markets,17,16,7,40,0.175000
2025-08-30,Ingram Micro,16,16,8,40,0.200000
2025-08-30,Ingredion,28,10,2,40,0.050000
2025-08-30,Insight Enterprises,18,18,4,40,0.100000
2025-08-30,Insperity,22,8,10,40,0.250000
2025-08-30,Instacart,23,13,4,40,0.100000
2025-08-30,Installed Building Products,20,14,6,40,0.150000
2025-08-30,Intel,9,18,13,40,0.325000
2025-08-30,Interactive Brokers,16,17,7,40,0.175000
2025-08-30,Intercontinental Exchange,22,17,1,40,0.025000
2025-08-30,International Flavors & Fragrances,16,16,8,40,0.200000
2025-08-30,International Paper,6,30,4,40,0.100000
2025-08-30,Interpublic Group,24,11,5,40,0.125000
2025-08-30,Intuit,23,13,4,40,0.100000
2025-08-30,Intuitive Surgical,13,17,10,40,0.250000
2025-08-30,Iron Mountain,16,19,5,40,0.125000
2025-08-30,JB Hunt Transport Services,12,25,3,40,0.075000
2025-08-30,JELD-WEN Holding,22,12,6,40,0.150000
2025-08-30,JM Smucker,18,12,10,40,0.250000
2025-08-30,JPMorgan Chase,17,21,2,40,0.050000
2025-08-30,Jabil,16,16,8,40,0.200000
2025-08-30,Jackson Financial,16,20,4,40,0.100000
2025-08-30,Jacobs Solutions,37,0,3,40,0.075000
2025-08-30,Jefferies Financial,18,18,4,40,0.100000
2025-08-30,JetBlue Airways,23,14,3,40,0.075000
2025-08-30,Johnson & Johnson,14,17,9,40,0.225000
2025-08-30,Jones Lang LaSalle,15,19,6,40,0.150000
2025-08-30,Juniper Networks,13,24,3,40,0.075000
2025-08-30,KB Home,17,20,3,40,0.075000
2025-08-30,KBR,26,13,1,40,0.025000
2025-08-30,KKR,21,16,3,40,0.075000
2025-08-30,KLA,11,19,10,40,0.250000
2025-08-30,Kaiser Aluminum,24,12,4,40,0.100000
2025-08-30,Kellanova,24,11,5,40,0.125000
2025-08-30,Kelly Services inc,22,10,8,40,0.200000
2025-08-30,Kemper,18,11,11,40,0.275000
2025-08-30,Keurig Dr Pepper,10,26,4,40,0.100000
2025-08-30,KeyCorp,25,12,3,40,0.075000
2025-08-30,Keysight Technologies,26,12,2,40,0.050000
2025-08-30,Kimberly-Clark,12,17,11,40,0.275000
2025-08-30,Kinder Morgan,40,0,0,40,0.000000
2025-08-30,Kirby Corporation,25,12,3,40,0.075000
2025-08-30,Knife River Corporation,21,15,4,40,0.100000
2025-08-30,Knight Swift Transportation,29,6,5,40,0.125000
2025-08-30,Kohls,16,11,13,40,0.325000
2025-08-30,Kontoor Brands,24,13,3,40,0.075000
2025-08-30,Korn Ferry,18,11,11,40,0.275000
2025-08-30,Kraft Heinz,16,21,3,40,0.075000
2025-08-30,Kroger,8,25,7,40,0.175000
2025-08-30,Kyndryl,18,19,3,40,0.075000
2025-08-30,L3Harris Technologies,22,13,5,40,0.125000
2025-08-30,LCI Industries,9,22,9,40,0.225000
2025-08-30,LKQ,24,13,3,40,0.075000
2025-08-30,LPL Financial,21,16,3,40,0.075000
2025-08-30,Labcorp Holdings,16,21,3,40,0.075000
2025-08-30,Lam Research,20,16,4,40,0.100000
2025-08-30,Lamb Weston,16,21,3,40,0.075000
2025-08-30,Land O'Lakes,8,26,6,40,0.150000
2025-08-30,Landstar System,17,13,10,40,0.250000
2025-08-30,Las Vegas Sands,16,22,2,40,0.050000
2025-08-30,Lear Corporation,16,15,9,40,0.225000
2025-08-30,Leggett & Platt,18,20,2,40,0.050000
2025-08-30,Leidos,31,8,1,40,0.025000
2025-08-30,Lennar,16,22,2,40,0.050000
2025-08-30,Lennox International,15,17,8,40,0.200000
2025-08-30,Levi Strauss,11,29,0,40,0.000000
2025-08-30,Liberty Energy,40,0,0,40,0.000000
2025-08-30,Liberty Media,40,0,0,40,0.000000
2025-08-30,Liberty Mutual Insurance,34,1,5,40,0.125000
2025-08-30,Light & Wonder,10,27,3,40,0.075000
2025-08-30,Lincoln Electric,11,19,10,40,0.250000
2025-08-30,Lincoln National,19,13,8,40,0.200000
2025-08-30,Lithia Motors,13,19,8,40,0.200000
2025-08-30,Live Nation Entertainment,38,2,0,40,0.000000
2025-08-30,Lockheed Martin,26,9,5,40,0.125000
2025-08-30,Loews,18,17,5,40,0.125000
2025-08-30,Louisiana-Pacific Corporation,26,9,5,40,0.125000
2025-08-30,Lowes,15,22,3,40,0.075000
2025-08-30,Lululemon athletica,17,19,4,40,0.100000
2025-08-30,Lumen Technologies,16,21,3,40,0.075000
2025-08-30,Lyft,15,14,11,40,0.275000
2025-08-30,M&T Bank,17,17,6,40,0.150000
2025-08-30,M/I Homes,17,19,4,40,0.100000
2025-08-30,MDU Resources Group,24,11,5,40,0.125000
2025-08-30,MGM Resorts International,20,13,7,40,0.175000
2025-08-30,MKS Instruments,16,17,7,40,0.175000
2025-08-30,MRC Global,15,18,7,40,0.175000
2025-08-30,MSC Industrial Direct,21,15,4,40,0.100000
2025-08-30,MSCI,31,7,2,40,0.050000
2025-08-30,MYR Group,14,22,4,40,0.100000
2025-08-30,Macys,16,21,3,40,0.075000
2025-08-30,ManpowerGroup,25,9,6,40,0.150000
2025-08-30,Marathon Oil,15,21,4,40,0.100000
2025-08-30,Marathon Petroleum,17,19,4,40,0.100000
2025-08-30,Markel Group,29,9,2,40,0.050000
2025-08-30,Marriott International,23,12,5,40,0.125000
2025-08-30,Marriott Vacations Worldwide,19,16,5,40,0.125000
2025-08-30,Marsh & McLennan,20,20,0,40,0.000000
2025-08-30,Martin Marietta Materials,17,19,4,40,0.100000
2025-08-30,Marvell Technology,10,18,12,40,0.300000
2025-08-30,MasTec,20,18,2,40,0.050000
2025-08-30,Masco,17,14,9,40,0.225000
2025-08-30,Mass Mutual,12,25,3,40,0.075000
2025-08-30,MasterBrand,22,14,4,40,0.100000
2025-08-30,Mastercard,13,22,5,40,0.125000
2025-08-30,Matador Resources,22,13,5,40,0.125000
2025-08-30,Match Group,15,10,15,40,0.375000
2025-08-30,Mativ,12,16,12,40,0.300000
2025-08-30,Matson inc,19,14,7,40,0.175000
2025-08-30,Mattel,14,19,7,40,0.175000
2025-08-30,Maximus,17,19,4,40,0.100000
2025-08-30,McCormick & Company,18,18,4,40,0.100000
2025-08-30,McDonalds,12,14,14,40,0.350000
2025-08-30,McKesson,20,17,3,40,0.075000
2025-08-30,Medical Mutual of Ohio,14,20,6,40,0.150000
2025-08-30,Merck,16,17,7,40,0.175000
2025-08-30,Mercury General,18,16,6,40,0.150000
2025-08-30,Meritage Homes,23,12,5,40,0.125000
2025-08-30,MetLife,17,18,5,40,0.125000
2025-08-30,Meta,22,15,3,40,0.075000
2025-08-30,Mettler-Toledo International,22,14,4,40,0.100000
2025-08-30,Microchip Technology,18,18,4,40,0.100000
2025-08-30,Micron Technology,18,18,4,40,0.100000
2025-08-30,Microsoft,8,17,15,40,0.375000
2025-08-30,Middleby,18,18,4,40,0.100000
2025-08-30,MillerKnoll,20,18,2,40,0.050000
2025-08-30,Moderna,20,13,7,40,0.175000
2025-08-30,ModivCare,18,17,5,40,0.125000
2025-08-30,Mohawk Industries,21,15,4,40,0.100000
2025-08-30,Molina Healthcare,17,18,5,40,0.125000
2025-08-30,Molson Coors Beverage,23,11,6,40,0.150000
2025-08-30,Mondelez,18,15,7,40,0.175000
2025-08-30,Monster Beverage,21,13,6,40,0.150000
2025-08-30,Moodys Corporation,3,12,2,17,0.117647
2025-08-30,Moog inc,21,16,3,40,0.075000
2025-08-30,Morgan Stanley,9,21,10,40,0.250000
2025-08-30,Mosaic,18,18,4,40,0.100000
2025-08-30,Motorola Solutions,36,0,4,40,0.100000
2025-08-30,Mueller Industries,17,14,9,40,0.225000
2025-08-30,Murphy Oil,18,15,7,40,0.175000
2025-08-30,Murphy USA,16,23,1,40,0.025000
2025-08-30,Mutual of Omaha,15,21,4,40,0.100000
2025-08-30,NCR Atleos,17,20,3,40,0.075000
2025-08-30,NCR Voyix,18,16,6,40,0.150000
2025-08-30,NGL Energy Partners,38,0,2,40,0.050000
2025-08-30,NLV Financial,4,4,2,10,0.200000
2025-08-30,NOV,10,25,5,40,0.125000
2025-08-30,NRG Energy,33,3,4,40,0.100000
2025-08-30,NVR,20,13,7,40,0.175000
2025-08-30,Nasdaq,10,19,11,40,0.275000
2025-08-30,Nationwide,12,12,16,40,0.400000
2025-08-30,Navient,19,16,5,40,0.125000
2025-08-30,NetApp,15,17,8,40,0.200000
2025-08-30,Netflix,14,16,10,40,0.250000
2025-08-30,NeueHealth,14,22,4,40,0.100000
2025-08-30,New York Life Insurance,13,25,2,40,0.050000
2025-08-30,NewMarket Corporation,18,16,6,40,0.150000
2025-08-30,Newell Brands,19,18,3,40,0.075000
2025-08-30,Newmont,10,16,14,40,0.350000
2025-08-30,News Corp,17,15,8,40,0.200000
2025-08-30,Nexstar Media Group,23,14,3,40,0.075000
2025-08-30,NextEra Energy,36,2,2,40,0.050000
2025-08-30,NiSource,20,15,5,40,0.125000
2025-08-30,Nike,10,24,6,40,0.150000
2025-08-30,Nordson,18,18,4,40,0.100000
2025-08-30,Nordstrom,11,21,8,40,0.200000
2025-08-30,Norfolk Southern,12,20,8,40,0.200000
2025-08-30,Northern Trust,39,1,0,40,0.000000
2025-08-30,Northrop Grumman,17,19,4,40,0.100000
2025-08-30,Northwestern Mutual,37,3,0,40,0.000000
2025-08-30,Nucor,18,18,4,40,0.100000
2025-08-30,Nvidia,12,16,12,40,0.300000
2025-08-30,O'Reilly Automotive,19,13,8,40,0.200000
2025-08-30,O-I Glass,16,20,4,40,0.100000
2025-08-30,ODP Business Solutions,22,17,1,40,0.025000
2025-08-30,OGE Energy,31,7,2,40,0.050000
2025-08-30,ON Semiconductor,10,22,8,40,0.200000
2025-08-30,Occidental Petroleum,15,20,5,40,0.125000
2025-08-30,Old Dominion Freight Line,22,17,1,40,0.025000
2025-08-30,Old National Bancorp,18,19,3,40,0.075000
2025-08-30,Old Republic International,19,15,6,40,0.150000
2025-08-30,Olin,16,18,6,40,0.150000
2025-08-30,Omnicom Group,15,17,8,40,0.200000
2025-08-30,OneMain,25,12,3,40,0.075000
2025-08-30,Oneok,24,15,1,40,0.025000
2025-08-30,Opendoor Technologies,14,16,10,40,0.250000
2025-08-30,Option Care Health,40,0,0,40,0.000000
2025-08-30,Oracle,11,23,6,40,0.150000
2025-08-30,Organon,11,24,5,40,0.125000
2025-08-30,Oscar Health,14,16,10,40,0.250000
2025-08-30,Oshkosh,11,19,10,40,0.250000
2025-08-30,Otis Worldwide,23,16,1,40,0.025000
2025-08-30,Ovintiv,25,10,5,40,0.125000
2025-08-30,Owens & Minor,10,19,11,40,0.275000
2025-08-30,Owens Corning,23,14,3,40,0.075000
2025-08-30,PACS Group,15,19,6,40,0.150000
2025-08-30,PBF Energy,32,5,3,40,0.075000
2025-08-30,PC Connection Inc,23,15,2,40,0.050000
2025-08-30,PENN Entertainment,39,1,0,40,0.000000
2025-08-30,PG&E,10,13,17,40,0.425000
2025-08-30,PNC Financial Services,20,18,2,40,0.050000
2025-08-30,PPG Industries,22,14,4,40,0.100000
2025-08-30,PPL,18,18,4,40,0.100000
2025-08-30,PVH,17,22,1,40,0.025000
2025-08-30,Paccar,23,11,6,40,0.150000
2025-08-30,Pacific Life,16,23,1,40,0.025000
2025-08-30,Packaging Corp of America,9,27,4,40,0.100000
2025-08-30,Palo Alto Networks,9,25,6,40,0.150000
2025-08-30,Par Pacific,25,12,3,40,0.075000
2025-08-30,Paramount Global,12,20,8,40,0.200000
2025-08-30,Park Hotels & Resorts,12,23,5,40,0.125000
2025-08-30,Parker-Hannifin,25,12,3,40,0.075000
2025-08-30,Parsons Corporation,26,11,3,40,0.075000
2025-08-30,Patrick Industries,18,21,1,40,0.025000
2025-08-30,Patterson Companies Inc,10,25,5,40,0.125000
2025-08-30,Patterson-UTI Energy,36,2,2,40,0.050000
2025-08-30,PayPal,15,14,11,40,0.275000
2025-08-30,Paychex,17,19,4,40,0.100000
2025-08-30,Peabody Energy,30,6,4,40,0.100000
2025-08-30,Peloton,21,14,5,40,0.125000
2025-08-30,Penn Mutual Life Insurance,19,18,3,40,0.075000
2025-08-30,PennyMac Financial Services,25,11,4,40,0.100000
2025-08-30,Penske Automotive,17,19,4,40,0.100000
2025-08-30,PepsiCo,26,11,3,40,0.075000
2025-08-30,Performance Food,20,16,4,40,0.100000
2025-08-30,Permian Resources,24,14,2,40,0.050000
2025-08-30,Petco Health and Wellness,29,11,0,40,0.000000
2025-08-30,Peter Kiewit Sons',6,21,13,40,0.325000
2025-08-30,Pfizer,15,17,8,40,0.200000
2025-08-30,Philip Morris,19,13,8,40,0.200000
2025-08-30,Phillips 66,20,13,7,40,0.175000
2025-08-30,Pinnacle West Capital,13,17,10,40,0.250000
2025-08-30,Pinterest,18,19,3,40,0.075000
2025-08-30,Pioneer Natural Resources,19,10,11,40,0.275000
2025-08-30,Pitney Bowes,22,10,8,40,0.200000
2025-08-30,Plains GP,17,10,13,40,0.325000
2025-08-30,Playtika Holding,19,15,6,40,0.150000
2025-08-30,Plexus,9,20,11,40,0.275000
2025-08-30,Polaris Inc,17,15,8,40,0.200000
2025-08-30,Pool Corporation,18,17,5,40,0.125000
2025-08-30,Popular inc,40,0,0,40,0.000000
2025-08-30,Portland General Electric,14,21,5,40,0.125000
2025-08-30,Post Holdings,20,17,3,40,0.075000
2025-08-30,PriceSmart,19,15,6,40,0.150000
2025-08-30,Primerica,15,19,6,40,0.150000
2025-08-30,Primoris Services,20,18,2,40,0.050000
2025-08-30,Principal Financial,18,18,4,40,0.100000
2025-08-30,ProFrac Holding,23,15,2,40,0.050000
2025-08-30,Procter & Gamble,13,22,5,40,0.125000
2025-08-30,Progressive Insurance,17,21,2,40,0.050000
2025-08-30,Prologis,22,15,3,40,0.075000
2025-08-30,Prudential Financial,23,11,6,40,0.150000
2025-08-30,Public Service Enterprise Group,26,10,4,40,0.100000
2025-08-30,Public Storage,20,16,4,40,0.100000
2025-08-30,Publix Super Markets,19,16,5,40,0.125000
2025-08-30,Puget Sound Energy,29,9,2,40,0.050000
2025-08-30,PulteGroup,28,9,3,40,0.075000
2025-08-30,Pure Storage,16,19,5,40,0.125000
2025-08-30,QVC,18,17,5,40,0.125000
2025-08-30,Qorvo,16,16,8,40,0.200000
2025-08-30,Quad/Graphics,19,12,9,40,0.225000
2025-08-30,Qualcomm,18,15,7,40,0.175000
2025-08-30,Quanta Services,19,13,8,40,0.200000
2025-08-30,Quest Diagnostics,16,18,6,40,0.150000
2025-08-30,QuidelOrtho,18,18,4,40,0.100000
2025-08-30,REV Group,15,20,5,40,0.125000
2025-08-30,RPM International,23,13,4,40,0.100000
2025-08-30,RTX,18,17,5,40,0.125000
2025-08-30,RXO inc,21,15,4,40,0.100000
2025-08-30,Rackspace Technology,23,13,4,40,0.100000
2025-08-30,Radius Recycling,14,15,11,40,0.275000
2025-08-30,Ralph Lauren,24,13,3,40,0.075000
2025-08-30,Range Resources,25,9,6,40,0.150000
2025-08-30,Raymond James Financial,23,15,2,40,0.050000
2025-08-30,Realty Income,26,10,4,40,0.100000
2025-08-30,Regal Rexnord,23,14,3,40,0.075000
2025-08-30,Regeneron Pharmaceuticals,22,16,2,40,0.050000
2025-08-30,Regions Financial,15,22,3,40,0.075000
2025-08-30,Reinsurance Group of America,17,18,5,40,0.125000
2025-08-30,Reliance Inc,25,13,2,40,0.050000
2025-08-30,Republic Services,13,11,16,40,0.400000
2025-08-30,ResMed,19,18,3,40,0.075000
2025-08-30,Resideo Technologies,23,14,3,40,0.075000
2025-08-30,Restoration Hardware,13,21,6,40,0.150000
2025-08-30,Revvity,22,14,4,40,0.100000
2025-08-30,Rite Aid,9,29,2,40,0.050000
2025-08-30,Rithm Capital,22,16,2,40,0.050000
2025-08-30,Rivian Automotive,18,19,3,40,0.075000
2025-08-30,Robert Half,20,13,7,40,0.175000
2025-08-30,Roblox,13,14,13,40,0.325000
2025-08-30,Rocket Companies,25,9,6,40,0.150000
2025-08-30,Rockwell Automation,20,16,4,40,0.100000
2025-08-30,Roku,16,16,8,40,0.200000
2025-08-30,Rollins inc,19,18,3,40,0.075000
2025-08-30,Roper Technologies,19,14,7,40,0.175000
2025-08-30,Ross Stores,14,20,6,40,0.150000
2025-08-30,Rush Enterprises,22,14,4,40,0.100000
2025-08-30,Ryder System,17,15,8,40,0.200000
2025-08-30,Ryerson Holding,13,14,13,40,0.325000
2025-08-30,S&P Global,14,22,4,40,0.100000
2025-08-30,SBA Communications,18,15,7,40,0.175000
2025-08-30,SS&C Technologies,24,12,4,40,0.100000
2025-08-30,Sabre Corporation,13,22,5,40,0.125000
2025-08-30,Saia inc,20,17,3,40,0.075000
2025-08-30,Salesforce,8,15,17,40,0.425000
2025-08-30,Sallie Mae,15,21,4,40,0.100000
2025-08-30,Sally Beauty,40,0,0,40,0.000000
2025-08-30,Sanmina,15,21,4,40,0.100000
2025-08-30,ScanSource,20,14,6,40,0.150000
2025-08-30,Schneider National,25,10,5,40,0.125000
2025-08-30,Science Applications International,19,14,7,40,0.175000
2025-08-30,Scotts Miracle-Gro,33,5,2,40,0.050000
2025-08-30,Seaboard,17,17,6,40,0.150000
2025-08-30,Sealed Air Corporation,23,14,3,40,0.075000
2025-08-30,Securian Financial,10,26,4,40,0.100000
2025-08-30,Select Medical,20,14,6,40,0.150000
2025-08-30,Selective Insurance Group,27,12,1,40,0.025000
2025-08-30,Sempra,19,20,1,40,0.025000
2025-08-30,Sentry Insurance Group,3,7,0,10,0.000000
2025-08-30,Service Corp International,8,10,7,25,0.280000
2025-08-30,ServiceNow,21,18,1,40,0.025000
2025-08-30,Sherwin-Williams,15,18,7,40,0.175000
2025-08-30,Shift4 Payments,15,17,8,40,0.200000
2025-08-30,Silgan,18,15,7,40,0.175000
2025-08-30,Simon Property Group,19,20,1,40,0.025000
2025-08-30,Sinclair,11,24,5,40,0.125000
2025-08-30,SiteOne Landscape Supply,24,14,2,40,0.050000
2025-08-30,Skechers USA,21,11,8,40,0.200000
2025-08-30,SkyWest,7,23,10,40,0.250000
2025-08-30,Skyline Champion,33,4,3,40,0.075000
2025-08-30,Skyworks Solutions,30,2,8,40,0.200000
2025-08-30,Smurfit Westrock,13,20,7,40,0.175000
2025-08-30,Snap Inc,13,7,20,40,0.500000
2025-08-30,Snap-on,15,21,4,40,0.100000
2025-08-30,Snowflake inc,21,16,3,40,0.075000
2025-08-30,Sonic Automotive,22,14,4,40,0.100000
2025-08-30,Sonoco Products,19,14,7,40,0.175000
2025-08-30,Southern Company,30,9,1,40,0.025000
2025-08-30,Southwest Airlines,5,22,13,40,0.325000
2025-08-30,Southwest Gas,22,14,4,40,0.100000
2025-08-30,Southwestern Energy,35,3,2,40,0.050000
2025-08-30,SpartanNash,13,23,4,40,0.100000
2025-08-30,Spectrum Brands,24,13,3,40,0.075000
2025-08-30,Spire inc,16,18,6,40,0.150000
2025-08-30,Spirit AeroSystems,33,1,6,40,0.150000
2025-08-30,Spirit Airlines,36,0,4,40,0.100000
2025-08-30,Splunk,12,17,11,40,0.275000
2025-08-30,Sprouts Farmers Market,15,20,5,40,0.125000
2025-08-30,Stagwell,12,24,4,40,0.100000
2025-08-30,Stanley Black & Decker,15,19,6,40,0.150000
2025-08-30,Starbucks,16,19,5,40,0.125000
2025-08-30,State Farm Insurance,15,17,8,40,0.200000
2025-08-30,State Street,15,19,6,40,0.150000
2025-08-30,Steel Dynamics,36,4,0,40,0.000000
2025-08-30,Steelcase,16,20,4,40,0.100000
2025-08-30,Stericycle,12,9,19,40,0.475000
2025-08-30,Stifel Financial,20,17,3,40,0.075000
2025-08-30,StoneX,20,19,1,40,0.025000
2025-08-30,Stryker,17,13,10,40,0.250000
2025-08-30,Summit Materials,10,27,3,40,0.075000
2025-08-30,Sun Communities,24,12,4,40,0.100000
2025-08-30,Super Micro Computer,38,2,0,40,0.000000
2025-08-30,Surgery Partners,13,22,5,40,0.125000
2025-08-30,Sylvamo,18,16,6,40,0.150000
2025-08-30,Synchrony Financial,21,14,5,40,0.125000
2025-08-30,Synopsys,15,21,4,40,0.100000
2025-08-30,Synovus Financial,27,12,1,40,0.025000
2025-08-30,Sysco,16,15,9,40,0.225000
2025-08-30,T Rowe Price,22,16,2,40,0.050000
2025-08-30,TD Synnex,21,10,9,40,0.225000
2025-08-30,TEGNA,11,27,2,40,0.050000
2025-08-30,TIAA,12,25,3,40,0.075000
2025-08-30,TJX,18,17,5,40,0.125000
2025-08-30,Take-Two Interactive Software,18,16,6,40,0.150000
2025-08-30,Talen Energy,37,2,1,40,0.025000
2025-08-30,Tapestry,12,24,4,40,0.100000
2025-08-30,Targa Resources,17,13,10,40,0.250000
2025-08-30,Target,11,21,8,40,0.200000
2025-08-30,Taylor Morrison Home,18,15,7,40,0.175000
2025-08-30,Teladoc Health,12,18,10,40,0.250000
2025-08-30,Teledyne Technologies,20,9,11,40,0.275000
2025-08-30,Teleflex,20,18,2,40,0.050000
2025-08-30,Telephone & Data Systems,18,17,5,40,0.125000
2025-08-30,TelevisaUnivision,19,18,3,40,0.075000
2025-08-30,Tempur Sealy International,12,23,5,40,0.125000
2025-08-30,Tenet Healthcare,17,18,5,40,0.125000
2025-08-30,Teradyne,23,11,6,40,0.150000
2025-08-30,Terex,12,23,5,40,0.125000
2025-08-30,Tesla,9,22,9,40,0.225000
2025-08-30,Tetra Tech,23,12,5,40,0.125000
2025-08-30,Texas Instruments,17,19,4,40,0.100000
2025-08-30,Texas Roadhouse,11,24,5,40,0.125000
2025-08-30,Textron,22,16,2,40,0.050000
2025-08-30,The Andersons Inc,18,13,9,40,0.225000
2025-08-30,The Coca-Cola Company,15,19,6,40,0.150000
2025-08-30,The Hartford,14,19,7,40,0.175000
2025-08-30,Thermo Fisher Scientific,17,21,2,40,0.050000
2025-08-30,Thor Industries,23,14,3,40,0.075000
2025-08-30,Thrivent Financial for Lutherans,16,21,3,40,0.075000
2025-08-30,Timken,14,23,3,40,0.075000
2025-08-30,Titan Machinery,16,20,4,40,0.100000
2025-08-30,Toast inc,23,17,0,40,0.000000
2025-08-30,Toll Brothers,16,23,1,40,0.025000
2025-08-30,TopBuild,21,14,5,40,0.125000
2025-08-30,Topgolf Callaway Brands,14,20,6,40,0.150000
2025-08-30,Toro Company,19,16,5,40,0.125000
2025-08-30,Tractor Supply,21,14,5,40,0.125000
2025-08-30,TransDigm,21,16,3,40,0.075000
2025-08-30,TransUnion,8,18,14,40,0.350000
2025-08-30,Travelers Insurance,12,21,7,40,0.175000
2025-08-30,TreeHouse Foods,14,17,9,40,0.225000
2025-08-30,Tri Pointe Homes,19,18,3,40,0.075000
2025-08-30,TriNet Group,21,11,8,40,0.200000
2025-08-30,Trimble,10,27,3,40,0.075000
2025-08-30,Trinity Industries,26,10,4,40,0.100000
2025-08-30,TruStage,25,13,2,40,0.050000
2025-08-30,Truist Financial,26,13,1,40,0.025000
2025-08-30,Tutor Perini Corporation,26,11,3,40,0.075000
2025-08-30,Twilio,16,18,6,40,0.150000
2025-08-30,Tyson Foods,14,20,6,40,0.150000
2025-08-30,U-Haul,10,17,13,40,0.325000
2025-08-30,UFP Industries,19,14,7,40,0.175000
2025-08-30,UGI Utilities Inc,18,17,5,40,0.125000
2025-08-30,UL Solutions,33,2,5,40,0.125000
2025-08-30,UPS,14,17,9,40,0.225000
2025-08-30,US Bancorp,28,10,2,40,0.050000
2025-08-30,US Foods,20,16,4,40,0.100000
2025-08-30,USAA,17,12,11,40,0.275000
2025-08-30,Uber,16,11,13,40,0.325000
2025-08-30,Ulta Beauty,36,1,3,40,0.075000
2025-08-30,Under Armour,18,16,6,40,0.150000
2025-08-30,Union Pacific,15,17,8,40,0.200000
2025-08-30,United Airlines,26,7,7,40,0.175000
2025-08-30,United Natural Foods,40,0,0,40,0.000000
2025-08-30,United Rentals,37,1,2,40,0.050000
2025-08-30,United States Steel,30,4,6,40,0.150000
2025-08-30,UnitedHealth,13,19,8,40,0.200000
2025-08-30,Universal Corporation,15,17,8,40,0.200000
2025-08-30,Universal Health Services,17,16,7,40,0.175000
2025-08-30,Unum Group,15,21,4,40,0.100000
2025-08-30,Upbound Group,26,8,6,40,0.150000
2025-08-30,Urban Outfitters,16,17,7,40,0.175000
2025-08-30,V2X,23,14,3,40,0.075000
2025-08-30,VF Corporation,22,14,4,40,0.100000
2025-08-30,VICI Properties,22,15,3,40,0.075000
2025-08-30,Vail Resorts,13,16,11,40,0.275000
2025-08-30,Valero Energy,36,4,0,40,0.000000
2025-08-30,Valley National Bancorp,23,13,4,40,0.100000
2025-08-30,Valmont Industries,27,13,0,40,0.000000
2025-08-30,Valvoline inc,18,21,1,40,0.025000
2025-08-30,Ventas inc,23,15,2,40,0.050000
2025-08-30,Verisk Analytics,18,12,10,40,0.250000
2025-08-30,Verizon,16,19,5,40,0.125000
2025-08-30,Vertex Pharmaceuticals,17,16,7,40,0.175000
2025-08-30,Vertiv,22,15,3,40,0.075000
2025-08-30,Viasat,22,15,3,40,0.075000
2025-08-30,Viatris,13,22,5,40,0.125000
2025-08-30,Victorias Secret,13,15,12,40,0.300000
2025-08-30,Visa,5,18,17,40,0.425000
2025-08-30,Vishay Intertechnology,23,11,6,40,0.150000
2025-08-30,Vista Outdoor,13,22,5,40,0.125000
2025-08-30,Visteon,21,15,4,40,0.100000
2025-08-30,Vistra,19,16,5,40,0.125000
2025-08-30,Vontier,18,17,5,40,0.125000
2025-08-30,Voya Financial,23,13,4,40,0.100000
2025-08-30,Vulcan Materials,17,18,5,40,0.125000
2025-08-30,WEC Energy,36,4,0,40,0.000000
2025-08-30,WESCO International,23,14,3,40,0.075000
2025-08-30,WEX,20,14,6,40,0.150000
2025-08-30,WR Berkley,9,22,9,40,0.225000
2025-08-30,WW Grainger,20,15,5,40,0.125000
2025-08-30,Wabash National,17,18,5,40,0.125000
2025-08-30,Walgreens,4,30,6,40,0.150000
2025-08-30,Walmart,10,19,11,40,0.275000
2025-08-30,Walt Disney,26,11,3,40,0.075000
2025-08-30,Warner Bros Discovery,14,22,4,40,0.100000
2025-08-30,Warner Music Group,10,29,1,40,0.025000
2025-08-30,Waters Corporation,17,16,7,40,0.175000
2025-08-30,Watsco,24,14,2,40,0.050000
2025-08-30,Wayfair,21,15,4,40,0.100000
2025-08-30,Webster Financial,21,13,6,40,0.150000
2025-08-30,Weis Markets,15,18,7,40,0.175000
2025-08-30,Wells Fargo,31,4,5,40,0.125000
2025-08-30,Welltower,33,6,1,40,0.025000
2025-08-30,Werner Enterprises,24,12,4,40,0.100000
2025-08-30,West Pharmaceutical Services,18,17,5,40,0.125000
2025-08-30,Western & Southern Financial,15,22,3,40,0.075000
2025-08-30,Western Alliance Bancorp,15,17,8,40,0.200000
2025-08-30,Western Digital,26,12,2,40,0.050000
2025-08-30,Western Midstream Partners,14,8,18,40,0.450000
2025-08-30,Western Union,15,24,1,40,0.025000
2025-08-30,Westinghouse Air Brake Technologies,16,18,6,40,0.150000
2025-08-30,Westlake Corporation,24,13,3,40,0.075000
2025-08-30,Weyerhaeuser,19,17,4,40,0.100000
2025-08-30,Whirlpool,25,13,2,40,0.050000
2025-08-30,Williams,13,13,14,40,0.350000
2025-08-30,Williams-Sonoma,13,21,6,40,0.150000
2025-08-30,Winnebago Industries,17,15,8,40,0.200000
2025-08-30,Wintrust Financial,21,14,5,40,0.125000
2025-08-30,Woodward inc,18,17,5,40,0.125000
2025-08-30,Workday,13,13,14,40,0.350000
2025-08-30,World Kinect,25,12,3,40,0.075000
2025-08-30,Worthington Enterprises,24,10,6,40,0.150000
2025-08-30,Wynn Resorts,21,10,9,40,0.225000
2025-08-30,XPO,18,18,4,40,0.100000
2025-08-30,Xcel Energy,33,7,0,40,0.000000
2025-08-30,Xerox,18,19,3,40,0.075000
2025-08-30,Xylem Inc,23,8,9,40,0.225000
2025-08-30,Yum Brands,18,18,4,40,0.100000
2025-08-30,Yum China,20,16,4,40,0.100000
2025-08-30,Zebra Technologies,12,22,6,40,0.150000
2025-08-30,Zimmer Biomet,15,22,3,40,0.075000
2025-08-30,Zions Bancorp,19,16,5,40,0.125000
2025-08-30,Zoetis,24,12,4,40,0.100000
2025-08-30,Zoom Video Communications,14,22,4,40,0.100000
2025-08-30,eXp World,17,18,5,40,0.125000
2025-08-30,iHeartMedia,14,20,6,40,0.150000
2025-08-31,A O Smith,16,20,4,40,0.100000
2025-08-31,A-Mark Precious Metals,39,1,0,40,0.000000
2025-08-31,ABM Industries,20,20,0,40,0.000000
2025-08-31,ADT,20,14,6,40,0.150000
2025-08-31,AECOM,20,17,3,40,0.075000
2025-08-31,AES,23,12,5,40,0.125000
2025-08-31,AGCO,19,12,9,40,0.225000
2025-08-31,AGNC Investment,18,15,7,40,0.175000
2025-08-31,AMC Entertainment,33,5,2,40,0.050000
2025-08-31,AMC Networks,11,17,12,40,0.300000
2025-08-31,AMN Healthcare Services,15,18,7,40,0.175000
2025-08-31,APA,15,16,9,40,0.225000
2025-08-31,APi Group,24,12,4,40,0.100000
2025-08-31,ARKO,24,11,5,40,0.125000
2025-08-31,ASGN,17,16,7,40,0.175000
2025-08-31,AT&T,13,19,8,40,0.200000
2025-08-31,ATI inc,23,10,7,40,0.175000
2025-08-31,AbbVie,10,22,8,40,0.200000
2025-08-31,Abbott Laboratories,17,16,7,40,0.175000
2025-08-31,Abercrombie & Fitch,16,22,2,40,0.050000
2025-08-31,Academy Sports and Outdoors,14,20,6,40,0.150000
2025-08-31,Acadia Healthcare,20,16,4,40,0.100000
2025-08-31,Acuity Inc,21,15,4,40,0.100000
2025-08-31,Adams Resources & Energy,20,7,1,28,0.035714
2025-08-31,AdaptHealth,16,20,4,40,0.100000
2025-08-31,Adobe,13,26,1,40,0.025000
2025-08-31,Advance Auto Parts,18,17,5,40,0.125000
2025-08-31,Advanced Drainage Systems,36,4,0,40,0.000000
2025-08-31,Advanced Micro Devices,37,2,1,40,0.025000
2025-08-31,Advantage Solutions,40,0,0,40,0.000000
2025-08-31,Aflac,11,20,9,40,0.225000
2025-08-31,Agilent Technologies,23,11,6,40,0.150000
2025-08-31,Agilon Health,22,9,9,40,0.225000
2025-08-31,Air Lease,18,19,3,40,0.075000
2025-08-31,Air Products & Chemicals,18,15,7,40,0.175000
2025-08-31,Airbnb,18,17,5,40,0.125000
2025-08-31,Akamai Technologies,18,19,3,40,0.075000
2025-08-31,Alaska Air,19,19,2,40,0.050000
2025-08-31,Albemarle Corporation,14,24,2,40,0.050000
2025-08-31,Albertsons,20,16,4,40,0.100000
2025-08-31,Alcoa Corporation,17,16,7,40,0.175000
2025-08-31,Alexandria Real Estate Equities,18,17,5,40,0.125000
2025-08-31,Alight Solutions,15,21,4,40,0.100000
2025-08-31,Align Technology,11,20,9,40,0.225000
2025-08-31,Allegiant Travel Company,16,17,7,40,0.175000
2025-08-31,Alliance Resource Partners,11,5,24,40,0.600000
2025-08-31,Alliant Energy,34,4,2,40,0.050000
2025-08-31,Allison Transmission,19,18,3,40,0.075000
2025-08-31,Allstate,25,14,1,40,0.025000
2025-08-31,Ally Financial,21,16,3,40,0.075000
2025-08-31,Alpha Metallurgical Resources,15,22,3,40,0.075000
2025-08-31,Alphabet,11,19,10,40,0.250000
2025-08-31,Altice,15,17,8,40,0.200000
2025-08-31,Altria,17,15,8,40,0.200000
2025-08-31,Amazon,29,7,4,40,0.100000
2025-08-31,Ameren,18,17,5,40,0.125000
2025-08-31,American Airlines,12,14,14,40,0.350000
2025-08-31,American Axle & Manufacturing,17,18,5,40,0.125000
2025-08-31,American Eagle Outfitters,13,18,9,40,0.225000
2025-08-31,American Electric Power,26,12,2,40,0.050000
2025-08-31,American Express,19,15,6,40,0.150000
2025-08-31,American Family Insurance,23,14,3,40,0.075000
2025-08-31,American Financial,20,15,5,40,0.125000
2025-08-31,American International Group,23,16,1,40,0.025000
2025-08-31,American Tower,19,19,2,40,0.050000
2025-08-31,American Water Works,22,12,6,40,0.150000
2025-08-31,Americold Realty Trust,36,4,0,40,0.000000
2025-08-31,Ameriprise Financial,26,12,2,40,0.050000
2025-08-31,Ametek,24,11,5,40,0.125000
2025-08-31,Amgen,23,11,6,40,0.150000
2025-08-31,Amica Mutual Insurance,13,25,2,40,0.050000
2025-08-31,Amkor Technology,15,16,9,40,0.225000
2025-08-31,Amphenol,21,19,0,40,0.000000
2025-08-31,Analog Devices,14,22,4,40,0.100000
2025-08-31,Antero Resources,20,18,2,40,0.050000
2025-08-31,Anywhere Real Estate Inc,20,14,6,40,0.150000
2025-08-31,Apollo Global Management,15,24,1,40,0.025000
2025-08-31,AppLovin,16,21,3,40,0.075000
2025-08-31,Apple,14,20,6,40,0.150000
2025-08-31,Applied Industrial Technologies,16,23,1,40,0.025000
2025-08-31,Applied Materials,9,18,13,40,0.325000
2025-08-31,AptarGroup,22,13,5,40,0.125000
2025-08-31,Aramark,16,19,5,40,0.125000
2025-08-31,ArcBest,14,21,5,40,0.125000
2025-08-31,Arch Resources,28,6,6,40,0.150000
2025-08-31,Archer Daniels Midland,16,20,4,40,0.100000
2025-08-31,Ares Management,25,15,0,40,0.000000
2025-08-31,Arista Networks,24,15,1,40,0.025000
2025-08-31,Arrow Electronics,21,14,5,40,0.125000
2025-08-31,Arthur J Gallagher,9,27,4,40,0.100000
2025-08-31,Asbury Automotive Group,14,22,4,40,0.100000
2025-08-31,Assurant,20,16,4,40,0.100000
2025-08-31,Atkore,22,13,5,40,0.125000
2025-08-31,Atlassian,17,14,9,40,0.225000
2025-08-31,Atmos Energy,35,5,0,40,0.000000
2025-08-31,Auto-Owners Insurance,13,22,5,40,0.125000
2025-08-31,AutoNation,17,18,5,40,0.125000
2025-08-31,AutoZone,19,16,5,40,0.125000
2025-08-31,Autodesk,17,19,4,40,0.100000
2025-08-31,Autoliv,22,13,5,40,0.125000
2025-08-31,Automatic Data Processing,23,11,6,40,0.150000
2025-08-31,AvalonBay Communities,20,14,6,40,0.150000
2025-08-31,Avantor,20,14,6,40,0.150000
2025-08-31,Avery Dennison,13,19,8,40,0.200000
2025-08-31,Avient,19,15,6,40,0.150000
2025-08-31,Avis Budget,16,17,7,40,0.175000
2025-08-31,Avnet,21,13,6,40,0.150000
2025-08-31,BJs Wholesale Club,10,23,7,40,0.175000
2025-08-31,BOK Financial,14,20,6,40,0.150000
2025-08-31,BWX Technologies,24,16,0,40,0.000000
2025-08-31,Baker Hughes,24,10,6,40,0.150000
2025-08-31,Ball,15,19,6,40,0.150000
2025-08-31,Bank of America,20,14,6,40,0.150000
2025-08-31,Bank of New York Mellon,28,10,2,40,0.050000
2025-08-31,Bath & Body Works,11,22,7,40,0.175000
2025-08-31,Baxter International,17,18,5,40,0.125000
2025-08-31,Beacon Roofing Supply,9,23,8,40,0.200000
2025-08-31,Becton Dickinson,12,22,6,40,0.150000
2025-08-31,Belden,15,19,6,40,0.150000
2025-08-31,Benchmark Electronics,21,13,6,40,0.150000
2025-08-31,Berkshire Hathaway,15,19,6,40,0.150000
2025-08-31,Best Buy,40,0,0,40,0.000000
2025-08-31,Big Lots,6,31,3,40,0.075000
2025-08-31,Bio-Rad Laboratories,14,21,5,40,0.125000
2025-08-31,Biogen,26,12,2,40,0.050000
2025-08-31,BlackRock,24,14,2,40,0.050000
2025-08-31,Blackstone,21,12,7,40,0.175000
2025-08-31,Bloomin Brands,9,25,6,40,0.150000
2025-08-31,BlueLinx,30,9,1,40,0.025000
2025-08-31,Boeing,14,18,8,40,0.200000
2025-08-31,Boise Cascade,12,19,9,40,0.225000
2025-08-31,Booking Holdings,22,10,8,40,0.200000
2025-08-31,Booz Allen Hamilton,21,14,5,40,0.125000
2025-08-31,BorgWarner,22,14,4,40,0.100000
2025-08-31,Boston Properties,24,12,4,40,0.100000
2025-08-31,Boston Scientific,16,15,9,40,0.225000
2025-08-31,Boyd Gaming,18,17,5,40,0.125000
2025-08-31,Bread Financial,29,9,2,40,0.050000
2025-08-31,BrightSpring Health Services,27,9,4,40,0.100000
2025-08-31,BrightView Holdings,24,13,3,40,0.075000
2025-08-31,Brighthouse Financial,18,18,4,40,0.100000
2025-08-31,Brinker International,21,13,6,40,0.150000
2025-08-31,Brinks Company,7,2,5,14,0.357143
2025-08-31,Bristol-Myers Squibb,15,21,4,40,0.100000
2025-08-31,Broadcom,10,28,2,40,0.050000
2025-08-31,Broadridge Financial Solutions,28,5,7,40,0.175000
2025-08-31,Brookdale Senior Living,21,12,7,40,0.175000
2025-08-31,Brown & Brown,16,18,6,40,0.150000
2025-08-31,Brown-Forman,10,21,9,40,0.225000
2025-08-31,Bruker,7,24,9,40,0.225000
2025-08-31,Brunswick,9,20,11,40,0.275000
2025-08-31,Builders FirstSource,21,15,4,40,0.100000
2025-08-31,Burlington Stores,18,20,2,40,0.050000
2025-08-31,CACI International,17,20,3,40,0.075000
2025-08-31,CBRE Group,20,20,0,40,0.000000
2025-08-31,CDW,18,17,5,40,0.125000
2025-08-31,CF Industries,21,15,4,40,0.100000
2025-08-31,CH Robinson Worldwide,20,18,2,40,0.050000
2025-08-31,CHS,17,18,5,40,0.125000
2025-08-31,CME Group,12,26,2,40,0.050000
2025-08-31,CMS Energy,36,3,1,40,0.025000
2025-08-31,CNO Financial Group,11,21,8,40,0.200000
2025-08-31,CNX Resources,21,11,8,40,0.200000
2025-08-31,CSX,17,13,10,40,0.250000
2025-08-31,CVS Health,16,16,8,40,0.200000
2025-08-31,Cabot Corporation,25,13,2,40,0.050000
2025-08-31,Cadence,17,18,5,40,0.125000
2025-08-31,Caesars Entertainment,35,4,1,40,0.025000
2025-08-31,Cal-Maine Foods,19,16,5,40,0.125000
2025-08-31,Caleres inc,19,14,7,40,0.175000
2025-08-31,California Resources,22,12,6,40,0.150000
2025-08-31,Calumet,13,17,10,40,0.250000
2025-08-31,Campbell Soup,13,21,6,40,0.150000
2025-08-31,Camping World,17,17,6,40,0.150000
2025-08-31,Capital One,24,11,5,40,0.125000
2025-08-31,CarMax,12,22,6,40,0.150000
2025-08-31,Cardinal Health,14,18,8,40,0.200000
2025-08-31,Carlisle Companies,12,15,13,40,0.325000
2025-08-31,Carlyle Group,18,18,4,40,0.100000
2025-08-31,Carpenter Technology,15,18,7,40,0.175000
2025-08-31,Carrier Global,20,14,6,40,0.150000
2025-08-31,Carters inc,8,21,2,31,0.064516
2025-08-31,Carvana,20,13,7,40,0.175000
2025-08-31,Caseys General Stores,13,22,5,40,0.125000
2025-08-31,Catalent,9,26,5,40,0.125000
2025-08-31,Caterpillar,12,17,11,40,0.275000
2025-08-31,Cboe Global Markets,24,13,3,40,0.075000
2025-08-31,Celanese,18,11,11,40,0.275000
2025-08-31,Cencora,21,16,3,40,0.075000
2025-08-31,Centene,15,11,14,40,0.350000
2025-08-31,CenterPoint Energy,24,7,9,40,0.225000
2025-08-31,Central Garden & Pet,13,23,4,40,0.100000
2025-08-31,Century Communities,25,13,2,40,0.050000
2025-08-31,ChampionX,21,15,4,40,0.100000
2025-08-31,Charles River Laboratories International,18,15,7,40,0.175000
2025-08-31,Charles Schwab,19,19,2,40,0.050000
2025-08-31,Chart Industries,10,25,5,40,0.125000
2025-08-31,Charter Communications,14,18,8,40,0.200000
2025-08-31,Cheesecake Factory,14,15,11,40,0.275000
2025-08-31,Chefs Warehouse,23,12,5,40,0.125000
2025-08-31,Chemours,11,17,12,40,0.300000
2025-08-31,Cheniere Energy,35,3,2,40,0.050000
2025-08-31,Chevron,15,21,4,40,0.100000
2025-08-31,Chewy,21,15,4,40,0.100000
2025-08-31,Chipotle Mexican Grill,20,19,1,40,0.025000
2025-08-31,Chord Energy,31,8,1,40,0.025000
2025-08-31,Church & Dwight,15,16,9,40,0.225000
2025-08-31,Ciena,13,21,6,40,0.150000
2025-08-31,Cigna,17,14,9,40,0.225000
2025-08-31,Cincinnati Financial,16,20,4,40,0.100000
2025-08-31,Cinemark,14,21,5,40,0.125000
2025-08-31,Cintas,23,15,2,40,0.050000
2025-08-31,Cisco Systems,12,24,4,40,0.100000
2025-08-31,Citigroup,28,8,4,40,0.100000
2025-08-31,Citizens Financial Group,21,15,4,40,0.100000
2025-08-31,Civitas Resources,20,12,8,40,0.200000
2025-08-31,Clean Harbors,39,0,1,40,0.025000
2025-08-31,Clear Channel Outdoor Hldgs,7,1,2,10,0.200000
2025-08-31,Cleveland-Cliffs,16,18,6,40,0.150000
2025-08-31,Clorox,19,14,7,40,0.175000
2025-08-31,Cognizant Technology Solutions,32,2,6,40,0.150000
2025-08-31,Coherent,19,18,3,40,0.075000
2025-08-31,Coinbase Global,14,25,1,40,0.025000
2025-08-31,Colgate-Palmolive,20,15,5,40,0.125000
2025-08-31,Columbia Banking System,14,24,2,40,0.050000
2025-08-31,Columbia Sportswear,16,17,7,40,0.175000
2025-08-31,Comcast,28,8,4,40,0.100000
2025-08-31,Comerica,26,10,4,40,0.100000
2025-08-31,Comfort Systems USA,40,0,0,40,0.000000
2025-08-31,CommScope,25,14,1,40,0.025000
2025-08-31,Commercial Metals,17,17,6,40,0.150000
2025-08-31,Community Health Systems,22,14,4,40,0.100000
2025-08-31,Compass,20,17,3,40,0.075000
2025-08-31,Conagra Brands,21,13,6,40,0.150000
2025-08-31,Concentrix,21,15,4,40,0.100000
2025-08-31,Conduent,22,17,1,40,0.025000
2025-08-31,ConocoPhillips,18,14,8,40,0.200000
2025-08-31,Consol Energy,33,5,2,40,0.050000
2025-08-31,Consolidated Edison,20,14,6,40,0.150000
2025-08-31,Constellation Brands,9,18,13,40,0.325000
2025-08-31,Constellation Energy,37,3,0,40,0.000000
2025-08-31,Continental Resources,18,14,8,40,0.200000
2025-08-31,Cooper Cos,6,30,4,40,0.100000
2025-08-31,Cooper-Standard,18,15,7,40,0.175000
2025-08-31,Copart,23,15,2,40,0.050000
2025-08-31,Core & Main,18,18,4,40,0.100000
2025-08-31,Cornerstone Building Brands,16,20,4,40,0.100000
2025-08-31,Corning,15,21,4,40,0.100000
2025-08-31,Corpay,13,23,4,40,0.100000
2025-08-31,Corteva,16,19,5,40,0.125000
2025-08-31,Costco,10,24,6,40,0.150000
2025-08-31,Coterra Energy,35,4,1,40,0.025000
2025-08-31,Coty,21,13,6,40,0.150000
2025-08-31,Country Financial,14,22,4,40,0.100000
2025-08-31,Coupang,22,18,0,40,0.000000
2025-08-31,Cracker Barrel Old Country Store,14,17,9,40,0.225000
2025-08-31,Crocs,8,28,4,40,0.100000
2025-08-31,CrossAmerica Partners,17,5,18,40,0.450000
2025-08-31,CrowdStrike,13,15,12,40,0.300000
2025-08-31,Crown Castle,16,21,3,40,0.075000
2025-08-31,Crown Holdings,17,14,9,40,0.225000
2025-08-31,Cullen Frost Bankers,23,10,7,40,0.175000
2025-08-31,Cummins,18,18,4,40,0.100000
2025-08-31,Curtiss-Wright,19,15,6,40,0.150000
2025-08-31,DR Horton,12,20,8,40,0.200000
2025-08-31,DTE Energy,33,2,5,40,0.125000
2025-08-31,DXC Technology,15,21,4,40,0.100000
2025-08-31,DaVita,12,14,14,40,0.350000
2025-08-31,Dana Incorporated,24,15,1,40,0.025000
2025-08-31,Danaher,22,15,3,40,0.075000
2025-08-31,Darden Restaurants,22,11,7,40,0.175000
2025-08-31,Darling Ingredients,38,2,0,40,0.000000
2025-08-31,Deckers Outdoor,23,10,7,40,0.175000
2025-08-31,Deere,9,24,7,40,0.175000
2025-08-31,Delek US,20,18,2,40,0.050000
2025-08-31,Dell Technologies,17,18,5,40,0.125000
2025-08-31,Delta Air Lines,10,13,17,40,0.425000
2025-08-31,Dentsply Sirona,17,21,2,40,0.050000
2025-08-31,Designer Brands,14,22,4,40,0.100000
2025-08-31,Devon Energy,35,4,1,40,0.025000
2025-08-31,DexCom,13,21,6,40,0.150000
2025-08-31,Diamondback Energy,38,1,1,40,0.025000
2025-08-31,Dicks Sporting Goods,16,19,5,40,0.125000
2025-08-31,Diebold Nixdorf,19,17,4,40,0.100000
2025-08-31,Digital Realty Trust,39,1,0,40,0.000000
2025-08-31,Dillards,25,11,4,40,0.100000
2025-08-31,DocuSign,22,15,3,40,0.075000
2025-08-31,Dollar General,12,21,7,40,0.175000
2025-08-31,Dollar Tree,12,23,5,40,0.125000
2025-08-31,Dominion Energy,35,4,1,40,0.025000
2025-08-31,Dominos Pizza inc,18,16,6,40,0.150000
2025-08-31,Domtar,10,25,5,40,0.125000
2025-08-31,Donaldson Company,26,12,2,40,0.050000
2025-08-31,DoorDash,22,15,3,40,0.075000
2025-08-31,Dover Corporation,21,14,5,40,0.125000
2025-08-31,DraftKings,31,6,3,40,0.075000
2025-08-31,Dream Finders Homes,38,2,0,40,0.000000
2025-08-31,Dropbox,16,21,3,40,0.075000
2025-08-31,DuPont,17,20,3,40,0.075000
2025-08-31,Duke Energy,38,2,0,40,0.000000
2025-08-31,Dycom Industries,16,19,5,40,0.125000
2025-08-31,EMCOR Group,18,19,3,40,0.075000
2025-08-31,EOG Resources,13,21,6,40,0.150000
2025-08-31,EPAM Systems,16,17,7,40,0.175000
2025-08-31,EQT,13,24,3,40,0.075000
2025-08-31,ESAB,18,17,5,40,0.125000
2025-08-31,East West Bancorp,24,14,2,40,0.050000
2025-08-31,Eastman Chemical,12,19,9,40,0.225000
2025-08-31,Ebay,21,10,9,40,0.225000
2025-08-31,EchoStar,12,23,5,40,0.125000
2025-08-31,Ecolab,20,14,6,40,0.150000
2025-08-31,Edison International,7,26,7,40,0.175000
2025-08-31,Edward Jones,16,19,5,40,0.125000
2025-08-31,Edwards Lifesciences,15,11,14,40,0.350000
2025-08-31,Elanco Animal Health,16,21,3,40,0.075000
2025-08-31,Electronic Arts,14,19,7,40,0.175000
2025-08-31,Elevance Health,20,9,11,40,0.275000
2025-08-31,Eli Lilly,20,11,9,40,0.225000
2025-08-31,Emerson Electric,25,10,5,40,0.125000
2025-08-31,EnLink Midstream,15,20,5,40,0.125000
2025-08-31,Encompass Health,17,18,5,40,0.125000
2025-08-31,Endeavor Group,14,22,4,40,0.100000
2025-08-31,EnerSys,18,16,6,40,0.150000
2025-08-31,Energizer,38,2,0,40,0.000000
2025-08-31,Energy Transfer,38,0,2,40,0.050000
2025-08-31,Ensign Group,23,10,7,40,0.175000
2025-08-31,Entegris,15,17,8,40,0.200000
2025-08-31,Entergy,27,9,4,40,0.100000
2025-08-31,Enterprise Products Partners,12,9,19,40,0.475000
2025-08-31,Envista,26,9,5,40,0.125000
2025-08-31,Equifax,23,13,4,40,0.100000
2025-08-31,Equinix,21,19,0,40,0.000000
2025-08-31,Equitable,20,19,1,40,0.025000
2025-08-31,Equity Residential,23,13,4,40,0.100000
2025-08-31,Erie Insurance,13,15,12,40,0.300000
2025-08-31,Estée Lauder,11,25,4,40,0.100000
2025-08-31,Etsy,22,13,5,40,0.125000
2025-08-31,Euronet Worldwide,17,17,6,40,0.150000
2025-08-31,Evergy,20,11,9,40,0.225000
2025-08-31,Eversource Energy,35,3,2,40,0.050000
2025-08-31,Exact Sciences,11,18,11,40,0.275000
2025-08-31,Exelon,21,15,4,40,0.100000
2025-08-31,Expand Energy,39,1,0,40,0.000000
2025-08-31,Expedia,21,13,6,40,0.150000
2025-08-31,Expeditors International of Washington,23,12,5,40,0.125000
2025-08-31,Extra Space Storage,20,10,10,40,0.250000
2025-08-31,Exxon Mobil,21,15,4,40,0.100000
2025-08-31,F5,18,19,3,40,0.075000
2025-08-31,FM Global,11,17,12,40,0.300000
2025-08-31,FMC Corporation,18,16,6,40,0.150000
2025-08-31,FTI Consulting,20,16,4,40,0.100000
2025-08-31,Fannie Mae,12,25,3,40,0.075000
2025-08-31,Farmers Insurance Exchange,8,19,13,40,0.325000
2025-08-31,Fastenal,25,5,10,40,0.250000
2025-08-31,FedEx,10,23,7,40,0.175000
2025-08-31,Federated Mutual Insurance,14,20,6,40,0.150000
2025-08-31,Fidelity National Financial,22,14,4,40,0.100000
2025-08-31,Fidelity National Information Services,20,16,4,40,0.100000
2025-08-31,Fifth Third Bancorp,20,19,1,40,0.025000
2025-08-31,First American Financial,14,20,6,40,0.150000
2025-08-31,First Citizens BancShares,19,17,4,40,0.100000
2025-08-31,First Horizon,17,21,2,40,0.050000
2025-08-31,First National of Nebraska,16,23,1,40,0.025000
2025-08-31,First Solar,19,15,6,40,0.150000
2025-08-31,FirstCash,21,16,3,40,0.075000
2025-08-31,FirstEnergy,14,21,5,40,0.125000
2025-08-31,Fiserv,17,18,5,40,0.125000
2025-08-31,Five Below,19,17,4,40,0.100000
2025-08-31,Flagstar Financial,19,20,1,40,0.025000
2025-08-31,Floor & Decor,21,16,3,40,0.075000
2025-08-31,Flowers Foods,16,20,4,40,0.100000
2025-08-31,Flowserve,24,12,4,40,0.100000
2025-08-31,Fluor,15,14,11,40,0.275000
2025-08-31,Foot Locker,12,17,11,40,0.275000
2025-08-31,Ford Motor,18,18,4,40,0.100000
2025-08-31,Fortinet,16,16,8,40,0.200000
2025-08-31,Fortive,24,12,4,40,0.100000
2025-08-31,Fortune Brands Innovations,22,17,1,40,0.025000
2025-08-31,Franklin Resources,25,11,4,40,0.100000
2025-08-31,Freddie Mac,12,19,9,40,0.225000
2025-08-31,Freeport-McMoRan,22,14,4,40,0.100000
2025-08-31,Frontier Airlines,15,13,12,40,0.300000
2025-08-31,Frontier Communications,18,15,7,40,0.175000
2025-08-31,G-III Apparel Group,26,9,5,40,0.125000
2025-08-31,GE HealthCare Technologies,17,17,6,40,0.150000
2025-08-31,GMS,8,23,9,40,0.225000
2025-08-31,GXO Logistics,18,18,4,40,0.100000
2025-08-31,GameStop,13,18,9,40,0.225000
2025-08-31,Gannett,21,11,8,40,0.200000
2025-08-31,Garrett Motion inc,16,16,8,40,0.200000
2025-08-31,Gartner,10,22,8,40,0.200000
2025-08-31,Gen Digital,18,13,9,40,0.225000
2025-08-31,Generac,16,19,5,40,0.125000
2025-08-31,General Dynamics,36,4,0,40,0.000000
2025-08-31,General Electric,13,21,6,40,0.150000
2025-08-31,General Mills,25,12,3,40,0.075000
2025-08-31,General Motors,23,11,6,40,0.150000
2025-08-31,Genesis Energy,34,3,3,40,0.075000
2025-08-31,Genuine Parts,15,16,9,40,0.225000
2025-08-31,Genworth Financial,15,18,7,40,0.175000
2025-08-31,Gilead Sciences,25,13,2,40,0.050000
2025-08-31,Global Partners,14,18,8,40,0.200000
2025-08-31,Global Payments,17,19,4,40,0.100000
2025-08-31,Globe Life,22,15,3,40,0.075000
2025-08-31,GoDaddy,21,15,4,40,0.100000
2025-08-31,Goldman Sachs,20,15,5,40,0.125000
2025-08-31,Goodyear Tire & Rubber,14,22,4,40,0.100000
2025-08-31,Graham Holdings Company,18,15,7,40,0.175000
2025-08-31,Granite Construction,21,15,4,40,0.100000
2025-08-31,Graphic Packaging,18,15,7,40,0.175000
2025-08-31,Gray Television,10,22,8,40,0.200000
2025-08-31,Graybar Electric,15,21,4,40,0.100000
2025-08-31,Green Plains inc,22,13,5,40,0.125000
2025-08-31,Greenbrier,13,19,8,40,0.200000
2025-08-31,Greif,5,26,9,40,0.225000
2025-08-31,Griffon Corporation,22,14,4,40,0.100000
2025-08-31,Grocery Outlet Holding,14,23,3,40,0.075000
2025-08-31,Group 1 Automotive,18,17,5,40,0.125000
2025-08-31,Guardian Life insurance,19,21,0,40,0.000000
2025-08-31,Guess inc,24,13,3,40,0.075000
2025-08-31,H B Fuller,18,16,6,40,0.150000
2025-08-31,HCA Healthcare,22,12,6,40,0.150000
2025-08-31,HEICO,12,20,8,40,0.200000
2025-08-31,HF Sinclair,21,14,5,40,0.125000
2025-08-31,Halliburton,20,14,6,40,0.150000
2025-08-31,Hanesbrands,15,21,4,40,0.100000
2025-08-31,Hanover Insurance Group,21,13,6,40,0.150000
2025-08-31,Harley-Davidson,18,17,5,40,0.125000
2025-08-31,Hasbro,14,17,9,40,0.225000
2025-08-31,Hawaiian Airlines inc,19,21,0,40,0.000000
2025-08-31,Hawaiian Electric Industries,18,20,2,40,0.050000
2025-08-31,Helmerich & Payne,15,25,0,40,0.000000
2025-08-31,Henry Schein,21,18,1,40,0.025000
2025-08-31,Herc Rentals,18,16,6,40,0.150000
2025-08-31,Hershey,19,16,5,40,0.125000
2025-08-31,Hertz,16,13,11,40,0.275000
2025-08-31,Hewlett Packard,20,16,4,40,0.100000
2025-08-31,Hewlett Packard Enterprise,20,19,1,40,0.025000
2025-08-31,Hillenbrand,16,21,3,40,0.075000
2025-08-31,Hilton Grand Vacations,39,1,0,40,0.000000
2025-08-31,Hilton Worldwide,21,18,1,40,0.025000
2025-08-31,Hologic,15,13,12,40,0.300000
2025-08-31,Home Depot,11,15,14,40,0.350000
2025-08-31,Honeywell,20,15,5,40,0.125000
2025-08-31,Hormel Foods,11,18,11,40,0.275000
2025-08-31,Host Hotels & Resorts,12,25,3,40,0.075000
2025-08-31,Hovnanian Enterprises,21,13,6,40,0.150000
2025-08-31,Howmet Aerospace,19,16,5,40,0.125000
2025-08-31,Hub Group,20,17,3,40,0.075000
2025-08-31,Hubbell,19,16,5,40,0.125000
2025-08-31,Humana,24,13,3,40,0.075000
2025-08-31,Huntington Bancshares,19,17,4,40,0.100000
2025-08-31,Huntington Ingalls Industries,19,17,4,40,0.100000
2025-08-31,Huntsman,15,15,10,40,0.250000
2025-08-31,Hyatt Hotels,24,13,3,40,0.075000
2025-08-31,Hyster-Yale,18,18,4,40,0.100000
2025-08-31,IAC,15,17,8,40,0.200000
2025-08-31,IBM,13,25,2,40,0.050000
2025-08-31,IDEX,22,12,6,40,0.150000
2025-08-31,IDEXX Laboratories,17,15,8,40,0.200000
2025-08-31,IQVIA,25,10,5,40,0.125000
2025-08-31,ITT,16,18,6,40,0.150000
2025-08-31,Icahn Enterprises,17,13,10,40,0.250000
2025-08-31,Illinois Tool Works,13,22,5,40,0.125000
2025-08-31,Illumina inc,18,15,7,40,0.175000
2025-08-31,Incyte,18,16,6,40,0.150000
2025-08-31,Ingersoll Rand,18,20,2,40,0.050000
2025-08-31,Ingles Markets,19,15,6,40,0.150000
2025-08-31,Ingram Micro,15,12,13,40,0.325000
2025-08-31,Ingredion,24,12,4,40,0.100000
2025-08-31,Insight Enterprises,15,15,10,40,0.250000
2025-08-31,Insperity,18,13,9,40,0.225000
2025-08-31,Instacart,20,16,4,40,0.100000
2025-08-31,Installed Building Products,19,16,5,40,0.125000
2025-08-31,Intel,10,19,11,40,0.275000
2025-08-31,Interactive Brokers,17,19,4,40,0.100000
2025-08-31,Intercontinental Exchange,19,18,3,40,0.075000
2025-08-31,International Flavors & Fragrances,19,14,7,40,0.175000
2025-08-31,International Paper,6,31,3,40,0.075000
2025-08-31,Interpublic Group,20,17,3,40,0.075000
2025-08-31,Intuit,20,17,3,40,0.075000
2025-08-31,Intuitive Surgical,11,17,12,40,0.300000
2025-08-31,Iron Mountain,16,17,7,40,0.175000
2025-08-31,JB Hunt Transport Services,17,18,5,40,0.125000
2025-08-31,JELD-WEN Holding,22,14,4,40,0.100000
2025-08-31,JM Smucker,16,16,8,40,0.200000
2025-08-31,JPMorgan Chase,22,16,2,40,0.050000
2025-08-31,Jabil,17,18,5,40,0.125000
2025-08-31,Jackson Financial,19,19,2,40,0.050000
2025-08-31,Jacobs Solutions,36,1,3,40,0.075000
2025-08-31,Jefferies Financial,20,17,3,40,0.075000
2025-08-31,JetBlue Airways,19,17,4,40,0.100000
2025-08-31,Johnson & Johnson,13,19,8,40,0.200000
2025-08-31,Jones Lang LaSalle,15,18,7,40,0.175000
2025-08-31,Juniper Networks,13,21,6,40,0.150000
2025-08-31,KB Home,21,13,6,40,0.150000
2025-08-31,KBR,25,12,3,40,0.075000
2025-08-31,KKR,19,19,2,40,0.050000
2025-08-31,KLA,16,18,6,40,0.150000
2025-08-31,Kaiser Aluminum,23,13,4,40,0.100000
2025-08-31,Kellanova,21,14,5,40,0.125000
2025-08-31,Kelly Services inc,20,12,8,40,0.200000
2025-08-31,Kemper,17,12,11,40,0.275000
2025-08-31,Keurig Dr Pepper,8,30,2,40,0.050000
2025-08-31,KeyCorp,30,9,1,40,0.025000
2025-08-31,Keysight Technologies,27,11,2,40,0.050000
2025-08-31,Kimberly-Clark,11,18,11,40,0.275000
2025-08-31,Kinder Morgan,39,0,1,40,0.025000
2025-08-31,Kirby Corporation,26,10,4,40,0.100000
2025-08-31,Knife River Corporation,17,19,4,40,0.100000
2025-08-31,Knight Swift Transportation,29,5,6,40,0.150000
2025-08-31,Kohls,14,13,13,40,0.325000
2025-08-31,Kontoor Brands,18,19,3,40,0.075000
2025-08-31,Korn Ferry,17,13,10,40,0.250000
2025-08-31,Kraft Heinz,21,15,4,40,0.100000
2025-08-31,Kroger,4,26,10,40,0.250000
2025-08-31,Kyndryl,16,20,4,40,0.100000
2025-08-31,L3Harris Technologies,22,15,3,40,0.075000
2025-08-31,LCI Industries,18,18,4,40,0.100000
2025-08-31,LKQ,16,18,6,40,0.150000
2025-08-31,LPL Financial,28,11,1,40,0.025000
2025-08-31,Labcorp Holdings,21,16,3,40,0.075000
2025-08-31,Lam Research,22,16,2,40,0.050000
2025-08-31,Lamb Weston,22,12,6,40,0.150000
2025-08-31,Land O'Lakes,11,23,6,40,0.150000
2025-08-31,Landstar System,20,11,9,40,0.225000
2025-08-31,Las Vegas Sands,21,15,4,40,0.100000
2025-08-31,Lear Corporation,18,16,6,40,0.150000
2025-08-31,Leggett & Platt,20,18,2,40,0.050000
2025-08-31,Leidos,32,5,3,40,0.075000
2025-08-31,Lennar,15,23,2,40,0.050000
2025-08-31,Lennox International,18,18,4,40,0.100000
2025-08-31,Levi Strauss,13,27,0,40,0.000000
2025-08-31,Liberty Energy,40,0,0,40,0.000000
2025-08-31,Liberty Media,40,0,0,40,0.000000
2025-08-31,Liberty Mutual Insurance,34,2,4,40,0.100000
2025-08-31,Light & Wonder,11,24,5,40,0.125000
2025-08-31,Lincoln Electric,10,20,10,40,0.250000
2025-08-31,Lincoln National,18,16,6,40,0.150000
2025-08-31,Lithia Motors,17,20,3,40,0.075000
2025-08-31,Live Nation Entertainment,39,0,1,40,0.025000
2025-08-31,Lockheed Martin,25,11,4,40,0.100000
2025-08-31,Loews,20,15,5,40,0.125000
2025-08-31,Louisiana-Pacific Corporation,20,10,10,40,0.250000
2025-08-31,Lowes,13,23,4,40,0.100000
2025-08-31,Lululemon athletica,21,16,3,40,0.075000
2025-08-31,Lumen Technologies,12,22,6,40,0.150000
2025-08-31,Lyft,15,15,10,40,0.250000
2025-08-31,M&T Bank,19,16,5,40,0.125000
2025-08-31,M/I Homes,16,20,4,40,0.100000
2025-08-31,MDU Resources Group,22,13,5,40,0.125000
2025-08-31,MGM Resorts International,19,15,6,40,0.150000
2025-08-31,MKS Instruments,13,17,10,40,0.250000
2025-08-31,MRC Global,19,14,7,40,0.175000
2025-08-31,MSC Industrial Direct,23,14,3,40,0.075000
2025-08-31,MSCI,30,9,1,40,0.025000
2025-08-31,MYR Group,9,24,7,40,0.175000
2025-08-31,Macys,16,23,1,40,0.025000
2025-08-31,ManpowerGroup,27,8,5,40,0.125000
2025-08-31,Marathon Oil,15,20,5,40,0.125000
2025-08-31,Marathon Petroleum,23,17,0,40,0.000000
2025-08-31,Markel Group,29,8,3,40,0.075000
2025-08-31,Marriott International,25,10,5,40,0.125000
2025-08-31,Marriott Vacations Worldwide,25,11,4,40,0.100000
2025-08-31,Marsh & McLennan,16,21,3,40,0.075000
2025-08-31,Martin Marietta Materials,19,18,3,40,0.075000
2025-08-31,Marvell Technology,14,17,9,40,0.225000
2025-08-31,MasTec,21,15,4,40,0.100000
2025-08-31,Masco,19,13,8,40,0.200000
2025-08-31,Mass Mutual,13,23,4,40,0.100000
2025-08-31,MasterBrand,20,17,3,40,0.075000
2025-08-31,Mastercard,11,24,5,40,0.125000
2025-08-31,Matador Resources,20,15,5,40,0.125000
2025-08-31,Match Group,15,12,13,40,0.325000
2025-08-31,Mativ,11,20,9,40,0.225000
2025-08-31,Matson inc,21,14,5,40,0.125000
2025-08-31,Mattel,19,17,4,40,0.100000
2025-08-31,Maximus,18,18,4,40,0.100000
2025-08-31,McCormick & Company,20,16,4,40,0.100000
2025-08-31,McDonalds,11,15,14,40,0.350000
2025-08-31,McKesson,15,19,6,40,0.150000
2025-08-31,Medical Mutual of Ohio,14,20,6,40,0.150000
2025-08-31,Merck,15,18,7,40,0.175000
2025-08-31,Mercury General,17,16,7,40,0.175000
2025-08-31,Meritage Homes,18,19,3,40,0.075000
2025-08-31,MetLife,18,18,4,40,0.100000
2025-08-31,Meta,16,18,6,40,0.150000
2025-08-31,Mettler-Toledo International,25,12,3,40,0.075000
2025-08-31,Microchip Technology,22,14,4,40,0.100000
2025-08-31,Micron Technology,9,24,7,40,0.175000
2025-08-31,Microsoft,9,11,20,40,0.500000
2025-08-31,Middleby,23,16,1,40,0.025000
2025-08-31,MillerKnoll,20,17,3,40,0.075000
2025-08-31,Moderna,17,12,11,40,0.275000
2025-08-31,ModivCare,11,21,8,40,0.200000
2025-08-31,Mohawk Industries,22,14,4,40,0.100000
2025-08-31,Molina Healthcare,19,13,8,40,0.200000
2025-08-31,Molson Coors Beverage,20,9,11,40,0.275000
2025-08-31,Mondelez,19,14,7,40,0.175000
2025-08-31,Monster Beverage,20,15,5,40,0.125000
2025-08-31,Moodys Corporation,3,12,2,17,0.117647
2025-08-31,Moog inc,18,16,6,40,0.150000
2025-08-31,Morgan Stanley,14,18,8,40,0.200000
2025-08-31,Mosaic,14,21,5,40,0.125000
2025-08-31,Motorola Solutions,34,1,5,40,0.125000
2025-08-31,Mueller Industries,20,14,6,40,0.150000
2025-08-31,Murphy Oil,16,12,12,40,0.300000
2025-08-31,Murphy USA,18,21,1,40,0.025000
2025-08-31,Mutual of Omaha,15,20,5,40,0.125000
2025-08-31,NCR Atleos,17,19,4,40,0.100000
2025-08-31,NCR Voyix,20,16,4,40,0.100000
2025-08-31,NGL Energy Partners,35,1,4,40,0.100000
2025-08-31,NLV Financial,4,4,2,10,0.200000
2025-08-31,NOV,13,24,3,40,0.075000
2025-08-31,NRG Energy,31,4,5,40,0.125000
2025-08-31,NVR,20,13,7,40,0.175000
2025-08-31,Nasdaq,10,20,10,40,0.250000
2025-08-31,Nationwide,9,15,16,40,0.400000
2025-08-31,Navient,23,13,4,40,0.100000
2025-08-31,NetApp,19,15,6,40,0.150000
2025-08-31,Netflix,15,18,7,40,0.175000
2025-08-31,NeueHealth,17,20,3,40,0.075000
2025-08-31,New York Life Insurance,14,24,2,40,0.050000
2025-08-31,NewMarket Corporation,17,19,4,40,0.100000
2025-08-31,Newell Brands,17,18,5,40,0.125000
2025-08-31,Newmont,9,17,14,40,0.350000
2025-08-31,News Corp,16,16,8,40,0.200000
2025-08-31,Nexstar Media Group,24,16,0,40,0.000000
2025-08-31,NextEra Energy,36,2,2,40,0.050000
2025-08-31,NiSource,19,14,7,40,0.175000
2025-08-31,Nike,14,18,8,40,0.200000
2025-08-31,Nordson,13,21,6,40,0.150000
2025-08-31,Nordstrom,16,20,4,40,0.100000
2025-08-31,Norfolk Southern,9,19,12,40,0.300000
2025-08-31,Northern Trust,39,1,0,40,0.000000
2025-08-31,Northrop Grumman,16,21,3,40,0.075000
2025-08-31,Northwestern Mutual,36,4,0,40,0.000000
2025-08-31,Nucor,12,24,4,40,0.100000
2025-08-31,Nvidia,11,20,9,40,0.225000
2025-08-31,O'Reilly Automotive,18,14,8,40,0.200000
2025-08-31,O-I Glass,18,17,5,40,0.125000
2025-08-31,ODP Business Solutions,21,18,1,40,0.025000
2025-08-31,OGE Energy,36,4,0,40,0.000000
2025-08-31,ON Semiconductor,13,22,5,40,0.125000
2025-08-31,Occidental Petroleum,19,17,4,40,0.100000
2025-08-31,Old Dominion Freight Line,23,14,3,40,0.075000
2025-08-31,Old National Bancorp,16,18,6,40,0.150000
2025-08-31,Old Republic International,22,14,4,40,0.100000
2025-08-31,Olin,16,15,9,40,0.225000
2025-08-31,Omnicom Group,19,14,7,40,0.175000
2025-08-31,OneMain,21,18,1,40,0.025000
2025-08-31,Oneok,25,15,0,40,0.000000
2025-08-31,Opendoor Technologies,12,16,12,40,0.300000
2025-08-31,Option Care Health,40,0,0,40,0.000000
2025-08-31,Oracle,16,18,6,40,0.150000
2025-08-31,Organon,10,23,7,40,0.175000
2025-08-31,Oscar Health,14,14,12,40,0.300000
2025-08-31,Oshkosh,18,13,9,40,0.225000
2025-08-31,Otis Worldwide,24,15,1,40,0.025000
2025-08-31,Ovintiv,22,13,5,40,0.125000
2025-08-31,Owens & Minor,12,17,11,40,0.275000
2025-08-31,Owens Corning,20,16,4,40,0.100000
2025-08-31,PACS Group,18,17,5,40,0.125000
2025-08-31,PBF Energy,32,6,2,40,0.050000
2025-08-31,PC Connection Inc,24,14,2,40,0.050000
2025-08-31,PENN Entertainment,38,2,0,40,0.000000
2025-08-31,PG&E,12,16,12,40,0.300000
2025-08-31,PNC Financial Services,19,20,1,40,0.025000
2025-08-31,PPG Industries,18,19,3,40,0.075000
2025-08-31,PPL,20,17,3,40,0.075000
2025-08-31,PVH,19,19,2,40,0.050000
2025-08-31,Paccar,25,10,5,40,0.125000
2025-08-31,Pacific Life,16,23,1,40,0.025000
2025-08-31,Packaging Corp of America,10,26,4,40,0.100000
2025-08-31,Palo Alto Networks,13,19,8,40,0.200000
2025-08-31,Par Pacific,27,13,0,40,0.000000
2025-08-31,Paramount Global,10,24,6,40,0.150000
2025-08-31,Park Hotels & Resorts,13,23,4,40,0.100000
2025-08-31,Parker-Hannifin,27,12,1,40,0.025000
2025-08-31,Parsons Corporation,17,19,4,40,0.100000
2025-08-31,Patrick Industries,20,18,2,40,0.050000
2025-08-31,Patterson Companies Inc,10,25,5,40,0.125000
2025-08-31,Patterson-UTI Energy,32,5,3,40,0.075000
2025-08-31,PayPal,13,13,14,40,0.350000
2025-08-31,Paychex,22,13,5,40,0.125000
2025-08-31,Peabody Energy,31,5,4,40,0.100000
2025-08-31,Peloton,21,15,4,40,0.100000
2025-08-31,Penn Mutual Life Insurance,19,18,3,40,0.075000
2025-08-31,PennyMac Financial Services,23,11,6,40,0.150000
2025-08-31,Penske Automotive,15,19,6,40,0.150000
2025-08-31,PepsiCo,27,9,4,40,0.100000
2025-08-31,Performance Food,15,19,6,40,0.150000
2025-08-31,Permian Resources,19,20,1,40,0.025000
2025-08-31,Petco Health and Wellness,30,8,2,40,0.050000
2025-08-31,Peter Kiewit Sons',4,22,14,40,0.350000
2025-08-31,Pfizer,14,19,7,40,0.175000
2025-08-31,Philip Morris,16,16,8,40,0.200000
2025-08-31,Phillips 66,19,14,7,40,0.175000
2025-08-31,Pinnacle West Capital,13,18,9,40,0.225000
2025-08-31,Pinterest,15,19,6,40,0.150000
2025-08-31,Pioneer Natural Resources,18,10,12,40,0.300000
2025-08-31,Pitney Bowes,21,11,8,40,0.200000
2025-08-31,Plains GP,17,9,14,40,0.350000
2025-08-31,Playtika Holding,17,17,6,40,0.150000
2025-08-31,Plexus,6,24,10,40,0.250000
2025-08-31,Polaris Inc,19,17,4,40,0.100000
2025-08-31,Pool Corporation,17,18,5,40,0.125000
2025-08-31,Popular inc,38,2,0,40,0.000000
2025-08-31,Portland General Electric,17,19,4,40,0.100000
2025-08-31,Post Holdings,22,16,2,40,0.050000
2025-08-31,PriceSmart,17,18,5,40,0.125000
2025-08-31,Primerica,19,14,7,40,0.175000
2025-08-31,Primoris Services,19,19,2,40,0.050000
2025-08-31,Principal Financial,22,14,4,40,0.100000
2025-08-31,ProFrac Holding,21,17,2,40,0.050000
2025-08-31,Procter & Gamble,18,19,3,40,0.075000
2025-08-31,Progressive Insurance,17,21,2,40,0.050000
2025-08-31,Prologis,21,19,0,40,0.000000
2025-08-31,Prudential Financial,23,12,5,40,0.125000
2025-08-31,Public Service Enterprise Group,23,15,2,40,0.050000
2025-08-31,Public Storage,22,17,1,40,0.025000
2025-08-31,Publix Super Markets,19,16,5,40,0.125000
2025-08-31,Puget Sound Energy,28,10,2,40,0.050000
2025-08-31,PulteGroup,28,9,3,40,0.075000
2025-08-31,Pure Storage,15,19,6,40,0.150000
2025-08-31,QVC,19,17,4,40,0.100000
2025-08-31,Qorvo,19,18,3,40,0.075000
2025-08-31,Quad/Graphics,18,15,7,40,0.175000
2025-08-31,Qualcomm,16,16,8,40,0.200000
2025-08-31,Quanta Services,23,14,3,40,0.075000
2025-08-31,Quest Diagnostics,16,19,5,40,0.125000
2025-08-31,QuidelOrtho,18,17,5,40,0.125000
2025-08-31,REV Group,19,17,4,40,0.100000
2025-08-31,RPM International,16,20,4,40,0.100000
2025-08-31,RTX,23,14,3,40,0.075000
2025-08-31,RXO inc,19,14,7,40,0.175000
2025-08-31,Rackspace Technology,23,9,8,40,0.200000
2025-08-31,Radius Recycling,17,13,10,40,0.250000
2025-08-31,Ralph Lauren,29,9,2,40,0.050000
2025-08-31,Range Resources,21,11,8,40,0.200000
2025-08-31,Raymond James Financial,22,18,0,40,0.000000
2025-08-31,Realty Income,22,14,4,40,0.100000
2025-08-31,Regal Rexnord,19,19,2,40,0.050000
2025-08-31,Regeneron Pharmaceuticals,24,16,0,40,0.000000
2025-08-31,Regions Financial,22,17,1,40,0.025000
2025-08-31,Reinsurance Group of America,22,13,5,40,0.125000
2025-08-31,Reliance Inc,26,11,3,40,0.075000
2025-08-31,Republic Services,12,10,18,40,0.450000
2025-08-31,ResMed,15,20,5,40,0.125000
2025-08-31,Resideo Technologies,24,13,3,40,0.075000
2025-08-31,Restoration Hardware,12,22,6,40,0.150000
2025-08-31,Revvity,21,15,4,40,0.100000
2025-08-31,Rite Aid,8,30,2,40,0.050000
2025-08-31,Rithm Capital,17,17,6,40,0.150000
2025-08-31,Rivian Automotive,17,16,7,40,0.175000
2025-08-31,Robert Half,18,19,3,40,0.075000
2025-08-31,Roblox,13,18,9,40,0.225000
2025-08-31,Rocket Companies,24,13,3,40,0.075000
2025-08-31,Rockwell Automation,20,16,4,40,0.100000
2025-08-31,Roku,16,17,7,40,0.175000
2025-08-31,Rollins inc,19,17,4,40,0.100000
2025-08-31,Roper Technologies,21,14,5,40,0.125000
2025-08-31,Ross Stores,19,18,3,40,0.075000
2025-08-31,Rush Enterprises,22,15,3,40,0.075000
2025-08-31,Ryder System,18,15,7,40,0.175000
2025-08-31,Ryerson Holding,18,12,10,40,0.250000
2025-08-31,S&P Global,12,24,4,40,0.100000
2025-08-31,SBA Communications,17,15,8,40,0.200000
2025-08-31,SS&C Technologies,23,15,2,40,0.050000
2025-08-31,Sabre Corporation,16,21,3,40,0.075000
2025-08-31,Saia inc,16,20,4,40,0.100000
2025-08-31,Salesforce,5,17,18,40,0.450000
2025-08-31,Sallie Mae,15,22,3,40,0.075000
2025-08-31,Sally Beauty,39,0,1,40,0.025000
2025-08-31,Sanmina,19,17,4,40,0.100000
2025-08-31,ScanSource,20,13,7,40,0.175000
2025-08-31,Schneider National,20,13,7,40,0.175000
2025-08-31,Science Applications International,18,16,6,40,0.150000
2025-08-31,Scotts Miracle-Gro,36,3,1,40,0.025000
2025-08-31,Seaboard,27,11,2,40,0.050000
2025-08-31,Sealed Air Corporation,21,17,2,40,0.050000
2025-08-31,Securian Financial,11,25,4,40,0.100000
2025-08-31,Select Medical,20,13,7,40,0.175000
2025-08-31,Selective Insurance Group,28,9,3,40,0.075000
2025-08-31,Sempra,17,22,1,40,0.025000
2025-08-31,Sentry Insurance Group,3,7,0,10,0.000000
2025-08-31,Service Corp International,10,9,7,26,0.269231
2025-08-31,ServiceNow,24,14,2,40,0.050000
2025-08-31,Sherwin-Williams,16,18,6,40,0.150000
2025-08-31,Shift4 Payments,15,18,7,40,0.175000
2025-08-31,Silgan,18,17,5,40,0.125000
2025-08-31,Simon Property Group,18,18,4,40,0.100000
2025-08-31,Sinclair,13,18,9,40,0.225000
2025-08-31,SiteOne Landscape Supply,27,10,3,40,0.075000
2025-08-31,Skechers USA,19,13,8,40,0.200000
2025-08-31,SkyWest,9,19,12,40,0.300000
2025-08-31,Skyline Champion,33,4,3,40,0.075000
2025-08-31,Skyworks Solutions,31,2,7,40,0.175000
2025-08-31,Smurfit Westrock,15,23,2,40,0.050000
2025-08-31,Snap Inc,13,11,16,40,0.400000
2025-08-31,Snowflake inc,20,16,4,40,0.100000
2025-08-31,Sonic Automotive,21,16,3,40,0.075000
2025-08-31,Sonoco Products,20,15,5,40,0.125000
2025-08-31,Southern Company,28,8,4,40,0.100000
2025-08-31,Southwest Airlines,9,19,12,40,0.300000
2025-08-31,Southwest Gas,23,11,6,40,0.150000
2025-08-31,Southwestern Energy,35,2,3,40,0.075000
2025-08-31,SpartanNash,17,20,3,40,0.075000
2025-08-31,Spectrum Brands,15,19,6,40,0.150000
2025-08-31,Spire inc,17,16,7,40,0.175000
2025-08-31,Spirit AeroSystems,35,1,4,40,0.100000
2025-08-31,Spirit Airlines,33,0,7,40,0.175000
2025-08-31,Splunk,14,16,10,40,0.250000
2025-08-31,Sprouts Farmers Market,16,21,3,40,0.075000
2025-08-31,Stagwell,15,22,3,40,0.075000
2025-08-31,Stanley Black & Decker,12,21,7,40,0.175000
2025-08-31,Starbucks,19,17,4,40,0.100000
2025-08-31,State Farm Insurance,14,19,7,40,0.175000
2025-08-31,State Street,11,18,11,40,0.275000
2025-08-31,Steel Dynamics,34,4,2,40,0.050000
2025-08-31,Steelcase,19,19,2,40,0.050000
2025-08-31,Stericycle,12,7,21,40,0.525000
2025-08-31,Stifel Financial,19,18,3,40,0.075000
2025-08-31,StoneX,23,15,2,40,0.050000
2025-08-31,Stryker,14,15,11,40,0.275000
2025-08-31,Summit Materials,10,27,3,40,0.075000
2025-08-31,Sun Communities,23,13,4,40,0.100000
2025-08-31,Super Micro Computer,38,2,0,40,0.000000
2025-08-31,Surgery Partners,17,17,6,40,0.150000
2025-08-31,Sylvamo,14,20,6,40,0.150000
2025-08-31,Synchrony Financial,20,17,3,40,0.075000
2025-08-31,Synopsys,16,17,7,40,0.175000
2025-08-31,Synovus Financial,22,14,4,40,0.100000
2025-08-31,Sysco,17,13,10,40,0.250000
2025-08-31,T Rowe Price,24,13,3,40,0.075000
2025-08-31,TD Synnex,23,9,8,40,0.200000
2025-08-31,TEGNA,10,27,3,40,0.075000
2025-08-31,TIAA,12,26,2,40,0.050000
2025-08-31,TJX,21,14,5,40,0.125000
2025-08-31,Take-Two Interactive Software,18,17,5,40,0.125000
2025-08-31,Talen Energy,36,2,2,40,0.050000
2025-08-31,Tapestry,9,20,11,40,0.275000
2025-08-31,Targa Resources,17,15,8,40,0.200000
2025-08-31,Target,8,23,9,40,0.225000
2025-08-31,Taylor Morrison Home,14,21,5,40,0.125000
2025-08-31,Teladoc Health,17,17,6,40,0.150000
2025-08-31,Teledyne Technologies,17,16,7,40,0.175000
2025-08-31,Teleflex,14,20,6,40,0.150000
2025-08-31,Telephone & Data Systems,16,20,4,40,0.100000
2025-08-31,TelevisaUnivision,18,18,4,40,0.100000
2025-08-31,Tempur Sealy International,11,24,5,40,0.125000
2025-08-31,Tenet Healthcare,18,18,4,40,0.100000
2025-08-31,Teradyne,18,12,10,40,0.250000
2025-08-31,Terex,16,18,6,40,0.150000
2025-08-31,Tesla,9,17,14,40,0.350000
2025-08-31,Tetra Tech,23,14,3,40,0.075000
2025-08-31,Texas Instruments,16,18,6,40,0.150000
2025-08-31,Texas Roadhouse,14,20,6,40,0.150000
2025-08-31,Textron,16,21,3,40,0.075000
2025-08-31,The Andersons Inc,17,18,5,40,0.125000
2025-08-31,The Coca-Cola Company,13,21,6,40,0.150000
2025-08-31,The Hartford,12,17,11,40,0.275000
2025-08-31,Thermo Fisher Scientific,16,21,3,40,0.075000
2025-08-31,Thor Industries,15,15,10,40,0.250000
2025-08-31,Thrivent Financial for Lutherans,16,21,3,40,0.075000
2025-08-31,Timken,12,24,4,40,0.100000
2025-08-31,Titan Machinery,18,18,4,40,0.100000
2025-08-31,Toast inc,25,13,2,40,0.050000
2025-08-31,Toll Brothers,17,21,2,40,0.050000
2025-08-31,TopBuild,21,12,7,40,0.175000
2025-08-31,Topgolf Callaway Brands,17,16,7,40,0.175000
2025-08-31,Toro Company,17,17,6,40,0.150000
2025-08-31,Tractor Supply,18,17,5,40,0.125000
2025-08-31,TransDigm,16,20,4,40,0.100000
2025-08-31,TransUnion,7,17,16,40,0.400000
2025-08-31,Travelers Insurance,12,20,8,40,0.200000
2025-08-31,TreeHouse Foods,12,19,9,40,0.225000
2025-08-31,Tri Pointe Homes,18,19,3,40,0.075000
2025-08-31,TriNet Group,14,18,8,40,0.200000
2025-08-31,Trimble,9,25,6,40,0.150000
2025-08-31,Trinity Industries,20,15,5,40,0.125000
2025-08-31,TruStage,26,12,2,40,0.050000
2025-08-31,Truist Financial,18,18,4,40,0.100000
2025-08-31,Tutor Perini Corporation,22,12,6,40,0.150000
2025-08-31,Twilio,22,13,5,40,0.125000
2025-08-31,Tyson Foods,13,23,4,40,0.100000
2025-08-31,U-Haul,8,20,12,40,0.300000
2025-08-31,UFP Industries,16,19,5,40,0.125000
2025-08-31,UGI Utilities Inc,18,17,5,40,0.125000
2025-08-31,UL Solutions,37,1,2,40,0.050000
2025-08-31,UPS,10,22,8,40,0.200000
2025-08-31,US Bancorp,26,10,4,40,0.100000
2025-08-31,US Foods,25,11,4,40,0.100000
2025-08-31,USAA,14,16,10,40,0.250000
2025-08-31,Uber,14,9,17,40,0.425000
2025-08-31,Ulta Beauty,37,1,2,40,0.050000
2025-08-31,Under Armour,19,14,7,40,0.175000
2025-08-31,Union Pacific,15,19,6,40,0.150000
2025-08-31,United Airlines,28,4,8,40,0.200000
2025-08-31,United Natural Foods,39,0,1,40,0.025000
2025-08-31,United Rentals,38,2,0,40,0.000000
2025-08-31,United States Steel,33,6,1,40,0.025000
2025-08-31,UnitedHealth,18,15,7,40,0.175000
2025-08-31,Universal Corporation,16,17,7,40,0.175000
2025-08-31,Universal Health Services,16,18,6,40,0.150000
2025-08-31,Unum Group,21,16,3,40,0.075000
2025-08-31,Upbound Group,24,12,4,40,0.100000
2025-08-31,Urban Outfitters,18,17,5,40,0.125000
2025-08-31,V2X,19,19,2,40,0.050000
2025-08-31,VF Corporation,24,13,3,40,0.075000
2025-08-31,VICI Properties,14,19,7,40,0.175000
2025-08-31,Vail Resorts,14,15,11,40,0.275000
2025-08-31,Valero Energy,34,6,0,40,0.000000
2025-08-31,Valley National Bancorp,19,17,4,40,0.100000
2025-08-31,Valmont Industries,23,15,2,40,0.050000
2025-08-31,Valvoline inc,19,20,1,40,0.025000
2025-08-31,Ventas inc,24,13,3,40,0.075000
2025-08-31,Verisk Analytics,11,16,13,40,0.325000
2025-08-31,Verizon,8,18,14,40,0.350000
2025-08-31,Vertex Pharmaceuticals,19,13,8,40,0.200000
2025-08-31,Vertiv,22,17,1,40,0.025000
2025-08-31,Viasat,21,16,3,40,0.075000
2025-08-31,Viatris,14,21,5,40,0.125000
2025-08-31,Victorias Secret,13,15,12,40,0.300000
2025-08-31,Visa,11,15,14,40,0.350000
2025-08-31,Vishay Intertechnology,19,12,9,40,0.225000
2025-08-31,Vista Outdoor,14,22,4,40,0.100000
2025-08-31,Visteon,21,17,2,40,0.050000
2025-08-31,Vistra,18,14,8,40,0.200000
2025-08-31,Vontier,19,15,6,40,0.150000
2025-08-31,Voya Financial,26,9,5,40,0.125000
2025-08-31,Vulcan Materials,22,15,3,40,0.075000
2025-08-31,WEC Energy,34,3,3,40,0.075000
2025-08-31,WESCO International,24,13,3,40,0.075000
2025-08-31,WEX,18,15,7,40,0.175000
2025-08-31,WR Berkley,13,23,4,40,0.100000
2025-08-31,WW Grainger,17,18,5,40,0.125000
2025-08-31,Wabash National,16,16,8,40,0.200000
2025-08-31,Walgreens,3,28,9,40,0.225000
2025-08-31,Walmart,13,14,13,40,0.325000
2025-08-31,Walt Disney,26,12,2,40,0.050000
2025-08-31,Warner Bros Discovery,15,20,5,40,0.125000
2025-08-31,Warner Music Group,12,26,2,40,0.050000
2025-08-31,Waters Corporation,15,20,5,40,0.125000
2025-08-31,Watsco,20,14,6,40,0.150000
2025-08-31,Wayfair,18,20,2,40,0.050000
2025-08-31,Webster Financial,24,11,5,40,0.125000
2025-08-31,Weis Markets,19,14,7,40,0.175000
2025-08-31,Wells Fargo,30,4,6,40,0.150000
2025-08-31,Welltower,35,4,1,40,0.025000
2025-08-31,Werner Enterprises,17,17,6,40,0.150000
2025-08-31,West Pharmaceutical Services,19,14,7,40,0.175000
2025-08-31,Western & Southern Financial,13,24,3,40,0.075000
2025-08-31,Western Alliance Bancorp,17,16,7,40,0.175000
2025-08-31,Western Digital,18,17,5,40,0.125000
2025-08-31,Western Midstream Partners,18,7,15,40,0.375000
2025-08-31,Western Union,12,24,4,40,0.100000
2025-08-31,Westinghouse Air Brake Technologies,15,18,7,40,0.175000
2025-08-31,Westlake Corporation,21,14,5,40,0.125000
2025-08-31,Weyerhaeuser,15,19,6,40,0.150000
2025-08-31,Whirlpool,22,15,3,40,0.075000
2025-08-31,Williams,13,17,10,40,0.250000
2025-08-31,Williams-Sonoma,16,18,6,40,0.150000
2025-08-31,Winnebago Industries,14,18,8,40,0.200000
2025-08-31,Wintrust Financial,24,13,3,40,0.075000
2025-08-31,Woodward inc,14,18,8,40,0.200000
2025-08-31,Workday,15,12,13,40,0.325000
2025-08-31,World Kinect,16,17,7,40,0.175000
2025-08-31,Worthington Enterprises,23,10,7,40,0.175000
2025-08-31,Wynn Resorts,19,7,14,40,0.350000
2025-08-31,XPO,16,21,3,40,0.075000
2025-08-31,Xcel Energy,30,7,3,40,0.075000
2025-08-31,Xerox,15,22,3,40,0.075000
2025-08-31,Xylem Inc,25,7,8,40,0.200000
2025-08-31,Yum Brands,17,19,4,40,0.100000
2025-08-31,Yum China,18,19,3,40,0.075000
2025-08-31,Zebra Technologies,15,20,5,40,0.125000
2025-08-31,Zimmer Biomet,19,18,3,40,0.075000
2025-08-31,Zions Bancorp,19,16,5,40,0.125000
2025-08-31,Zoetis,27,11,2,40,0.050000
2025-08-31,Zoom Video Communications,15,21,4,40,0.100000
2025-08-31,eXp World,17,18,5,40,0.125000
2025-08-31,iHeartMedia,14,18,8,40,0.200000
2025-09-01,3M,17,18,5,40,0.125000
2025-09-01,A O Smith,15,19,6,40,0.150000
2025-09-01,A-Mark Precious Metals,39,1,0,40,0.000000
2025-09-01,ABM Industries,21,15,4,40,0.100000
2025-09-01,ADT,15,22,3,40,0.075000
2025-09-01,AECOM,21,17,2,40,0.050000
2025-09-01,AES,22,14,4,40,0.100000
2025-09-01,AGCO,17,15,8,40,0.200000
2025-09-01,AGNC Investment,16,18,6,40,0.150000
2025-09-01,AMC Entertainment,36,2,2,40,0.050000
2025-09-01,AMC Networks,12,16,12,40,0.300000
2025-09-01,AMN Healthcare Services,15,18,7,40,0.175000
2025-09-01,APA,18,14,8,40,0.200000
2025-09-01,APi Group,24,10,6,40,0.150000
2025-09-01,ARKO,22,14,4,40,0.100000
2025-09-01,ASGN,18,14,8,40,0.200000
2025-09-01,AT&T,10,22,8,40,0.200000
2025-09-01,ATI inc,22,12,6,40,0.150000
2025-09-01,AbbVie,11,24,5,40,0.125000
2025-09-01,Abbott Laboratories,17,16,7,40,0.175000
2025-09-01,Abercrombie & Fitch,18,21,1,40,0.025000
2025-09-01,Academy Sports and Outdoors,18,20,2,40,0.050000
2025-09-01,Acadia Healthcare,18,14,8,40,0.200000
2025-09-01,Acuity Inc,23,12,5,40,0.125000
2025-09-01,Adams Resources & Energy,20,6,1,27,0.037037
2025-09-01,AdaptHealth,16,16,8,40,0.200000
2025-09-01,Adobe,10,28,2,40,0.050000
2025-09-01,Advance Auto Parts,23,13,4,40,0.100000
2025-09-01,Advanced Drainage Systems,36,4,0,40,0.000000
2025-09-01,Advanced Micro Devices,37,2,1,40,0.025000
2025-09-01,Advantage Solutions,39,1,0,40,0.000000
2025-09-01,Aflac,9,23,8,40,0.200000
2025-09-01,Agilent Technologies,22,11,7,40,0.175000
2025-09-01,Agilon Health,21,9,10,40,0.250000
2025-09-01,Air Lease,18,15,7,40,0.175000
2025-09-01,Air Products & Chemicals,19,14,7,40,0.175000
2025-09-01,Airbnb,20,12,8,40,0.200000
2025-09-01,Akamai Technologies,20,16,4,40,0.100000
2025-09-01,Alaska Air,21,17,2,40,0.050000
2025-09-01,Albemarle Corporation,14,23,3,40,0.075000
2025-09-01,Albertsons,19,16,5,40,0.125000
2025-09-01,Alcoa Corporation,18,16,6,40,0.150000
2025-09-01,Alexandria Real Estate Equities,17,17,6,40,0.150000
2025-09-01,Alight Solutions,15,22,3,40,0.075000
2025-09-01,Align Technology,9,23,8,40,0.200000
2025-09-01,Allegiant Travel Company,15,18,7,40,0.175000
2025-09-01,Alliance Resource Partners,14,6,20,40,0.500000
2025-09-01,Alliant Energy,34,4,2,40,0.050000
2025-09-01,Allison Transmission,22,13,5,40,0.125000
2025-09-01,Allstate,27,10,3,40,0.075000
2025-09-01,Ally Financial,21,18,1,40,0.025000
2025-09-01,Alpha Metallurgical Resources,18,18,4,40,0.100000
2025-09-01,Alphabet,18,11,11,40,0.275000
2025-09-01,Altice,13,19,8,40,0.200000
2025-09-01,Altria,17,15,8,40,0.200000
2025-09-01,Amazon,34,4,2,40,0.050000
2025-09-01,Ameren,20,15,5,40,0.125000
2025-09-01,American Airlines,10,14,16,40,0.400000
2025-09-01,American Axle & Manufacturing,15,20,5,40,0.125000
2025-09-01,American Eagle Outfitters,16,15,9,40,0.225000
2025-09-01,American Electric Power,20,16,4,40,0.100000
2025-09-01,American Express,21,14,5,40,0.125000
2025-09-01,American Family Insurance,23,14,3,40,0.075000
2025-09-01,American Financial,21,14,5,40,0.125000
2025-09-01,American International Group,27,10,3,40,0.075000
2025-09-01,American Tower,16,19,5,40,0.125000
2025-09-01,American Water Works,22,13,5,40,0.125000
2025-09-01,Americold Realty Trust,38,2,0,40,0.000000
2025-09-01,Ameriprise Financial,20,16,4,40,0.100000
2025-09-01,Ametek,28,10,2,40,0.050000
2025-09-01,Amgen,21,12,7,40,0.175000
2025-09-01,Amica Mutual Insurance,13,25,2,40,0.050000
2025-09-01,Amkor Technology,13,21,6,40,0.150000
2025-09-01,Amphenol,15,22,3,40,0.075000
2025-09-01,Analog Devices,12,24,4,40,0.100000
2025-09-01,Antero Resources,15,21,4,40,0.100000
2025-09-01,Anywhere Real Estate Inc,23,11,6,40,0.150000
2025-09-01,Apollo Global Management,12,24,4,40,0.100000
2025-09-01,AppLovin,15,21,4,40,0.100000
2025-09-01,Apple,15,19,6,40,0.150000
2025-09-01,Applied Industrial Technologies,16,21,3,40,0.075000
2025-09-01,Applied Materials,10,17,13,40,0.325000
2025-09-01,AptarGroup,20,14,6,40,0.150000
2025-09-01,Aramark,17,18,5,40,0.125000
2025-09-01,ArcBest,18,18,4,40,0.100000
2025-09-01,Arch Resources,29,6,5,40,0.125000
2025-09-01,Archer Daniels Midland,19,18,3,40,0.075000
2025-09-01,Ares Management,25,13,2,40,0.050000
2025-09-01,Arista Networks,27,13,0,40,0.000000
2025-09-01,Arrow Electronics,18,14,8,40,0.200000
2025-09-01,Arthur J Gallagher,8,29,3,40,0.075000
2025-09-01,Asbury Automotive Group,18,18,4,40,0.100000
2025-09-01,Assurant,19,17,4,40,0.100000
2025-09-01,Atkore,17,18,5,40,0.125000
2025-09-01,Atlassian,16,14,10,40,0.250000
2025-09-01,Atmos Energy,34,5,1,40,0.025000
2025-09-01,Auto-Owners Insurance,14,21,5,40,0.125000
2025-09-01,AutoNation,22,15,3,40,0.075000
2025-09-01,AutoZone,19,15,6,40,0.150000
2025-09-01,Autodesk,19,15,6,40,0.150000
2025-09-01,Autoliv,21,13,6,40,0.150000
2025-09-01,Automatic Data Processing,22,12,6,40,0.150000
2025-09-01,AvalonBay Communities,24,11,5,40,0.125000
2025-09-01,Avantor,17,16,7,40,0.175000
2025-09-01,Avery Dennison,12,24,4,40,0.100000
2025-09-01,Avient,19,16,5,40,0.125000
2025-09-01,Avis Budget,18,13,9,40,0.225000
2025-09-01,Avnet,16,16,8,40,0.200000
2025-09-01,BJs Wholesale Club,9,23,8,40,0.200000
2025-09-01,BOK Financial,13,21,6,40,0.150000
2025-09-01,BWX Technologies,20,19,1,40,0.025000
2025-09-01,Baker Hughes,19,12,9,40,0.225000
2025-09-01,Ball,9,26,5,40,0.125000
2025-09-01,Bank of America,14,21,5,40,0.125000
2025-09-01,Bank of New York Mellon,28,10,2,40,0.050000
2025-09-01,Bath & Body Works,10,21,9,40,0.225000
2025-09-01,Baxter International,13,18,9,40,0.225000
2025-09-01,Beacon Roofing Supply,9,23,8,40,0.200000
2025-09-01,Becton Dickinson,15,20,5,40,0.125000
2025-09-01,Belden,24,12,4,40,0.100000
2025-09-01,Benchmark Electronics,22,13,5,40,0.125000
2025-09-01,Berkshire Hathaway,16,19,5,40,0.125000
2025-09-01,Best Buy,40,0,0,40,0.000000
2025-09-01,Big Lots,7,30,3,40,0.075000
2025-09-01,Bio-Rad Laboratories,15,18,7,40,0.175000
2025-09-01,Biogen,25,12,3,40,0.075000
2025-09-01,BlackRock,2,8,0,10,0.000000
2025-09-01,Blackstone,17,14,9,40,0.225000
2025-09-01,Bloomin Brands,17,18,5,40,0.125000
2025-09-01,BlueLinx,28,11,1,40,0.025000
2025-09-01,Boeing,16,15,9,40,0.225000
2025-09-01,Boise Cascade,13,18,9,40,0.225000
2025-09-01,Booking Holdings,22,10,8,40,0.200000
2025-09-01,Booz Allen Hamilton,23,14,3,40,0.075000
2025-09-01,BorgWarner,22,15,3,40,0.075000
2025-09-01,Boston Properties,20,16,4,40,0.100000
2025-09-01,Boston Scientific,14,15,11,40,0.275000
2025-09-01,Boyd Gaming,20,18,2,40,0.050000
2025-09-01,Bread Financial,24,12,4,40,0.100000
2025-09-01,BrightSpring Health Services,26,9,5,40,0.125000
2025-09-01,BrightView Holdings,21,13,6,40,0.150000
2025-09-01,Brighthouse Financial,17,18,5,40,0.125000
2025-09-01,Brinker International,22,12,6,40,0.150000
2025-09-01,Brinks Company,7,2,5,14,0.357143
2025-09-01,Bristol-Myers Squibb,10,24,6,40,0.150000
2025-09-01,Broadcom,11,25,4,40,0.100000
2025-09-01,Broadridge Financial Solutions,30,6,4,40,0.100000
2025-09-01,Brookdale Senior Living,20,12,8,40,0.200000
2025-09-01,Brown & Brown,17,19,4,40,0.100000
2025-09-01,Brown-Forman,8,21,11,40,0.275000
2025-09-01,Bruker,8,22,10,40,0.250000
2025-09-01,Brunswick,7,15,18,40,0.450000
2025-09-01,Builders FirstSource,20,15,5,40,0.125000
2025-09-01,Burlington Stores,16,22,2,40,0.050000
2025-09-01,CACI International,14,22,4,40,0.100000
2025-09-01,CBRE Group,17,23,0,40,0.000000
2025-09-01,CDW,19,16,5,40,0.125000
2025-09-01,CF Industries,20,13,7,40,0.175000
2025-09-01,CH Robinson Worldwide,18,15,7,40,0.175000
2025-09-01,CHS,16,19,5,40,0.125000
2025-09-01,CME Group,16,19,5,40,0.125000
2025-09-01,CMS Energy,35,3,2,40,0.050000
2025-09-01,CNO Financial Group,17,19,4,40,0.100000
2025-09-01,CNX Resources,21,11,8,40,0.200000
2025-09-01,CSX,14,14,12,40,0.300000
2025-09-01,CVS Health,18,14,8,40,0.200000
2025-09-01,Cabot Corporation,20,18,2,40,0.050000
2025-09-01,Cadence,18,22,0,40,0.000000
2025-09-01,Caesars Entertainment,34,6,0,40,0.000000
2025-09-01,Cal-Maine Foods,16,16,8,40,0.200000
2025-09-01,Caleres inc,19,14,7,40,0.175000
2025-09-01,California Resources,23,10,7,40,0.175000
2025-09-01,Calumet,14,17,9,40,0.225000
2025-09-01,Campbell Soup,16,19,5,40,0.125000
2025-09-01,Camping World,16,19,5,40,0.125000
2025-09-01,Capital One,26,10,4,40,0.100000
2025-09-01,CarMax,11,23,6,40,0.150000
2025-09-01,Cardinal Health,15,17,8,40,0.200000
2025-09-01,Carlisle Companies,14,12,14,40,0.350000
2025-09-01,Carlyle Group,15,21,4,40,0.100000
2025-09-01,Carpenter Technology,18,17,5,40,0.125000
2025-09-01,Carrier Global,16,17,7,40,0.175000
2025-09-01,Carters inc,10,22,2,34,0.058824
2025-09-01,Carvana,26,9,5,40,0.125000
2025-09-01,Caseys General Stores,12,23,5,40,0.125000
2025-09-01,Catalent,9,26,5,40,0.125000
2025-09-01,Caterpillar,12,19,9,40,0.225000
2025-09-01,Cboe Global Markets,18,17,5,40,0.125000
2025-09-01,Celanese,16,14,10,40,0.250000
2025-09-01,Cencora,20,16,4,40,0.100000
2025-09-01,Centene,14,7,19,40,0.475000
2025-09-01,CenterPoint Energy,29,6,5,40,0.125000
2025-09-01,Central Garden & Pet,10,27,3,40,0.075000
2025-09-01,Century Communities,27,11,2,40,0.050000
2025-09-01,ChampionX,20,15,5,40,0.125000
2025-09-01,Charles River Laboratories International,19,17,4,40,0.100000
2025-09-01,Charles Schwab,26,10,4,40,0.100000
2025-09-01,Chart Industries,11,23,6,40,0.150000
2025-09-01,Charter Communications,14,20,6,40,0.150000
2025-09-01,Cheesecake Factory,16,15,9,40,0.225000
2025-09-01,Chefs Warehouse,20,14,6,40,0.150000
2025-09-01,Chemours,11,17,12,40,0.300000
2025-09-01,Cheniere Energy,34,2,4,40,0.100000
2025-09-01,Chevron,17,18,5,40,0.125000
2025-09-01,Chewy,20,19,1,40,0.025000
2025-09-01,Chipotle Mexican Grill,21,18,1,40,0.025000
2025-09-01,Chord Energy,39,1,0,40,0.000000
2025-09-01,Church & Dwight,16,20,4,40,0.100000
2025-09-01,Ciena,14,21,5,40,0.125000
2025-09-01,Cigna,16,16,8,40,0.200000
2025-09-01,Cincinnati Financial,13,24,3,40,0.075000
2025-09-01,Cinemark,16,19,5,40,0.125000
2025-09-01,Cintas,22,15,3,40,0.075000
2025-09-01,Cisco Systems,13,22,5,40,0.125000
2025-09-01,Citigroup,22,12,6,40,0.150000
2025-09-01,Citizens Financial Group,20,18,2,40,0.050000
2025-09-01,Civitas Resources,18,13,9,40,0.225000
2025-09-01,Clean Harbors,39,1,0,40,0.000000
2025-09-01,Clear Channel Outdoor Hldgs,7,1,2,10,0.200000
2025-09-01,Cleveland-Cliffs,16,18,6,40,0.150000
2025-09-01,Clorox,20,13,7,40,0.175000
2025-09-01,Cognizant Technology Solutions,31,3,6,40,0.150000
2025-09-01,Coherent,20,17,3,40,0.075000
2025-09-01,Coinbase Global,12,28,0,40,0.000000
2025-09-01,Colgate-Palmolive,20,16,4,40,0.100000
2025-09-01,Columbia Banking System,16,21,3,40,0.075000
2025-09-01,Columbia Sportswear,14,21,5,40,0.125000
2025-09-01,Comcast,25,8,7,40,0.175000
2025-09-01,Comerica,17,20,3,40,0.075000
2025-09-01,Comfort Systems USA,40,0,0,40,0.000000
2025-09-01,CommScope,21,19,0,40,0.000000
2025-09-01,Commercial Metals,16,20,4,40,0.100000
2025-09-01,Community Health Systems,19,17,4,40,0.100000
2025-09-01,Compass,14,23,3,40,0.075000
2025-09-01,Conagra Brands,23,13,4,40,0.100000
2025-09-01,Concentrix,16,16,8,40,0.200000
2025-09-01,Conduent,22,17,1,40,0.025000
2025-09-01,ConocoPhillips,21,13,6,40,0.150000
2025-09-01,Consol Energy,31,5,4,40,0.100000
2025-09-01,Consolidated Edison,20,17,3,40,0.075000
2025-09-01,Constellation Brands,8,22,10,40,0.250000
2025-09-01,Constellation Energy,37,1,2,40,0.050000
2025-09-01,Continental Resources,17,15,8,40,0.200000
2025-09-01,Cooper Cos,6,30,4,40,0.100000
2025-09-01,Cooper-Standard,22,13,5,40,0.125000
2025-09-01,Copart,21,17,2,40,0.050000
2025-09-01,Core & Main,15,21,4,40,0.100000
2025-09-01,Cornerstone Building Brands,15,21,4,40,0.100000
2025-09-01,Corning,11,22,7,40,0.175000
2025-09-01,Corpay,14,23,3,40,0.075000
2025-09-01,Corteva,20,18,2,40,0.050000
2025-09-01,Costco,15,20,5,40,0.125000
2025-09-01,Coterra Energy,35,5,0,40,0.000000
2025-09-01,Coty,20,15,5,40,0.125000
2025-09-01,Country Financial,15,21,4,40,0.100000
2025-09-01,Coupang,19,21,0,40,0.000000
2025-09-01,Cracker Barrel Old Country Store,12,19,9,40,0.225000
2025-09-01,Crocs,9,25,6,40,0.150000
2025-09-01,CrossAmerica Partners,17,3,20,40,0.500000
2025-09-01,CrowdStrike,17,14,9,40,0.225000
2025-09-01,Crown Castle,14,21,5,40,0.125000
2025-09-01,Crown Holdings,21,11,8,40,0.200000
2025-09-01,Cullen Frost Bankers,24,11,5,40,0.125000
2025-09-01,Cummins,14,13,13,40,0.325000
2025-09-01,Curtiss-Wright,16,21,3,40,0.075000
2025-09-01,DR Horton,12,18,10,40,0.250000
2025-09-01,DTE Energy,35,3,2,40,0.050000
2025-09-01,DXC Technology,17,22,1,40,0.025000
2025-09-01,DaVita,10,14,16,40,0.400000
2025-09-01,Dana Incorporated,28,9,3,40,0.075000
2025-09-01,Danaher,24,13,3,40,0.075000
2025-09-01,Darden Restaurants,21,11,8,40,0.200000
2025-09-01,Darling Ingredients,39,1,0,40,0.000000
2025-09-01,Deckers Outdoor,21,15,4,40,0.100000
2025-09-01,Deere,12,24,4,40,0.100000
2025-09-01,Delek US,25,11,4,40,0.100000
2025-09-01,Dell Technologies,17,15,8,40,0.200000
2025-09-01,Delta Air Lines,10,15,15,40,0.375000
2025-09-01,Dentsply Sirona,18,19,3,40,0.075000
2025-09-01,Designer Brands,12,20,8,40,0.200000
2025-09-01,Devon Energy,39,1,0,40,0.000000
2025-09-01,DexCom,17,16,7,40,0.175000
2025-09-01,Diamondback Energy,37,2,1,40,0.025000
2025-09-01,Dicks Sporting Goods,14,23,3,40,0.075000
2025-09-01,Diebold Nixdorf,24,12,4,40,0.100000
2025-09-01,Digital Realty Trust,38,2,0,40,0.000000
2025-09-01,Dillards,18,17,5,40,0.125000
2025-09-01,DocuSign,21,16,3,40,0.075000
2025-09-01,Dollar General,14,19,7,40,0.175000
2025-09-01,Dollar Tree,14,19,7,40,0.175000
2025-09-01,Dominion Energy,33,4,3,40,0.075000
2025-09-01,Dominos Pizza inc,18,16,6,40,0.150000
2025-09-01,Domtar,9,26,5,40,0.125000
2025-09-01,Donaldson Company,22,12,6,40,0.150000
2025-09-01,DoorDash,24,10,6,40,0.150000
2025-09-01,Dover Corporation,18,19,3,40,0.075000
2025-09-01,DraftKings,23,14,3,40,0.075000
2025-09-01,Dream Finders Homes,39,1,0,40,0.000000
2025-09-01,Dropbox,15,22,3,40,0.075000
2025-09-01,DuPont,15,21,4,40,0.100000
2025-09-01,Duke Energy,40,0,0,40,0.000000
2025-09-01,Dycom Industries,12,24,4,40,0.100000
2025-09-01,EMCOR Group,18,15,7,40,0.175000
2025-09-01,EOG Resources,18,18,4,40,0.100000
2025-09-01,EPAM Systems,15,23,2,40,0.050000
2025-09-01,EQT,20,15,5,40,0.125000
2025-09-01,ESAB,13,23,4,40,0.100000
2025-09-01,East West Bancorp,25,12,3,40,0.075000
2025-09-01,Eastman Chemical,16,18,6,40,0.150000
2025-09-01,Ebay,22,8,10,40,0.250000
2025-09-01,EchoStar,15,21,4,40,0.100000
2025-09-01,Ecolab,20,14,6,40,0.150000
2025-09-01,Edison International,12,21,7,40,0.175000
2025-09-01,Edward Jones,13,22,5,40,0.125000
2025-09-01,Edwards Lifesciences,16,11,13,40,0.325000
2025-09-01,Elanco Animal Health,15,19,6,40,0.150000
2025-09-01,Electronic Arts,10,22,8,40,0.200000
2025-09-01,Elevance Health,19,6,15,40,0.375000
2025-09-01,Eli Lilly,16,14,10,40,0.250000
2025-09-01,Emerson Electric,18,17,5,40,0.125000
2025-09-01,EnLink Midstream,14,21,5,40,0.125000
2025-09-01,Encompass Health,20,15,5,40,0.125000
2025-09-01,Endeavor Group,11,24,5,40,0.125000
2025-09-01,EnerSys,21,13,6,40,0.150000
2025-09-01,Energizer,36,3,1,40,0.025000
2025-09-01,Energy Transfer,35,1,4,40,0.100000
2025-09-01,Ensign Group,23,11,6,40,0.150000
2025-09-01,Entegris,15,15,10,40,0.250000
2025-09-01,Entergy,29,9,2,40,0.050000
2025-09-01,Enterprise Products Partners,18,11,11,40,0.275000
2025-09-01,Envista,25,12,3,40,0.075000
2025-09-01,Equifax,20,15,5,40,0.125000
2025-09-01,Equinix,24,14,2,40,0.050000
2025-09-01,Equitable,20,20,0,40,0.000000
2025-09-01,Equity Residential,20,14,6,40,0.150000
2025-09-01,Erie Insurance,13,15,12,40,0.300000
2025-09-01,Estée Lauder,12,21,7,40,0.175000
2025-09-01,Etsy,19,14,7,40,0.175000
2025-09-01,Euronet Worldwide,20,14,6,40,0.150000
2025-09-01,Evergy,17,14,9,40,0.225000
2025-09-01,Eversource Energy,35,4,1,40,0.025000
2025-09-01,Exact Sciences,11,18,11,40,0.275000
2025-09-01,Exelon,20,17,3,40,0.075000
2025-09-01,Expand Energy,38,2,0,40,0.000000
2025-09-01,Expedia,23,13,4,40,0.100000
2025-09-01,Expeditors International of Washington,20,18,2,40,0.050000
2025-09-01,Extra Space Storage,17,16,7,40,0.175000
2025-09-01,Exxon Mobil,17,21,2,40,0.050000
2025-09-01,F5,17,20,3,40,0.075000
2025-09-01,FM Global,11,17,12,40,0.300000
2025-09-01,FTI Consulting,19,15,6,40,0.150000
2025-09-01,Fannie Mae,10,27,3,40,0.075000
2025-09-01,Farmers Insurance Exchange,9,18,13,40,0.325000
2025-09-01,Fastenal,19,18,3,40,0.075000
2025-09-01,FedEx,10,21,9,40,0.225000
2025-09-01,Federated Mutual Insurance,16,17,7,40,0.175000
2025-09-01,Fidelity National Financial,17,20,3,40,0.075000
2025-09-01,Fidelity National Information Services,16,19,5,40,0.125000
2025-09-01,Fifth Third Bancorp,23,16,1,40,0.025000
2025-09-01,First American Financial,14,21,5,40,0.125000
2025-09-01,First Citizens BancShares,20,15,5,40,0.125000
2025-09-01,First Horizon,16,23,1,40,0.025000
2025-09-01,First National of Nebraska,17,22,1,40,0.025000
2025-09-01,First Solar,19,14,7,40,0.175000
2025-09-01,FirstCash,14,23,3,40,0.075000
2025-09-01,FirstEnergy,16,19,5,40,0.125000
2025-09-01,Fiserv,12,24,4,40,0.100000
2025-09-01,Five Below,17,21,2,40,0.050000
2025-09-01,Flagstar Financial,24,13,3,40,0.075000
2025-09-01,Floor & Decor,17,20,3,40,0.075000
2025-09-01,Flowers Foods,12,24,4,40,0.100000
2025-09-01,Flowserve,21,18,1,40,0.025000
2025-09-01,Fluor,17,15,8,40,0.200000
2025-09-01,Ford Motor,19,16,5,40,0.125000
2025-09-01,Fortinet,13,16,11,40,0.275000
2025-09-01,Fortive,23,14,3,40,0.075000
2025-09-01,Fortune Brands Innovations,21,16,3,40,0.075000
2025-09-01,Franklin Resources,27,11,2,40,0.050000
2025-09-01,Freddie Mac,12,22,6,40,0.150000
2025-09-01,Freeport-McMoRan,23,14,3,40,0.075000
2025-09-01,Frontier Airlines,15,13,12,40,0.300000
2025-09-01,Frontier Communications,20,15,5,40,0.125000
2025-09-01,G-III Apparel Group,24,11,5,40,0.125000
2025-09-01,GE HealthCare Technologies,21,13,6,40,0.150000
2025-09-01,GMS,6,27,7,40,0.175000
2025-09-01,GXO Logistics,23,13,4,40,0.100000
2025-09-01,GameStop,11,17,12,40,0.300000
2025-09-01,Gannett,19,14,7,40,0.175000
2025-09-01,Garrett Motion inc,17,17,6,40,0.150000
2025-09-01,Gartner,9,21,10,40,0.250000
2025-09-01,Gen Digital,26,9,5,40,0.125000
2025-09-01,Generac,18,17,5,40,0.125000
2025-09-01,General Dynamics,36,3,1,40,0.025000
2025-09-01,General Electric,21,13,6,40,0.150000
2025-09-01,General Mills,21,15,4,40,0.100000
2025-09-01,General Motors,21,14,5,40,0.125000
2025-09-01,Genesis Energy,34,2,4,40,0.100000
2025-09-01,Genuine Parts,19,14,7,40,0.175000
2025-09-01,Genworth Financial,14,21,5,40,0.125000
2025-09-01,Gilead Sciences,22,15,3,40,0.075000
2025-09-01,Global Partners,14,19,7,40,0.175000
2025-09-01,Global Payments,17,19,4,40,0.100000
2025-09-01,Globe Life,24,13,3,40,0.075000
2025-09-01,GoDaddy,20,15,5,40,0.125000
2025-09-01,Goldman Sachs,20,17,3,40,0.075000
2025-09-01,Goodyear Tire & Rubber,15,20,5,40,0.125000
2025-09-01,Graham Holdings Company,18,16,6,40,0.150000
2025-09-01,Granite Construction,21,15,4,40,0.100000
2025-09-01,Graphic Packaging,14,18,8,40,0.200000
2025-09-01,Gray Television,12,21,7,40,0.175000
2025-09-01,Graybar Electric,15,20,5,40,0.125000
2025-09-01,Green Plains inc,21,13,6,40,0.150000
2025-09-01,Greenbrier,16,20,4,40,0.100000
2025-09-01,Greif,14,18,8,40,0.200000
2025-09-01,Griffon Corporation,19,17,4,40,0.100000
2025-09-01,Grocery Outlet Holding,15,19,6,40,0.150000
2025-09-01,Group 1 Automotive,18,19,3,40,0.075000
2025-09-01,Guardian Life insurance,18,22,0,40,0.000000
2025-09-01,Guess inc,22,16,2,40,0.050000
2025-09-01,H B Fuller,17,18,5,40,0.125000
2025-09-01,HCA Healthcare,19,15,6,40,0.150000
2025-09-01,HEICO,15,20,5,40,0.125000
2025-09-01,HF Sinclair,18,18,4,40,0.100000
2025-09-01,Halliburton,21,15,4,40,0.100000
2025-09-01,Hanesbrands,12,21,7,40,0.175000
2025-09-01,Hanover Insurance Group,18,15,7,40,0.175000
2025-09-01,Harley-Davidson,21,15,4,40,0.100000
2025-09-01,Hasbro,16,18,6,40,0.150000
2025-09-01,Hawaiian Airlines inc,17,23,0,40,0.000000
2025-09-01,Hawaiian Electric Industries,19,17,4,40,0.100000
2025-09-01,Helmerich & Payne,15,24,1,40,0.025000
2025-09-01,Henry Schein,19,16,5,40,0.125000
2025-09-01,Herc Rentals,17,17,6,40,0.150000
2025-09-01,Hershey,22,15,3,40,0.075000
2025-09-01,Hertz,15,11,14,40,0.350000
2025-09-01,Hewlett Packard,17,20,3,40,0.075000
2025-09-01,Hewlett Packard Enterprise,17,23,0,40,0.000000
2025-09-01,Hillenbrand,18,20,2,40,0.050000
2025-09-01,Hilton Grand Vacations,39,0,1,40,0.025000
2025-09-01,Hilton Worldwide,18,16,6,40,0.150000
2025-09-01,Hologic,13,18,9,40,0.225000
2025-09-01,Home Depot,13,15,12,40,0.300000
2025-09-01,Honeywell,19,16,5,40,0.125000
2025-09-01,Hormel Foods,12,15,13,40,0.325000
2025-09-01,Host Hotels & Resorts,14,24,2,40,0.050000
2025-09-01,Hovnanian Enterprises,22,11,7,40,0.175000
2025-09-01,Howmet Aerospace,18,20,2,40,0.050000
2025-09-01,Hub Group,18,18,4,40,0.100000
2025-09-01,Hubbell,21,13,6,40,0.150000
2025-09-01,Humana,22,15,3,40,0.075000
2025-09-01,Huntington Bancshares,20,19,1,40,0.025000
2025-09-01,Huntington Ingalls Industries,16,19,5,40,0.125000
2025-09-01,Huntsman,14,16,10,40,0.250000
2025-09-01,Hyatt Hotels,26,11,3,40,0.075000
2025-09-01,Hyster-Yale,21,15,4,40,0.100000
2025-09-01,IAC,14,19,7,40,0.175000
2025-09-01,IBM,13,22,5,40,0.125000
2025-09-01,IDEX,22,11,7,40,0.175000
2025-09-01,IDEXX Laboratories,18,16,6,40,0.150000
2025-09-01,IQVIA,25,11,4,40,0.100000
2025-09-01,ITT,16,21,3,40,0.075000
2025-09-01,Icahn Enterprises,22,9,9,40,0.225000
2025-09-01,Illinois Tool Works,14,20,6,40,0.150000
2025-09-01,Illumina inc,22,13,5,40,0.125000
2025-09-01,Incyte,19,15,6,40,0.150000
2025-09-01,Ingersoll Rand,24,13,3,40,0.075000
2025-09-01,Ingles Markets,17,17,6,40,0.150000
2025-09-01,Ingram Micro,11,16,13,40,0.325000
2025-09-01,Ingredion,25,13,2,40,0.050000
2025-09-01,Insight Enterprises,18,15,7,40,0.175000
2025-09-01,Insperity,17,16,7,40,0.175000
2025-09-01,Instacart,22,15,3,40,0.075000
2025-09-01,Installed Building Products,12,24,4,40,0.100000
2025-09-01,Intel,11,19,10,40,0.250000
2025-09-01,Interactive Brokers,13,22,5,40,0.125000
2025-09-01,Intercontinental Exchange,17,19,4,40,0.100000
2025-09-01,International Flavors & Fragrances,18,15,7,40,0.175000
2025-09-01,International Paper,5,30,5,40,0.125000
2025-09-01,Interpublic Group,20,16,4,40,0.100000
2025-09-01,Intuit,23,13,4,40,0.100000
2025-09-01,Intuitive Surgical,15,13,12,40,0.300000
2025-09-01,Iron Mountain,12,21,7,40,0.175000
2025-09-01,JB Hunt Transport Services,15,17,8,40,0.200000
2025-09-01,JELD-WEN Holding,21,15,4,40,0.100000
2025-09-01,JM Smucker,13,17,10,40,0.250000
2025-09-01,JPMorgan Chase,22,15,3,40,0.075000
2025-09-01,Jabil,17,16,7,40,0.175000
2025-09-01,Jackson Financial,18,20,2,40,0.050000
2025-09-01,Jacobs Solutions,37,0,3,40,0.075000
2025-09-01,Jefferies Financial,21,16,3,40,0.075000
2025-09-01,JetBlue Airways,20,15,5,40,0.125000
2025-09-01,Johnson & Johnson,13,16,11,40,0.275000
2025-09-01,Jones Lang LaSalle,13,17,10,40,0.250000
2025-09-01,Juniper Networks,12,26,2,40,0.050000
2025-09-01,KB Home,24,11,5,40,0.125000
2025-09-01,KBR,28,10,2,40,0.050000
2025-09-01,KKR,21,16,3,40,0.075000
2025-09-01,KLA,16,18,6,40,0.150000
2025-09-01,Kaiser Aluminum,22,10,8,40,0.200000
2025-09-01,Kellanova,23,11,6,40,0.150000
2025-09-01,Kelly Services inc,20,12,8,40,0.200000
2025-09-01,Kemper,17,12,11,40,0.275000
2025-09-01,Keurig Dr Pepper,9,28,3,40,0.075000
2025-09-01,KeyCorp,25,11,4,40,0.100000
2025-09-01,Keysight Technologies,28,9,3,40,0.075000
2025-09-01,Kimberly-Clark,14,18,8,40,0.200000
2025-09-01,Kinder Morgan,40,0,0,40,0.000000
2025-09-01,Kirby Corporation,21,15,4,40,0.100000
2025-09-01,Knife River Corporation,16,19,5,40,0.125000
2025-09-01,Knight Swift Transportation,26,6,8,40,0.200000
2025-09-01,Kohls,17,10,13,40,0.325000
2025-09-01,Kontoor Brands,22,13,5,40,0.125000
2025-09-01,Korn Ferry,18,10,12,40,0.300000
2025-09-01,Kraft Heinz,17,19,4,40,0.100000
2025-09-01,Kroger,3,27,10,40,0.250000
2025-09-01,Kyndryl,18,19,3,40,0.075000
2025-09-01,L3Harris Technologies,19,14,7,40,0.175000
2025-09-01,LCI Industries,14,20,6,40,0.150000
2025-09-01,LKQ,24,12,4,40,0.100000
2025-09-01,LPL Financial,25,10,5,40,0.125000
2025-09-01,Labcorp Holdings,20,19,1,40,0.025000
2025-09-01,Lam Research,23,13,4,40,0.100000
2025-09-01,Lamb Weston,21,14,5,40,0.125000
2025-09-01,Land O'Lakes,10,24,6,40,0.150000
2025-09-01,Landstar System,22,12,6,40,0.150000
2025-09-01,Las Vegas Sands,16,21,3,40,0.075000
2025-09-01,Lear Corporation,18,17,5,40,0.125000
2025-09-01,Leggett & Platt,21,18,1,40,0.025000
2025-09-01,Leidos,27,12,1,40,0.025000
2025-09-01,Lennar,13,24,3,40,0.075000
2025-09-01,Lennox International,20,16,4,40,0.100000
2025-09-01,Levi Strauss,16,23,1,40,0.025000
2025-09-01,Liberty Energy,40,0,0,40,0.000000
2025-09-01,Liberty Media,39,1,0,40,0.000000
2025-09-01,Liberty Mutual Insurance,34,2,4,40,0.100000
2025-09-01,Light & Wonder,11,27,2,40,0.050000
2025-09-01,Lincoln Electric,17,16,7,40,0.175000
2025-09-01,Lincoln National,18,13,9,40,0.225000
2025-09-01,Lithia Motors,18,16,6,40,0.150000
2025-09-01,Live Nation Entertainment,31,6,3,40,0.075000
2025-09-01,Lockheed Martin,22,13,5,40,0.125000
2025-09-01,Loews,19,14,7,40,0.175000
2025-09-01,Louisiana-Pacific Corporation,20,12,8,40,0.200000
2025-09-01,Lowes,14,22,4,40,0.100000
2025-09-01,Lululemon athletica,14,19,7,40,0.175000
2025-09-01,Lumen Technologies,13,24,3,40,0.075000
2025-09-01,Lyft,17,15,8,40,0.200000
2025-09-01,M&T Bank,17,18,5,40,0.125000
2025-09-01,M/I Homes,18,18,4,40,0.100000
2025-09-01,MDU Resources Group,20,15,5,40,0.125000
2025-09-01,MGM Resorts International,21,16,3,40,0.075000
2025-09-01,MKS Instruments,12,22,6,40,0.150000
2025-09-01,MRC Global,20,15,5,40,0.125000
2025-09-01,MSC Industrial Direct,25,13,2,40,0.050000
2025-09-01,MSCI,29,11,0,40,0.000000
2025-09-01,MYR Group,7,24,9,40,0.225000
2025-09-01,Macys,15,22,3,40,0.075000
2025-09-01,ManpowerGroup,23,13,4,40,0.100000
2025-09-01,Marathon Oil,15,20,5,40,0.125000
2025-09-01,Marathon Petroleum,20,14,6,40,0.150000
2025-09-01,Markel Group,29,6,5,40,0.125000
2025-09-01,Marriott International,19,19,2,40,0.050000
2025-09-01,Marriott Vacations Worldwide,25,12,3,40,0.075000
2025-09-01,Marsh & McLennan,18,17,5,40,0.125000
2025-09-01,Martin Marietta Materials,14,20,6,40,0.150000
2025-09-01,Marvell Technology,11,18,11,40,0.275000
2025-09-01,MasTec,20,16,4,40,0.100000
2025-09-01,Masco,18,13,9,40,0.225000
2025-09-01,Mass Mutual,11,25,4,40,0.100000
2025-09-01,MasterBrand,17,18,5,40,0.125000
2025-09-01,Mastercard,11,22,7,40,0.175000
2025-09-01,Matador Resources,18,13,9,40,0.225000
2025-09-01,Match Group,15,11,14,40,0.350000
2025-09-01,Mativ,14,16,10,40,0.250000
2025-09-01,Matson inc,26,9,5,40,0.125000
2025-09-01,Mattel,18,13,9,40,0.225000
2025-09-01,Maximus,17,20,3,40,0.075000
2025-09-01,McCormick & Company,20,17,3,40,0.075000
2025-09-01,McDonalds,9,19,12,40,0.300000
2025-09-01,McKesson,19,18,3,40,0.075000
2025-09-01,Medical Mutual of Ohio,14,20,6,40,0.150000
2025-09-01,Merck,13,19,8,40,0.200000
2025-09-01,Mercury General,17,19,4,40,0.100000
2025-09-01,Meritage Homes,20,16,4,40,0.100000
2025-09-01,MetLife,20,13,7,40,0.175000
2025-09-01,Meta,17,18,5,40,0.125000
2025-09-01,Mettler-Toledo International,22,16,2,40,0.050000
2025-09-01,Microchip Technology,19,18,3,40,0.075000
2025-09-01,Micron Technology,13,20,7,40,0.175000
2025-09-01,Microsoft,11,12,17,40,0.425000
2025-09-01,Middleby,24,11,5,40,0.125000
2025-09-01,MillerKnoll,20,16,4,40,0.100000
2025-09-01,Moderna,20,8,12,40,0.300000
2025-09-01,ModivCare,18,14,8,40,0.200000
2025-09-01,Mohawk Industries,23,13,4,40,0.100000
2025-09-01,Molina Healthcare,13,16,11,40,0.275000
2025-09-01,Molson Coors Beverage,20,14,6,40,0.150000
2025-09-01,Mondelez,17,16,7,40,0.175000
2025-09-01,Monster Beverage,21,15,4,40,0.100000
2025-09-01,Moodys Corporation,3,11,2,16,0.125000
2025-09-01,Moog inc,17,16,7,40,0.175000
2025-09-01,Morgan Stanley,17,14,9,40,0.225000
2025-09-01,Mosaic,15,19,6,40,0.150000
2025-09-01,Motorola Solutions,37,1,2,40,0.050000
2025-09-01,Mueller Industries,22,13,5,40,0.125000
2025-09-01,Murphy Oil,19,12,9,40,0.225000
2025-09-01,Murphy USA,18,18,4,40,0.100000
2025-09-01,Mutual of Omaha,17,19,4,40,0.100000
2025-09-01,NCR Atleos,18,20,2,40,0.050000
2025-09-01,NCR Voyix,21,13,6,40,0.150000
2025-09-01,NGL Energy Partners,36,2,2,40,0.050000
2025-09-01,NLV Financial,4,4,2,10,0.200000
2025-09-01,NOV,10,23,7,40,0.175000
2025-09-01,NRG Energy,32,1,7,40,0.175000
2025-09-01,NVR,17,16,7,40,0.175000
2025-09-01,Nasdaq,13,17,10,40,0.250000
2025-09-01,Nationwide,13,12,15,40,0.375000
2025-09-01,Navient,20,16,4,40,0.100000
2025-09-01,NetApp,18,15,7,40,0.175000
2025-09-01,Netflix,9,17,14,40,0.350000
2025-09-01,NeueHealth,21,16,3,40,0.075000
2025-09-01,New York Life Insurance,15,23,2,40,0.050000
2025-09-01,NewMarket Corporation,18,16,6,40,0.150000
2025-09-01,Newell Brands,16,20,4,40,0.100000
2025-09-01,Newmont,12,19,9,40,0.225000
2025-09-01,News Corp,18,14,8,40,0.200000
2025-09-01,Nexstar Media Group,22,17,1,40,0.025000
2025-09-01,NextEra Energy,30,7,3,40,0.075000
2025-09-01,NiSource,19,12,9,40,0.225000
2025-09-01,Nike,13,16,11,40,0.275000
2025-09-01,Nordson,17,18,5,40,0.125000
2025-09-01,Nordstrom,15,19,6,40,0.150000
2025-09-01,Norfolk Southern,13,14,13,40,0.325000
2025-09-01,Northern Trust,39,1,0,40,0.000000
2025-09-01,Northrop Grumman,18,18,4,40,0.100000
2025-09-01,Northwestern Mutual,37,3,0,40,0.000000
2025-09-01,Nucor,13,25,2,40,0.050000
2025-09-01,Nvidia,8,18,14,40,0.350000
2025-09-01,O'Reilly Automotive,20,13,7,40,0.175000
2025-09-01,O-I Glass,18,18,4,40,0.100000
2025-09-01,ODP Business Solutions,22,17,1,40,0.025000
2025-09-01,OGE Energy,34,5,1,40,0.025000
2025-09-01,ON Semiconductor,9,26,5,40,0.125000
2025-09-01,Occidental Petroleum,15,18,7,40,0.175000
2025-09-01,Old Dominion Freight Line,21,15,4,40,0.100000
2025-09-01,Old National Bancorp,13,21,6,40,0.150000
2025-09-01,Old Republic International,25,12,3,40,0.075000
2025-09-01,Olin,17,16,7,40,0.175000
2025-09-01,Omnicom Group,15,18,7,40,0.175000
2025-09-01,OneMain,23,14,3,40,0.075000
2025-09-01,Oneok,26,11,3,40,0.075000
2025-09-01,Opendoor Technologies,10,23,7,40,0.175000
2025-09-01,Option Care Health,40,0,0,40,0.000000
2025-09-01,Oracle,11,22,7,40,0.175000
2025-09-01,Organon,8,24,8,40,0.200000
2025-09-01,Oscar Health,14,17,9,40,0.225000
2025-09-01,Oshkosh,16,13,11,40,0.275000
2025-09-01,Otis Worldwide,25,11,4,40,0.100000
2025-09-01,Ovintiv,26,6,8,40,0.200000
2025-09-01,Owens & Minor,10,19,11,40,0.275000
2025-09-01,Owens Corning,22,15,3,40,0.075000
2025-09-01,PACS Group,22,12,6,40,0.150000
2025-09-01,PBF Energy,32,8,0,40,0.000000
2025-09-01,PC Connection Inc,23,15,2,40,0.050000
2025-09-01,PENN Entertainment,37,2,1,40,0.025000
2025-09-01,PG&E,12,15,13,40,0.325000
2025-09-01,PNC Financial Services,26,12,2,40,0.050000
2025-09-01,PPG Industries,18,19,3,40,0.075000
2025-09-01,PPL,22,16,2,40,0.050000
2025-09-01,PVH,15,22,3,40,0.075000
2025-09-01,Paccar,23,8,9,40,0.225000
2025-09-01,Pacific Life,16,23,1,40,0.025000
2025-09-01,Packaging Corp of America,9,27,4,40,0.100000
2025-09-01,Palo Alto Networks,14,19,7,40,0.175000
2025-09-01,Par Pacific,22,15,3,40,0.075000
2025-09-01,Paramount Global,9,26,5,40,0.125000
2025-09-01,Park Hotels & Resorts,13,23,4,40,0.100000
2025-09-01,Parker-Hannifin,23,13,4,40,0.100000
2025-09-01,Parsons Corporation,25,10,5,40,0.125000
2025-09-01,Patrick Industries,18,19,3,40,0.075000
2025-09-01,Patterson Companies Inc,10,26,4,40,0.100000
2025-09-01,Patterson-UTI Energy,29,6,5,40,0.125000
2025-09-01,PayPal,13,13,14,40,0.350000
2025-09-01,Paychex,14,22,4,40,0.100000
2025-09-01,Peabody Energy,32,5,3,40,0.075000
2025-09-01,Peloton,20,12,8,40,0.200000
2025-09-01,Penn Mutual Life Insurance,18,19,3,40,0.075000
2025-09-01,PennyMac Financial Services,25,11,4,40,0.100000
2025-09-01,Penske Automotive,15,22,3,40,0.075000
2025-09-01,PepsiCo,25,11,4,40,0.100000
2025-09-01,Performance Food,17,21,2,40,0.050000
2025-09-01,Permian Resources,21,14,5,40,0.125000
2025-09-01,Petco Health and Wellness,35,5,0,40,0.000000
2025-09-01,Peter Kiewit Sons',5,22,13,40,0.325000
2025-09-01,Pfizer,17,17,6,40,0.150000
2025-09-01,Philip Morris,20,12,8,40,0.200000
2025-09-01,Phillips 66,17,16,7,40,0.175000
2025-09-01,Pinnacle West Capital,19,15,6,40,0.150000
2025-09-01,Pinterest,17,20,3,40,0.075000
2025-09-01,Pioneer Natural Resources,19,9,12,40,0.300000
2025-09-01,Pitney Bowes,26,9,5,40,0.125000
2025-09-01,Plains GP,20,9,11,40,0.275000
2025-09-01,Playtika Holding,15,19,6,40,0.150000
2025-09-01,Plexus,3,23,14,40,0.350000
2025-09-01,Polaris Inc,16,18,6,40,0.150000
2025-09-01,Pool Corporation,21,14,5,40,0.125000
2025-09-01,Popular inc,38,2,0,40,0.000000
2025-09-01,Portland General Electric,21,15,4,40,0.100000
2025-09-01,Post Holdings,19,21,0,40,0.000000
2025-09-01,PriceSmart,21,16,3,40,0.075000
2025-09-01,Primerica,17,19,4,40,0.100000
2025-09-01,Primoris Services,18,19,3,40,0.075000
2025-09-01,Principal Financial,16,20,4,40,0.100000
2025-09-01,ProFrac Holding,14,25,1,40,0.025000
2025-09-01,Procter & Gamble,14,21,5,40,0.125000
2025-09-01,Progressive Insurance,17,20,3,40,0.075000
2025-09-01,Prologis,17,20,3,40,0.075000
2025-09-01,Prudential Financial,21,13,6,40,0.150000
2025-09-01,Public Service Enterprise Group,22,15,3,40,0.075000
2025-09-01,Public Storage,16,22,2,40,0.050000
2025-09-01,Publix Super Markets,19,16,5,40,0.125000
2025-09-01,Puget Sound Energy,28,10,2,40,0.050000
2025-09-01,PulteGroup,30,5,5,40,0.125000
2025-09-01,Pure Storage,13,20,7,40,0.175000
2025-09-01,QVC,16,20,4,40,0.100000
2025-09-01,Qorvo,18,19,3,40,0.075000
2025-09-01,Quad/Graphics,16,15,9,40,0.225000
2025-09-01,Qualcomm,14,19,7,40,0.175000
2025-09-01,Quanta Services,24,12,4,40,0.100000
2025-09-01,Quest Diagnostics,14,24,2,40,0.050000
2025-09-01,QuidelOrtho,16,19,5,40,0.125000
2025-09-01,REV Group,17,19,4,40,0.100000
2025-09-01,RPM International,16,19,5,40,0.125000
2025-09-01,RTX,21,15,4,40,0.100000
2025-09-01,RXO inc,18,16,6,40,0.150000
2025-09-01,Rackspace Technology,23,10,7,40,0.175000
2025-09-01,Radius Recycling,15,12,13,40,0.325000
2025-09-01,Ralph Lauren,30,6,4,40,0.100000
2025-09-01,Range Resources,19,17,4,40,0.100000
2025-09-01,Raymond James Financial,24,16,0,40,0.000000
2025-09-01,Realty Income,16,18,6,40,0.150000
2025-09-01,Regal Rexnord,20,18,2,40,0.050000
2025-09-01,Regeneron Pharmaceuticals,21,17,2,40,0.050000
2025-09-01,Regions Financial,24,14,2,40,0.050000
2025-09-01,Reinsurance Group of America,20,14,6,40,0.150000
2025-09-01,Reliance Inc,25,10,5,40,0.125000
2025-09-01,Republic Services,20,10,10,40,0.250000
2025-09-01,ResMed,17,17,6,40,0.150000
2025-09-01,Resideo Technologies,22,14,4,40,0.100000
2025-09-01,Restoration Hardware,12,23,5,40,0.125000
2025-09-01,Revvity,21,12,7,40,0.175000
2025-09-01,Rite Aid,10,27,3,40,0.075000
2025-09-01,Rithm Capital,14,23,3,40,0.075000
2025-09-01,Rivian Automotive,14,20,6,40,0.150000
2025-09-01,Robert Half,24,14,2,40,0.050000
2025-09-01,Roblox,12,12,16,40,0.400000
2025-09-01,Rocket Companies,24,16,0,40,0.000000
2025-09-01,Rockwell Automation,20,16,4,40,0.100000
2025-09-01,Roku,19,15,6,40,0.150000
2025-09-01,Rollins inc,19,19,2,40,0.050000
2025-09-01,Roper Technologies,18,18,4,40,0.100000
2025-09-01,Ross Stores,18,17,5,40,0.125000
2025-09-01,Rush Enterprises,24,13,3,40,0.075000
2025-09-01,Ryder System,19,17,4,40,0.100000
2025-09-01,Ryerson Holding,16,12,12,40,0.300000
2025-09-01,S&P Global,8,30,2,40,0.050000
2025-09-01,SBA Communications,18,18,4,40,0.100000
2025-09-01,SS&C Technologies,22,15,3,40,0.075000
2025-09-01,Sabre Corporation,16,17,7,40,0.175000
2025-09-01,Saia inc,21,15,4,40,0.100000
2025-09-01,Salesforce,9,18,13,40,0.325000
2025-09-01,Sallie Mae,15,22,3,40,0.075000
2025-09-01,Sally Beauty,39,0,1,40,0.025000
2025-09-01,Sanmina,18,18,4,40,0.100000
2025-09-01,ScanSource,22,10,8,40,0.200000
2025-09-01,Schneider National,19,14,7,40,0.175000
2025-09-01,Science Applications International,21,15,4,40,0.100000
2025-09-01,Scotts Miracle-Gro,37,1,2,40,0.050000
2025-09-01,Seaboard,26,7,7,40,0.175000
2025-09-01,Sealed Air Corporation,18,20,2,40,0.050000
2025-09-01,Securian Financial,10,25,5,40,0.125000
2025-09-01,Select Medical,25,8,7,40,0.175000
2025-09-01,Selective Insurance Group,27,12,1,40,0.025000
2025-09-01,Sempra,20,20,0,40,0.000000
2025-09-01,Sentry Insurance Group,3,7,0,10,0.000000
2025-09-01,Service Corp International,10,9,7,26,0.269231
2025-09-01,ServiceNow,19,20,1,40,0.025000
2025-09-01,Sherwin-Williams,17,18,5,40,0.125000
2025-09-01,Shift4 Payments,15,20,5,40,0.125000
2025-09-01,Silgan,17,16,7,40,0.175000
2025-09-01,Simon Property Group,14,20,6,40,0.150000
2025-09-01,Sinclair,14,18,8,40,0.200000
2025-09-01,SiteOne Landscape Supply,17,20,3,40,0.075000
2025-09-01,Skechers USA,15,19,6,40,0.150000
2025-09-01,SkyWest,7,23,10,40,0.250000
2025-09-01,Skyline Champion,33,4,3,40,0.075000
2025-09-01,Skyworks Solutions,31,2,7,40,0.175000
2025-09-01,Smurfit Westrock,12,24,4,40,0.100000
2025-09-01,Snap Inc,14,9,17,40,0.425000
2025-09-01,Snap-on,15,21,4,40,0.100000
2025-09-01,Snowflake inc,24,14,2,40,0.050000
2025-09-01,Sonic Automotive,19,17,4,40,0.100000
2025-09-01,Sonoco Products,25,13,2,40,0.050000
2025-09-01,Southern Company,26,10,4,40,0.100000
2025-09-01,Southwest Airlines,9,21,10,40,0.250000
2025-09-01,Southwest Gas,22,14,4,40,0.100000
2025-09-01,Southwestern Energy,35,2,3,40,0.075000
2025-09-01,SpartanNash,16,22,2,40,0.050000
2025-09-01,Spectrum Brands,18,16,6,40,0.150000
2025-09-01,Spire inc,18,15,7,40,0.175000
2025-09-01,Spirit AeroSystems,34,1,5,40,0.125000
2025-09-01,Spirit Airlines,32,0,8,40,0.200000
2025-09-01,Splunk,14,16,10,40,0.250000
2025-09-01,Sprouts Farmers Market,12,25,3,40,0.075000
2025-09-01,Stagwell,19,19,2,40,0.050000
2025-09-01,Stanley Black & Decker,14,18,8,40,0.200000
2025-09-01,Starbucks,19,17,4,40,0.100000
2025-09-01,State Farm Insurance,14,18,8,40,0.200000
2025-09-01,State Street,13,21,6,40,0.150000
2025-09-01,Steel Dynamics,34,4,2,40,0.050000
2025-09-01,Steelcase,19,20,1,40,0.025000
2025-09-01,Stericycle,12,8,20,40,0.500000
2025-09-01,Stifel Financial,23,14,3,40,0.075000
2025-09-01,StoneX,19,18,3,40,0.075000
2025-09-01,Stryker,15,13,12,40,0.300000
2025-09-01,Summit Materials,9,28,3,40,0.075000
2025-09-01,Sun Communities,21,15,4,40,0.100000
2025-09-01,Super Micro Computer,34,5,1,40,0.025000
2025-09-01,Surgery Partners,16,18,6,40,0.150000
2025-09-01,Sylvamo,15,18,7,40,0.175000
2025-09-01,Synchrony Financial,21,15,4,40,0.100000
2025-09-01,Synopsys,14,19,7,40,0.175000
2025-09-01,Synovus Financial,25,10,5,40,0.125000
2025-09-01,Sysco,17,14,9,40,0.225000
2025-09-01,T Rowe Price,21,16,3,40,0.075000
2025-09-01,TD Synnex,23,9,8,40,0.200000
2025-09-01,TEGNA,10,26,4,40,0.100000
2025-09-01,TIAA,12,26,2,40,0.050000
2025-09-01,TJX,21,14,5,40,0.125000
2025-09-01,Take-Two Interactive Software,25,15,0,40,0.000000
2025-09-01,Talen Energy,34,4,2,40,0.050000
2025-09-01,Tapestry,13,20,7,40,0.175000
2025-09-01,Targa Resources,15,15,10,40,0.250000
2025-09-01,Target,4,23,13,40,0.325000
2025-09-01,Taylor Morrison Home,10,24,6,40,0.150000
2025-09-01,Teladoc Health,21,11,8,40,0.200000
2025-09-01,Teledyne Technologies,16,16,8,40,0.200000
2025-09-01,Teleflex,14,21,5,40,0.125000
2025-09-01,Telephone & Data Systems,15,19,6,40,0.150000
2025-09-01,TelevisaUnivision,18,17,5,40,0.125000
2025-09-01,Tempur Sealy International,10,25,5,40,0.125000
2025-09-01,Tenet Healthcare,17,16,7,40,0.175000
2025-09-01,Teradyne,15,16,9,40,0.225000
2025-09-01,Terex,14,21,5,40,0.125000
2025-09-01,Tesla,6,14,20,40,0.500000
2025-09-01,Tetra Tech,18,18,4,40,0.100000
2025-09-01,Texas Instruments,13,18,9,40,0.225000
2025-09-01,Texas Roadhouse,16,20,4,40,0.100000
2025-09-01,Textron,17,18,5,40,0.125000
2025-09-01,The Andersons Inc,15,19,6,40,0.150000
2025-09-01,The Coca-Cola Company,9,25,6,40,0.150000
2025-09-01,The Hartford,10,19,11,40,0.275000
2025-09-01,Thermo Fisher Scientific,17,17,6,40,0.150000
2025-09-01,Thor Industries,16,13,11,40,0.275000
2025-09-01,Thrivent Financial for Lutherans,16,21,3,40,0.075000
2025-09-01,Timken,14,23,3,40,0.075000
2025-09-01,Titan Machinery,15,18,7,40,0.175000
2025-09-01,Toast inc,19,19,2,40,0.050000
2025-09-01,Toll Brothers,12,25,3,40,0.075000
2025-09-01,TopBuild,19,15,6,40,0.150000
2025-09-01,Topgolf Callaway Brands,17,14,9,40,0.225000
2025-09-01,Toro Company,19,15,6,40,0.150000
2025-09-01,Tractor Supply,18,17,5,40,0.125000
2025-09-01,TransDigm,19,18,3,40,0.075000
2025-09-01,TransUnion,15,15,10,40,0.250000
2025-09-01,Travelers Insurance,13,19,8,40,0.200000
2025-09-01,TreeHouse Foods,14,18,8,40,0.200000
2025-09-01,Tri Pointe Homes,22,16,2,40,0.050000
2025-09-01,TriNet Group,18,15,7,40,0.175000
2025-09-01,Trimble,5,31,4,40,0.100000
2025-09-01,Trinity Industries,25,11,4,40,0.100000
2025-09-01,Truist Financial,23,12,5,40,0.125000
2025-09-01,Tutor Perini Corporation,22,12,6,40,0.150000
2025-09-01,Twilio,20,16,4,40,0.100000
2025-09-01,Tyson Foods,17,20,3,40,0.075000
2025-09-01,U-Haul,7,17,16,40,0.400000
2025-09-01,UFP Industries,20,15,5,40,0.125000
2025-09-01,UGI Utilities Inc,18,17,5,40,0.125000
2025-09-01,UL Solutions,35,0,5,40,0.125000
2025-09-01,UPS,14,17,9,40,0.225000
2025-09-01,US Bancorp,16,23,1,40,0.025000
2025-09-01,US Foods,23,14,3,40,0.075000
2025-09-01,USAA,16,13,11,40,0.275000
2025-09-01,Uber,18,10,12,40,0.300000
2025-09-01,Ulta Beauty,38,1,1,40,0.025000
2025-09-01,Under Armour,21,13,6,40,0.150000
2025-09-01,Union Pacific,17,16,7,40,0.175000
2025-09-01,United Airlines,30,4,6,40,0.150000
2025-09-01,United Natural Foods,39,0,1,40,0.025000
2025-09-01,United Rentals,40,0,0,40,0.000000
2025-09-01,United States Steel,34,5,1,40,0.025000
2025-09-01,UnitedHealth,15,19,6,40,0.150000
2025-09-01,Universal Corporation,18,18,4,40,0.100000
2025-09-01,Universal Health Services,14,19,7,40,0.175000
2025-09-01,Unum Group,19,16,5,40,0.125000
2025-09-01,Upbound Group,24,12,4,40,0.100000
2025-09-01,Urban Outfitters,20,16,4,40,0.100000
2025-09-01,V2X,21,17,2,40,0.050000
2025-09-01,VF Corporation,30,8,2,40,0.050000
2025-09-01,VICI Properties,20,15,5,40,0.125000
2025-09-01,Vail Resorts,12,16,12,40,0.300000
2025-09-01,Valero Energy,38,2,0,40,0.000000
2025-09-01,Valley National Bancorp,21,17,2,40,0.050000
2025-09-01,Valmont Industries,25,14,1,40,0.025000
2025-09-01,Valvoline inc,18,20,2,40,0.050000
2025-09-01,Ventas inc,25,11,4,40,0.100000
2025-09-01,Verisk Analytics,15,15,10,40,0.250000
2025-09-01,Verizon,13,15,12,40,0.300000
2025-09-01,Vertex Pharmaceuticals,18,10,12,40,0.300000
2025-09-01,Vertiv,19,19,2,40,0.050000
2025-09-01,Viasat,22,16,2,40,0.050000
2025-09-01,Viatris,15,21,4,40,0.100000
2025-09-01,Victorias Secret,13,16,11,40,0.275000
2025-09-01,Visa,11,15,14,40,0.350000
2025-09-01,Vishay Intertechnology,20,14,6,40,0.150000
2025-09-01,Vista Outdoor,14,22,4,40,0.100000
2025-09-01,Visteon,20,16,4,40,0.100000
2025-09-01,Vistra,22,13,5,40,0.125000
2025-09-01,Vontier,16,19,5,40,0.125000
2025-09-01,Voya Financial,19,16,5,40,0.125000
2025-09-01,Vulcan Materials,18,17,5,40,0.125000
2025-09-01,WEC Energy,32,4,4,40,0.100000
2025-09-01,WESCO International,26,13,1,40,0.025000
2025-09-01,WEX,16,17,7,40,0.175000
2025-09-01,WR Berkley,16,20,4,40,0.100000
2025-09-01,WW Grainger,14,19,7,40,0.175000
2025-09-01,Wabash National,14,20,6,40,0.150000
2025-09-01,Walgreens,5,29,6,40,0.150000
2025-09-01,Walmart,12,15,13,40,0.325000
2025-09-01,Walt Disney,20,19,1,40,0.025000
2025-09-01,Warner Bros Discovery,12,22,6,40,0.150000
2025-09-01,Warner Music Group,13,25,2,40,0.050000
2025-09-01,Waters Corporation,18,11,11,40,0.275000
2025-09-01,Watsco,19,18,3,40,0.075000
2025-09-01,Wayfair,19,20,1,40,0.025000
2025-09-01,Webster Financial,23,11,6,40,0.150000
2025-09-01,Weis Markets,16,17,7,40,0.175000
2025-09-01,Wells Fargo,30,6,4,40,0.100000
2025-09-01,Welltower,32,7,1,40,0.025000
2025-09-01,Werner Enterprises,23,13,4,40,0.100000
2025-09-01,West Pharmaceutical Services,26,9,5,40,0.125000
2025-09-01,Western & Southern Financial,15,22,3,40,0.075000
2025-09-01,Western Alliance Bancorp,16,16,8,40,0.200000
2025-09-01,Western Digital,25,14,1,40,0.025000
2025-09-01,Western Midstream Partners,12,6,22,40,0.550000
2025-09-01,Western Union,13,24,3,40,0.075000
2025-09-01,Westinghouse Air Brake Technologies,15,17,8,40,0.200000
2025-09-01,Westlake Corporation,24,10,6,40,0.150000
2025-09-01,Weyerhaeuser,17,18,5,40,0.125000
2025-09-01,Whirlpool,19,18,3,40,0.075000
2025-09-01,Williams,13,18,9,40,0.225000
2025-09-01,Williams-Sonoma,15,19,6,40,0.150000
2025-09-01,Winnebago Industries,21,12,7,40,0.175000
2025-09-01,Wintrust Financial,29,8,3,40,0.075000
2025-09-01,Woodward inc,14,18,8,40,0.200000
2025-09-01,Workday,15,13,12,40,0.300000
2025-09-01,World Kinect,23,10,7,40,0.175000
2025-09-01,Worthington Enterprises,24,10,6,40,0.150000
2025-09-01,Wynn Resorts,19,9,12,40,0.300000
2025-09-01,XPO,15,19,6,40,0.150000
2025-09-01,Xcel Energy,30,6,4,40,0.100000
2025-09-01,Xerox,13,25,2,40,0.050000
2025-09-01,Xylem Inc,28,7,5,40,0.125000
2025-09-01,Yum Brands,16,19,5,40,0.125000
2025-09-01,Yum China,17,20,3,40,0.075000
2025-09-01,Zebra Technologies,17,17,6,40,0.150000
2025-09-01,Zimmer Biomet,20,18,2,40,0.050000
2025-09-01,Zions Bancorp,18,16,6,40,0.150000
2025-09-01,Zoetis,21,16,3,40,0.075000
2025-09-01,Zoom Video Communications,16,20,4,40,0.100000
2025-09-01,eXp World,10,26,4,40,0.100000
2025-09-01,iHeartMedia,14,19,7,40,0.175000
2025-09-03,3M,13,18,9,40,0.225000
2025-09-03,A O Smith,21,17,2,40,0.050000
2025-09-03,A-Mark Precious Metals,40,0,0,40,0.000000
2025-09-03,ABM Industries,25,10,5,40,0.125000
2025-09-03,ADT,18,20,2,40,0.050000
2025-09-03,AECOM,22,16,2,40,0.050000
2025-09-03,AES,20,13,7,40,0.175000
2025-09-03,AGCO,20,13,7,40,0.175000
2025-09-03,AGNC Investment,16,21,3,40,0.075000
2025-09-03,AMC Entertainment,38,1,1,40,0.025000
2025-09-03,AMC Networks,18,15,7,40,0.175000
2025-09-03,AMN Healthcare Services,23,11,6,40,0.150000
2025-09-03,APA,17,13,10,40,0.250000
2025-09-03,APi Group,19,11,10,40,0.250000
2025-09-03,ARKO,20,18,2,40,0.050000
2025-09-03,ASGN,21,11,8,40,0.200000
2025-09-03,AT&T,13,23,4,40,0.100000
2025-09-03,ATI inc,23,11,6,40,0.150000
2025-09-03,AbbVie,12,24,4,40,0.100000
2025-09-03,Abbott Laboratories,21,15,4,40,0.100000
2025-09-03,Abercrombie & Fitch,16,22,2,40,0.050000
2025-09-03,Academy Sports and Outdoors,18,15,7,40,0.175000
2025-09-03,Acadia Healthcare,18,16,6,40,0.150000
2025-09-03,Acuity Inc,19,18,3,40,0.075000
2025-09-03,Adams Resources & Energy,21,7,1,29,0.034483
2025-09-03,AdaptHealth,17,18,5,40,0.125000
2025-09-03,Adobe,9,27,4,40,0.100000
2025-09-03,Advance Auto Parts,19,13,8,40,0.200000
2025-09-03,Advanced Drainage Systems,36,4,0,40,0.000000
2025-09-03,Advanced Micro Devices,35,2,3,40,0.075000
2025-09-03,Advantage Solutions,39,1,0,40,0.000000
2025-09-03,Aflac,11,17,12,40,0.300000
2025-09-03,Agilent Technologies,17,18,5,40,0.125000
2025-09-03,Agilon Health,20,16,4,40,0.100000
2025-09-03,Air Lease,8,29,3,40,0.075000
2025-09-03,Air Products & Chemicals,18,17,5,40,0.125000
2025-09-03,Airbnb,20,13,7,40,0.175000
2025-09-03,Akamai Technologies,18,15,7,40,0.175000
2025-09-03,Alaska Air,16,21,3,40,0.075000
2025-09-03,Albemarle Corporation,15,22,3,40,0.075000
2025-09-03,Albertsons,17,15,8,40,0.200000
2025-09-03,Alcoa Corporation,15,20,5,40,0.125000
2025-09-03,Alexandria Real Estate Equities,20,13,7,40,0.175000
2025-09-03,Alight Solutions,16,20,4,40,0.100000
2025-09-03,Align Technology,12,21,7,40,0.175000
2025-09-03,Allegiant Travel Company,21,12,7,40,0.175000
2025-09-03,Alliance Resource Partners,14,8,18,40,0.450000
2025-09-03,Alliant Energy,35,3,2,40,0.050000
2025-09-03,Allison Transmission,24,12,4,40,0.100000
2025-09-03,Allstate,24,14,2,40,0.050000
2025-09-03,Ally Financial,17,20,3,40,0.075000
2025-09-03,Alpha Metallurgical Resources,17,17,6,40,0.150000
2025-09-03,Alphabet,16,14,10,40,0.250000
2025-09-03,Altice,18,16,6,40,0.150000
2025-09-03,Altria,20,13,7,40,0.175000
2025-09-03,Amazon,32,3,5,40,0.125000
2025-09-03,Ameren,20,17,3,40,0.075000
2025-09-03,American Airlines,10,18,12,40,0.300000
2025-09-03,American Axle & Manufacturing,15,23,2,40,0.050000
2025-09-03,American Eagle Outfitters,14,20,6,40,0.150000
2025-09-03,American Electric Power,25,10,5,40,0.125000
2025-09-03,American Express,18,12,10,40,0.250000
2025-09-03,American Family Insurance,21,16,3,40,0.075000
2025-09-03,American Financial,22,12,6,40,0.150000
2025-09-03,American International Group,23,14,3,40,0.075000
2025-09-03,American Tower,18,17,5,40,0.125000
2025-09-03,American Water Works,21,13,6,40,0.150000
2025-09-03,Americold Realty Trust,40,0,0,40,0.000000
2025-09-03,Ameriprise Financial,24,16,0,40,0.000000
2025-09-03,Ametek,24,10,6,40,0.150000
2025-09-03,Amgen,21,17,2,40,0.050000
2025-09-03,Amica Mutual Insurance,14,24,2,40,0.050000
2025-09-03,Amkor Technology,14,20,6,40,0.150000
2025-09-03,Amphenol,14,25,1,40,0.025000
2025-09-03,Analog Devices,13,21,6,40,0.150000
2025-09-03,Antero Resources,18,16,6,40,0.150000
2025-09-03,Anywhere Real Estate Inc,17,15,8,40,0.200000
2025-09-03,Apollo Global Management,12,27,1,40,0.025000
2025-09-03,AppLovin,18,18,4,40,0.100000
2025-09-03,Apple,9,26,5,40,0.125000
2025-09-03,Applied Industrial Technologies,16,18,6,40,0.150000
2025-09-03,Applied Materials,11,16,13,40,0.325000
2025-09-03,AptarGroup,20,15,5,40,0.125000
2025-09-03,Aramark,20,17,3,40,0.075000
2025-09-03,ArcBest,17,19,4,40,0.100000
2025-09-03,Arch Resources,29,6,5,40,0.125000
2025-09-03,Archer Daniels Midland,24,12,4,40,0.100000
2025-09-03,Ares Management,27,12,1,40,0.025000
2025-09-03,Arista Networks,26,12,2,40,0.050000
2025-09-03,Arrow Electronics,18,14,8,40,0.200000
2025-09-03,Arthur J Gallagher,10,28,2,40,0.050000
2025-09-03,Asbury Automotive Group,15,23,2,40,0.050000
2025-09-03,Assurant,17,17,6,40,0.150000
2025-09-03,Atkore,18,18,4,40,0.100000
2025-09-03,Atlassian,17,17,6,40,0.150000
2025-09-03,Atmos Energy,35,5,0,40,0.000000
2025-09-03,Auto-Owners Insurance,15,20,5,40,0.125000
2025-09-03,AutoNation,21,15,4,40,0.100000
2025-09-03,AutoZone,17,20,3,40,0.075000
2025-09-03,Autodesk,20,16,4,40,0.100000
2025-09-03,Autoliv,25,13,2,40,0.050000
2025-09-03,Automatic Data Processing,21,15,4,40,0.100000
2025-09-03,AvalonBay Communities,20,12,8,40,0.200000
2025-09-03,Avantor,15,17,8,40,0.200000
2025-09-03,Avery Dennison,15,23,2,40,0.050000
2025-09-03,Avient,13,21,6,40,0.150000
2025-09-03,Avis Budget,11,24,5,40,0.125000
2025-09-03,Avnet,14,20,6,40,0.150000
2025-09-03,BJs Wholesale Club,12,22,6,40,0.150000
2025-09-03,BOK Financial,20,15,5,40,0.125000
2025-09-03,BWX Technologies,27,12,1,40,0.025000
2025-09-03,Baker Hughes,23,13,4,40,0.100000
2025-09-03,Bank of America,17,17,6,40,0.150000
2025-09-03,Bank of New York Mellon,24,12,4,40,0.100000
2025-09-03,Bath & Body Works,15,20,5,40,0.125000
2025-09-03,Baxter International,16,19,5,40,0.125000
2025-09-03,Beacon Roofing Supply,9,24,7,40,0.175000
2025-09-03,Becton Dickinson,16,17,7,40,0.175000
2025-09-03,Belden,19,17,4,40,0.100000
2025-09-03,Benchmark Electronics,21,14,5,40,0.125000
2025-09-03,Berkshire Hathaway,8,26,6,40,0.150000
2025-09-03,Best Buy,39,1,0,40,0.000000
2025-09-03,Big Lots,7,31,2,40,0.050000
2025-09-03,Bio-Rad Laboratories,14,20,6,40,0.150000
2025-09-03,Biogen,15,24,1,40,0.025000
2025-09-03,BlackRock,23,12,5,40,0.125000
2025-09-03,Blackstone,19,19,2,40,0.050000
2025-09-03,Bloomin Brands,17,16,7,40,0.175000
2025-09-03,BlueLinx,25,8,7,40,0.175000
2025-09-03,Boeing,10,18,12,40,0.300000
2025-09-03,Boise Cascade,16,15,9,40,0.225000
2025-09-03,Booking Holdings,23,14,3,40,0.075000
2025-09-03,Booz Allen Hamilton,21,17,2,40,0.050000
2025-09-03,BorgWarner,23,16,1,40,0.025000
2025-09-03,Boston Properties,20,11,9,40,0.225000
2025-09-03,Boston Scientific,14,21,5,40,0.125000
2025-09-03,Boyd Gaming,22,17,1,40,0.025000
2025-09-03,Bread Financial,18,17,5,40,0.125000
2025-09-03,BrightSpring Health Services,27,10,3,40,0.075000
2025-09-03,BrightView Holdings,21,13,6,40,0.150000
2025-09-03,Brighthouse Financial,15,20,5,40,0.125000
2025-09-03,Brinker International,23,12,5,40,0.125000
2025-09-03,Brinks Company,8,3,5,16,0.312500
2025-09-03,Bristol-Myers Squibb,13,23,4,40,0.100000
2025-09-03,Broadcom,12,23,5,40,0.125000
2025-09-03,Broadridge Financial Solutions,33,3,4,40,0.100000
2025-09-03,Brookdale Senior Living,25,11,4,40,0.100000
2025-09-03,Brown & Brown,18,19,3,40,0.075000
2025-09-03,Brown-Forman,9,19,12,40,0.300000
2025-09-03,Bruker,17,11,12,40,0.300000
2025-09-03,Brunswick,10,18,12,40,0.300000
2025-09-03,Builders FirstSource,18,16,6,40,0.150000
2025-09-03,Burlington Stores,19,17,4,40,0.100000
2025-09-03,CACI International,20,12,8,40,0.200000
2025-09-03,CBRE Group,20,18,2,40,0.050000
2025-09-03,CDW,20,19,1,40,0.025000
2025-09-03,CF Industries,21,13,6,40,0.150000
2025-09-03,CH Robinson Worldwide,15,21,4,40,0.100000
2025-09-03,CHS,15,22,3,40,0.075000
2025-09-03,CME Group,13,25,2,40,0.050000
2025-09-03,CMS Energy,36,2,2,40,0.050000
2025-09-03,CNO Financial Group,20,16,4,40,0.100000
2025-09-03,CNX Resources,21,16,3,40,0.075000
2025-09-03,CSX,14,13,13,40,0.325000
2025-09-03,CVS Health,12,18,10,40,0.250000
2025-09-03,Cabot Corporation,19,17,4,40,0.100000
2025-09-03,Cadence,18,19,3,40,0.075000
2025-09-03,Caesars Entertainment,34,5,1,40,0.025000
2025-09-03,Cal-Maine Foods,18,15,7,40,0.175000
2025-09-03,Caleres inc,19,15,6,40,0.150000
2025-09-03,California Resources,22,12,6,40,0.150000
2025-09-03,Calumet,10,17,13,40,0.325000
2025-09-03,Campbell Soup,12,23,5,40,0.125000
2025-09-03,Camping World,11,22,7,40,0.175000
2025-09-03,Capital One,22,12,6,40,0.150000
2025-09-03,CarMax,11,22,7,40,0.175000
2025-09-03,Cardinal Health,12,18,10,40,0.250000
2025-09-03,Carlisle Companies,18,14,8,40,0.200000
2025-09-03,Carlyle Group,12,27,1,40,0.025000
2025-09-03,Carpenter Technology,15,17,8,40,0.200000
2025-09-03,Carrier Global,20,10,10,40,0.250000
2025-09-03,Carters inc,10,21,2,33,0.060606
2025-09-03,Carvana,21,16,3,40,0.075000
2025-09-03,Caseys General Stores,12,23,5,40,0.125000
2025-09-03,Catalent,10,26,4,40,0.100000
2025-09-03,Caterpillar,11,18,11,40,0.275000
2025-09-03,Cboe Global Markets,18,19,3,40,0.075000
2025-09-03,Celanese,15,9,16,40,0.400000
2025-09-03,Cencora,21,14,5,40,0.125000
2025-09-03,Centene,12,10,18,40,0.450000
2025-09-03,CenterPoint Energy,29,5,6,40,0.150000
2025-09-03,Central Garden & Pet,12,24,4,40,0.100000
2025-09-03,Century Communities,26,11,3,40,0.075000
2025-09-03,ChampionX,19,15,6,40,0.150000
2025-09-03,Charles River Laboratories International,13,17,10,40,0.250000
2025-09-03,Charles Schwab,29,9,2,40,0.050000
2025-09-03,Chart Industries,16,16,8,40,0.200000
2025-09-03,Charter Communications,8,21,11,40,0.275000
2025-09-03,Cheesecake Factory,13,15,12,40,0.300000
2025-09-03,Chefs Warehouse,16,15,9,40,0.225000
2025-09-03,Chemours,13,19,8,40,0.200000
2025-09-03,Cheniere Energy,29,6,5,40,0.125000
2025-09-03,Chevron,16,18,6,40,0.150000
2025-09-03,Chewy,25,14,1,40,0.025000
2025-09-03,Chipotle Mexican Grill,14,23,3,40,0.075000
2025-09-03,Chord Energy,35,2,3,40,0.075000
2025-09-03,Church & Dwight,15,19,6,40,0.150000
2025-09-03,Ciena,19,18,3,40,0.075000
2025-09-03,Cigna,20,15,5,40,0.125000
2025-09-03,Cincinnati Financial,16,22,2,40,0.050000
2025-09-03,Cinemark,15,22,3,40,0.075000
2025-09-03,Cintas,24,13,3,40,0.075000
2025-09-03,Cisco Systems,15,21,4,40,0.100000
2025-09-03,Citigroup,27,10,3,40,0.075000
2025-09-03,Citizens Financial Group,18,19,3,40,0.075000
2025-09-03,Civitas Resources,19,14,7,40,0.175000
2025-09-03,Clean Harbors,37,1,2,40,0.050000
2025-09-03,Clear Channel Outdoor Hldgs,8,0,2,10,0.200000
2025-09-03,Cleveland-Cliffs,12,18,10,40,0.250000
2025-09-03,Clorox,20,13,7,40,0.175000
2025-09-03,Cognizant Technology Solutions,37,2,1,40,0.025000
2025-09-03,Coherent,23,14,3,40,0.075000
2025-09-03,Coinbase Global,12,28,0,40,0.000000
2025-09-03,Colgate-Palmolive,18,14,8,40,0.200000
2025-09-03,Columbia Banking System,13,23,4,40,0.100000
2025-09-03,Columbia Sportswear,23,14,3,40,0.075000
2025-09-03,Comcast,24,13,3,40,0.075000
2025-09-03,Comerica,24,14,2,40,0.050000
2025-09-03,Comfort Systems USA,40,0,0,40,0.000000
2025-09-03,CommScope,14,20,6,40,0.150000
2025-09-03,Commercial Metals,14,17,9,40,0.225000
2025-09-03,Community Health Systems,21,18,1,40,0.025000
2025-09-03,Compass,22,17,1,40,0.025000
2025-09-03,Conagra Brands,23,16,1,40,0.025000
2025-09-03,Concentrix,20,14,6,40,0.150000
2025-09-03,Conduent,18,18,4,40,0.100000
2025-09-03,ConocoPhillips,24,12,4,40,0.100000
2025-09-03,Consol Energy,32,6,2,40,0.050000
2025-09-03,Consolidated Edison,21,15,4,40,0.100000
2025-09-03,Constellation Brands,8,9,23,40,0.575000
2025-09-03,Constellation Energy,37,3,0,40,0.000000
2025-09-03,Continental Resources,18,14,8,40,0.200000
2025-09-03,Cooper Cos,7,29,4,40,0.100000
2025-09-03,Cooper-Standard,21,15,4,40,0.100000
2025-09-03,Copart,21,17,2,40,0.050000
2025-09-03,Core & Main,19,18,3,40,0.075000
2025-09-03,Cornerstone Building Brands,16,20,4,40,0.100000
2025-09-03,Corning,23,15,2,40,0.050000
2025-09-03,Corpay,17,15,8,40,0.200000
2025-09-03,Corteva,14,22,4,40,0.100000
2025-09-03,Costco,13,21,6,40,0.150000
2025-09-03,Coterra Energy,33,5,2,40,0.050000
2025-09-03,Coty,20,14,6,40,0.150000
2025-09-03,Country Financial,14,20,6,40,0.150000
2025-09-03,Coupang,20,18,2,40,0.050000
2025-09-03,Cracker Barrel Old Country Store,14,13,13,40,0.325000
2025-09-03,Crocs,9,26,5,40,0.125000
2025-09-03,CrossAmerica Partners,18,3,19,40,0.475000
2025-09-03,CrowdStrike,25,10,5,40,0.125000
2025-09-03,Crown Castle,18,15,7,40,0.175000
2025-09-03,Crown Holdings,21,11,8,40,0.200000
2025-09-03,Cullen Frost Bankers,25,13,2,40,0.050000
2025-09-03,Cummins,12,16,12,40,0.300000
2025-09-03,Curtiss-Wright,17,20,3,40,0.075000
2025-09-03,DR Horton,14,18,8,40,0.200000
2025-09-03,DTE Energy,33,5,2,40,0.050000
2025-09-03,DXC Technology,17,22,1,40,0.025000
2025-09-03,DaVita,14,13,13,40,0.325000
2025-09-03,Dana Incorporated,21,15,4,40,0.100000
2025-09-03,Danaher,23,14,3,40,0.075000
2025-09-03,Darden Restaurants,19,15,6,40,0.150000
2025-09-03,Darling Ingredients,39,1,0,40,0.000000
2025-09-03,Deckers Outdoor,26,9,5,40,0.125000
2025-09-03,Deere,11,21,8,40,0.200000
2025-09-03,Delek US,19,16,5,40,0.125000
2025-09-03,Dell Technologies,18,10,12,40,0.300000
2025-09-03,Delta Air Lines,6,17,17,40,0.425000
2025-09-03,Dentsply Sirona,18,19,3,40,0.075000
2025-09-03,Designer Brands,16,17,7,40,0.175000
2025-09-03,Devon Energy,38,2,0,40,0.000000
2025-09-03,DexCom,15,17,8,40,0.200000
2025-09-03,Diamondback Energy,27,5,8,40,0.200000
2025-09-03,Dicks Sporting Goods,15,22,3,40,0.075000
2025-09-03,Diebold Nixdorf,19,17,4,40,0.100000
2025-09-03,Digital Realty Trust,39,1,0,40,0.000000
2025-09-03,Dillards,20,16,4,40,0.100000
2025-09-03,DocuSign,21,13,6,40,0.150000
2025-09-03,Dollar General,16,18,6,40,0.150000
2025-09-03,Dollar Tree,9,24,7,40,0.175000
2025-09-03,Dominion Energy,32,5,3,40,0.075000
2025-09-03,Dominos Pizza inc,17,17,6,40,0.150000
2025-09-03,Domtar,9,27,4,40,0.100000
2025-09-03,Donaldson Company,21,15,4,40,0.100000
2025-09-03,DoorDash,24,12,4,40,0.100000
2025-09-03,Dover Corporation,19,15,6,40,0.150000
2025-09-03,DraftKings,23,11,6,40,0.150000
2025-09-03,Dream Finders Homes,36,1,3,40,0.075000
2025-09-03,Dropbox,16,21,3,40,0.075000
2025-09-03,DuPont,17,18,5,40,0.125000
2025-09-03,Duke Energy,37,1,2,40,0.050000
2025-09-03,Dycom Industries,16,19,5,40,0.125000
2025-09-03,EMCOR Group,21,13,6,40,0.150000
2025-09-03,EOG Resources,23,13,4,40,0.100000
2025-09-03,EPAM Systems,15,19,6,40,0.150000
2025-09-03,EQT,25,12,3,40,0.075000
2025-09-03,ESAB,15,18,7,40,0.175000
2025-09-03,East West Bancorp,20,19,1,40,0.025000
2025-09-03,Eastman Chemical,13,18,9,40,0.225000
2025-09-03,Ebay,22,12,6,40,0.150000
2025-09-03,EchoStar,11,24,5,40,0.125000
2025-09-03,Ecolab,19,18,3,40,0.075000
2025-09-03,Edison International,10,23,7,40,0.175000
2025-09-03,Edward Jones,11,24,5,40,0.125000
2025-09-03,Edwards Lifesciences,12,12,16,40,0.400000
2025-09-03,Elanco Animal Health,19,16,5,40,0.125000
2025-09-03,Electronic Arts,12,22,6,40,0.150000
2025-09-03,Elevance Health,15,9,16,40,0.400000
2025-09-03,Eli Lilly,21,13,6,40,0.150000
2025-09-03,Emerson Electric,12,24,4,40,0.100000
2025-09-03,EnLink Midstream,14,21,5,40,0.125000
2025-09-03,Encompass Health,14,23,3,40,0.075000
2025-09-03,Endeavor Group,13,22,5,40,0.125000
2025-09-03,EnerSys,21,15,4,40,0.100000
2025-09-03,Energizer,36,3,1,40,0.025000
2025-09-03,Energy Transfer,33,2,5,40,0.125000
2025-09-03,Ensign Group,22,16,2,40,0.050000
2025-09-03,Entegris,20,15,5,40,0.125000
2025-09-03,Entergy,25,12,3,40,0.075000
2025-09-03,Enterprise Products Partners,14,10,16,40,0.400000
2025-09-03,Envista,23,12,5,40,0.125000
2025-09-03,Equifax,21,14,5,40,0.125000
2025-09-03,Equinix,22,18,0,40,0.000000
2025-09-03,Equitable,21,18,1,40,0.025000
2025-09-03,Equity Residential,19,13,8,40,0.200000
2025-09-03,Erie Insurance,12,16,12,40,0.300000
2025-09-03,Estée Lauder,14,18,8,40,0.200000
2025-09-03,Etsy,18,14,8,40,0.200000
2025-09-03,Euronet Worldwide,17,17,6,40,0.150000
2025-09-03,Evergy,20,14,6,40,0.150000
2025-09-03,Eversource Energy,35,1,4,40,0.100000
2025-09-03,Exact Sciences,10,18,12,40,0.300000
2025-09-03,Exelon,22,14,4,40,0.100000
2025-09-03,Expand Energy,39,0,1,40,0.025000
2025-09-03,Expedia,22,15,3,40,0.075000
2025-09-03,Expeditors International of Washington,21,16,3,40,0.075000
2025-09-03,Extra Space Storage,19,15,6,40,0.150000
2025-09-03,Exxon Mobil,17,19,4,40,0.100000
2025-09-03,F5,15,23,2,40,0.050000
2025-09-03,FM Global,13,18,9,40,0.225000
2025-09-03,FMC Corporation,15,20,5,40,0.125000
2025-09-03,FTI Consulting,21,14,5,40,0.125000
2025-09-03,Fannie Mae,7,29,4,40,0.100000
2025-09-03,Farmers Insurance Exchange,9,18,13,40,0.325000
2025-09-03,Fastenal,21,16,3,40,0.075000
2025-09-03,FedEx,13,17,10,40,0.250000
2025-09-03,Federated Mutual Insurance,18,15,7,40,0.175000
2025-09-03,Fidelity National Financial,13,21,6,40,0.150000
2025-09-03,Fidelity National Information Services,22,15,3,40,0.075000
2025-09-03,Fifth Third Bancorp,16,21,3,40,0.075000
2025-09-03,First American Financial,21,14,5,40,0.125000
2025-09-03,First Citizens BancShares,17,18,5,40,0.125000
2025-09-03,First Horizon,19,20,1,40,0.025000
2025-09-03,First National of Nebraska,17,23,0,40,0.000000
2025-09-03,First Solar,18,15,7,40,0.175000
2025-09-03,FirstCash,15,23,2,40,0.050000
2025-09-03,FirstEnergy,13,19,8,40,0.200000
2025-09-03,Fiserv,21,15,4,40,0.100000
2025-09-03,Five Below,12,24,4,40,0.100000
2025-09-03,Flagstar Financial,18,19,3,40,0.075000
2025-09-03,Floor & Decor,19,19,2,40,0.050000
2025-09-03,Flowers Foods,18,19,3,40,0.075000
2025-09-03,Flowserve,29,10,1,40,0.025000
2025-09-03,Fluor,16,16,8,40,0.200000
2025-09-03,Foot Locker,15,16,9,40,0.225000
2025-09-03,Ford Motor,14,19,7,40,0.175000
2025-09-03,Fortinet,15,16,9,40,0.225000
2025-09-03,Fortive,20,14,6,40,0.150000
2025-09-03,Fortune Brands Innovations,20,15,5,40,0.125000
2025-09-03,Franklin Resources,25,11,4,40,0.100000
2025-09-03,Freddie Mac,7,28,5,40,0.125000
2025-09-03,Freeport-McMoRan,19,14,7,40,0.175000
2025-09-03,Frontier Airlines,18,13,9,40,0.225000
2025-09-03,Frontier Communications,19,15,6,40,0.150000
2025-09-03,G-III Apparel Group,18,16,6,40,0.150000
2025-09-03,GE HealthCare Technologies,22,15,3,40,0.075000
2025-09-03,GMS,14,20,6,40,0.150000
2025-09-03,GXO Logistics,19,18,3,40,0.075000
2025-09-03,GameStop,15,19,6,40,0.150000
2025-09-03,Gannett,17,11,12,40,0.300000
2025-09-03,Garrett Motion inc,14,18,8,40,0.200000
2025-09-03,Gartner,12,18,10,40,0.250000
2025-09-03,Gen Digital,25,7,8,40,0.200000
2025-09-03,Generac,16,17,7,40,0.175000
2025-09-03,General Dynamics,38,1,1,40,0.025000
2025-09-03,General Electric,12,23,5,40,0.125000
2025-09-03,General Mills,22,15,3,40,0.075000
2025-09-03,General Motors,13,21,6,40,0.150000
2025-09-03,Genesis Energy,38,0,2,40,0.050000
2025-09-03,Genuine Parts,21,17,2,40,0.050000
2025-09-03,Genworth Financial,18,19,3,40,0.075000
2025-09-03,Gilead Sciences,22,16,2,40,0.050000
2025-09-03,Global Partners,14,15,11,40,0.275000
2025-09-03,Global Payments,14,24,2,40,0.050000
2025-09-03,Globe Life,22,17,1,40,0.025000
2025-09-03,GoDaddy,17,16,7,40,0.175000
2025-09-03,Goldman Sachs,13,22,5,40,0.125000
2025-09-03,Goodyear Tire & Rubber,13,24,3,40,0.075000
2025-09-03,Graham Holdings Company,18,18,4,40,0.100000
2025-09-03,Granite Construction,21,16,3,40,0.075000
2025-09-03,Graphic Packaging,14,16,10,40,0.250000
2025-09-03,Gray Television,10,23,7,40,0.175000
2025-09-03,Graybar Electric,14,22,4,40,0.100000
2025-09-03,Green Plains inc,20,13,7,40,0.175000
2025-09-03,Greenbrier,15,20,5,40,0.125000
2025-09-03,Greif,11,21,8,40,0.200000
2025-09-03,Griffon Corporation,22,12,6,40,0.150000
2025-09-03,Grocery Outlet Holding,17,18,5,40,0.125000
2025-09-03,Group 1 Automotive,16,17,7,40,0.175000
2025-09-03,Guardian Life insurance,17,23,0,40,0.000000
2025-09-03,Guess inc,20,17,3,40,0.075000
2025-09-03,H B Fuller,19,12,9,40,0.225000
2025-09-03,HCA Healthcare,18,15,7,40,0.175000
2025-09-03,HEICO,17,21,2,40,0.050000
2025-09-03,HF Sinclair,23,15,2,40,0.050000
2025-09-03,Halliburton,19,12,9,40,0.225000
2025-09-03,Hanesbrands,13,24,3,40,0.075000
2025-09-03,Hanover Insurance Group,24,13,3,40,0.075000
2025-09-03,Harley-Davidson,14,17,9,40,0.225000
2025-09-03,Hasbro,13,20,7,40,0.175000
2025-09-03,Hawaiian Airlines inc,18,22,0,40,0.000000
2025-09-03,Hawaiian Electric Industries,21,17,2,40,0.050000
2025-09-03,Helmerich & Payne,14,22,4,40,0.100000
2025-09-03,Henry Schein,15,22,3,40,0.075000
2025-09-03,Herc Rentals,18,16,6,40,0.150000
2025-09-03,Hershey,18,19,3,40,0.075000
2025-09-03,Hertz,17,9,14,40,0.350000
2025-09-03,Hewlett Packard,17,18,5,40,0.125000
2025-09-03,Hewlett Packard Enterprise,16,21,3,40,0.075000
2025-09-03,Hillenbrand,17,18,5,40,0.125000
2025-09-03,Hilton Grand Vacations,37,1,2,40,0.050000
2025-09-03,Hilton Worldwide,12,23,5,40,0.125000
2025-09-03,Hologic,17,15,8,40,0.200000
2025-09-03,Home Depot,19,15,6,40,0.150000
2025-09-03,Honeywell,21,15,4,40,0.100000
2025-09-03,Hormel Foods,11,17,12,40,0.300000
2025-09-03,Host Hotels & Resorts,13,26,1,40,0.025000
2025-09-03,Hovnanian Enterprises,26,10,4,40,0.100000
2025-09-03,Howmet Aerospace,16,20,4,40,0.100000
2025-09-03,Hub Group,16,17,7,40,0.175000
2025-09-03,Hubbell,15,16,9,40,0.225000
2025-09-03,Humana,19,17,4,40,0.100000
2025-09-03,Huntington Bancshares,22,16,2,40,0.050000
2025-09-03,Huntington Ingalls Industries,19,15,6,40,0.150000
2025-09-03,Huntsman,19,14,7,40,0.175000
2025-09-03,Hyatt Hotels,20,17,3,40,0.075000
2025-09-03,Hyster-Yale,21,15,4,40,0.100000
2025-09-03,IAC,17,20,3,40,0.075000
2025-09-03,IBM,14,23,3,40,0.075000
2025-09-03,IDEX,18,15,7,40,0.175000
2025-09-03,IDEXX Laboratories,17,17,6,40,0.150000
2025-09-03,IQVIA,18,17,5,40,0.125000
2025-09-03,ITT,15,21,4,40,0.100000
2025-09-03,Icahn Enterprises,16,11,13,40,0.325000
2025-09-03,Illinois Tool Works,20,18,2,40,0.050000
2025-09-03,Illumina inc,16,19,5,40,0.125000
2025-09-03,Incyte,19,16,5,40,0.125000
2025-09-03,Ingersoll Rand,26,11,3,40,0.075000
2025-09-03,Ingles Markets,16,17,7,40,0.175000
2025-09-03,Ingram Micro,17,13,10,40,0.250000
2025-09-03,Ingredion,18,18,4,40,0.100000
2025-09-03,Insight Enterprises,20,12,8,40,0.200000
2025-09-03,Insperity,16,14,10,40,0.250000
2025-09-03,Instacart,19,15,6,40,0.150000
2025-09-03,Installed Building Products,17,18,5,40,0.125000
2025-09-03,Intel,11,22,7,40,0.175000
2025-09-03,Interactive Brokers,11,23,6,40,0.150000
2025-09-03,Intercontinental Exchange,17,22,1,40,0.025000
2025-09-03,International Flavors & Fragrances,14,21,5,40,0.125000
2025-09-03,International Paper,9,26,5,40,0.125000
2025-09-03,Interpublic Group,21,13,6,40,0.150000
2025-09-03,Intuit,19,17,4,40,0.100000
2025-09-03,Intuitive Surgical,11,18,11,40,0.275000
2025-09-03,Iron Mountain,8,29,3,40,0.075000
2025-09-03,JB Hunt Transport Services,18,19,3,40,0.075000
2025-09-03,JELD-WEN Holding,23,12,5,40,0.125000
2025-09-03,JM Smucker,14,18,8,40,0.200000
2025-09-03,JPMorgan Chase,20,16,4,40,0.100000
2025-09-03,Jabil,20,16,4,40,0.100000
2025-09-03,Jackson Financial,18,21,1,40,0.025000
2025-09-03,Jacobs Solutions,36,1,3,40,0.075000
2025-09-03,Jefferies Financial,19,20,1,40,0.025000
2025-09-03,JetBlue Airways,20,13,7,40,0.175000
2025-09-03,Johnson & Johnson,20,17,3,40,0.075000
2025-09-03,Jones Lang LaSalle,19,13,8,40,0.200000
2025-09-03,Juniper Networks,17,18,5,40,0.125000
2025-09-03,KB Home,16,19,5,40,0.125000
2025-09-03,KBR,27,10,3,40,0.075000
2025-09-03,KKR,14,25,1,40,0.025000
2025-09-03,KLA,20,15,5,40,0.125000
2025-09-03,Kaiser Aluminum,18,18,4,40,0.100000
2025-09-03,Kellanova,18,17,5,40,0.125000
2025-09-03,Kelly Services inc,22,11,7,40,0.175000
2025-09-03,Kemper,16,18,6,40,0.150000
2025-09-03,Keurig Dr Pepper,10,26,4,40,0.100000
2025-09-03,KeyCorp,22,14,4,40,0.100000
2025-09-03,Keysight Technologies,28,11,1,40,0.025000
2025-09-03,Kimberly-Clark,21,15,4,40,0.100000
2025-09-03,Kinder Morgan,40,0,0,40,0.000000
2025-09-03,Kirby Corporation,21,14,5,40,0.125000
2025-09-03,Knife River Corporation,17,21,2,40,0.050000
2025-09-03,Knight Swift Transportation,33,1,6,40,0.150000
2025-09-03,Kohls,12,19,9,40,0.225000
2025-09-03,Kontoor Brands,21,17,2,40,0.050000
2025-09-03,Korn Ferry,22,11,7,40,0.175000
2025-09-03,Kraft Heinz,11,25,4,40,0.100000
2025-09-03,Kroger,10,17,13,40,0.325000
2025-09-03,Kyndryl,16,20,4,40,0.100000
2025-09-03,L3Harris Technologies,24,12,4,40,0.100000
2025-09-03,LCI Industries,17,15,8,40,0.200000
2025-09-03,LKQ,24,13,3,40,0.075000
2025-09-03,LPL Financial,27,12,1,40,0.025000
2025-09-03,Labcorp Holdings,21,18,1,40,0.025000
2025-09-03,Lam Research,19,15,6,40,0.150000
2025-09-03,Lamb Weston,19,15,6,40,0.150000
2025-09-03,Land O'Lakes,10,25,5,40,0.125000
2025-09-03,Landstar System,19,13,8,40,0.200000
2025-09-03,Las Vegas Sands,21,14,5,40,0.125000
2025-09-03,Lear Corporation,22,13,5,40,0.125000
2025-09-03,Leggett & Platt,21,15,4,40,0.100000
2025-09-03,Leidos,23,15,2,40,0.050000
2025-09-03,Lennar,14,24,2,40,0.050000
2025-09-03,Lennox International,21,14,5,40,0.125000
2025-09-03,Levi Strauss,14,26,0,40,0.000000
2025-09-03,Liberty Energy,40,0,0,40,0.000000
2025-09-03,Liberty Media,38,2,0,40,0.000000
2025-09-03,Liberty Mutual Insurance,35,1,4,40,0.100000
2025-09-03,Light & Wonder,14,22,4,40,0.100000
2025-09-03,Lincoln Electric,13,20,7,40,0.175000
2025-09-03,Lincoln National,16,13,11,40,0.275000
2025-09-03,Lithia Motors,19,17,4,40,0.100000
2025-09-03,Live Nation Entertainment,39,1,0,40,0.000000
2025-09-03,Lockheed Martin,23,12,5,40,0.125000
2025-09-03,Loews,20,12,8,40,0.200000
2025-09-03,Louisiana-Pacific Corporation,18,14,8,40,0.200000
2025-09-03,Lowes,10,26,4,40,0.100000
2025-09-03,Lululemon athletica,16,17,7,40,0.175000
2025-09-03,Lumen Technologies,14,20,6,40,0.150000
2025-09-03,Lyft,13,22,5,40,0.125000
2025-09-03,M&T Bank,19,18,3,40,0.075000
2025-09-03,M/I Homes,18,17,5,40,0.125000
2025-09-03,MDU Resources Group,24,13,3,40,0.075000
2025-09-03,MGM Resorts International,18,19,3,40,0.075000
2025-09-03,MKS Instruments,17,18,5,40,0.125000
2025-09-03,MRC Global,19,15,6,40,0.150000
2025-09-03,MSC Industrial Direct,19,16,5,40,0.125000
2025-09-03,MSCI,31,6,3,40,0.075000
2025-09-03,MYR Group,19,18,3,40,0.075000
2025-09-03,Macys,14,22,4,40,0.100000
2025-09-03,ManpowerGroup,21,15,4,40,0.100000
2025-09-03,Marathon Oil,13,21,6,40,0.150000
2025-09-03,Marathon Petroleum,31,8,1,40,0.025000
2025-09-03,Markel Group,29,6,5,40,0.125000
2025-09-03,Marriott International,17,16,7,40,0.175000
2025-09-03,Marriott Vacations Worldwide,20,16,4,40,0.100000
2025-09-03,Marsh & McLennan,14,25,1,40,0.025000
2025-09-03,Martin Marietta Materials,14,20,6,40,0.150000
2025-09-03,Marvell Technology,18,15,7,40,0.175000
2025-09-03,MasTec,19,15,6,40,0.150000
2025-09-03,Masco,14,14,12,40,0.300000
2025-09-03,Mass Mutual,13,24,3,40,0.075000
2025-09-03,MasterBrand,16,22,2,40,0.050000
2025-09-03,Mastercard,19,16,5,40,0.125000
2025-09-03,Matador Resources,17,15,8,40,0.200000
2025-09-03,Match Group,12,13,15,40,0.375000
2025-09-03,Mativ,15,18,7,40,0.175000
2025-09-03,Matson inc,20,17,3,40,0.075000
2025-09-03,Mattel,22,15,3,40,0.075000
2025-09-03,Maximus,13,25,2,40,0.050000
2025-09-03,McCormick & Company,20,15,5,40,0.125000
2025-09-03,McDonalds,24,10,6,40,0.150000
2025-09-03,McKesson,16,21,3,40,0.075000
2025-09-03,Medical Mutual of Ohio,15,19,6,40,0.150000
2025-09-03,Merck,16,19,5,40,0.125000
2025-09-03,Mercury General,20,16,4,40,0.100000
2025-09-03,Meritage Homes,21,16,3,40,0.075000
2025-09-03,MetLife,17,19,4,40,0.100000
2025-09-03,Meta,15,14,11,40,0.275000
2025-09-03,Mettler-Toledo International,20,19,1,40,0.025000
2025-09-03,Microchip Technology,19,16,5,40,0.125000
2025-09-03,Micron Technology,16,18,6,40,0.150000
2025-09-03,Microsoft,19,12,9,40,0.225000
2025-09-03,Middleby,16,19,5,40,0.125000
2025-09-03,MillerKnoll,23,16,1,40,0.025000
2025-09-03,Moderna,19,12,9,40,0.225000
2025-09-03,ModivCare,18,12,10,40,0.250000
2025-09-03,Mohawk Industries,21,16,3,40,0.075000
2025-09-03,Molina Healthcare,18,12,10,40,0.250000
2025-09-03,Molson Coors Beverage,22,7,11,40,0.275000
2025-09-03,Mondelez,19,15,6,40,0.150000
2025-09-03,Monster Beverage,21,15,4,40,0.100000
2025-09-03,Moodys Corporation,3,10,2,15,0.133333
2025-09-03,Moog inc,20,15,5,40,0.125000
2025-09-03,Morgan Stanley,18,17,5,40,0.125000
2025-09-03,Mosaic,19,17,4,40,0.100000
2025-09-03,Motorola Solutions,32,3,5,40,0.125000
2025-09-03,Mueller Industries,19,17,4,40,0.100000
2025-09-03,Murphy Oil,15,18,7,40,0.175000
2025-09-03,Murphy USA,20,17,3,40,0.075000
2025-09-03,Mutual of Omaha,17,19,4,40,0.100000
2025-09-03,NCR Atleos,18,18,4,40,0.100000
2025-09-03,NCR Voyix,21,13,6,40,0.150000
2025-09-03,NGL Energy Partners,33,2,5,40,0.125000
2025-09-03,NLV Financial,4,4,2,10,0.200000
2025-09-03,NOV,6,25,9,40,0.225000
2025-09-03,NRG Energy,30,4,6,40,0.150000
2025-09-03,NVR,18,20,2,40,0.050000
2025-09-03,Nasdaq,16,16,8,40,0.200000
2025-09-03,Nationwide,11,14,15,40,0.375000
2025-09-03,Navient,25,12,3,40,0.075000
2025-09-03,NetApp,18,17,5,40,0.125000
2025-09-03,Netflix,11,20,9,40,0.225000
2025-09-03,NeueHealth,20,17,3,40,0.075000
2025-09-03,New York Life Insurance,15,23,2,40,0.050000
2025-09-03,NewMarket Corporation,15,22,3,40,0.075000
2025-09-03,Newell Brands,19,16,5,40,0.125000
2025-09-03,Newmont,19,16,5,40,0.125000
2025-09-03,News Corp,15,17,8,40,0.200000
2025-09-03,Nexstar Media Group,21,16,3,40,0.075000
2025-09-03,NextEra Energy,29,6,5,40,0.125000
2025-09-03,NiSource,22,13,5,40,0.125000
2025-09-03,Nike,15,19,6,40,0.150000
2025-09-03,Nordson,19,17,4,40,0.100000
2025-09-03,Nordstrom,16,21,3,40,0.075000
2025-09-03,Norfolk Southern,17,14,9,40,0.225000
2025-09-03,Northern Trust,40,0,0,40,0.000000
2025-09-03,Northrop Grumman,20,14,6,40,0.150000
2025-09-03,Northwestern Mutual,36,3,1,40,0.025000
2025-09-03,Nucor,16,22,2,40,0.050000
2025-09-03,Nvidia,11,21,8,40,0.200000
2025-09-03,O'Reilly Automotive,21,16,3,40,0.075000
2025-09-03,O-I Glass,20,15,5,40,0.125000
2025-09-03,ODP Business Solutions,23,16,1,40,0.025000
2025-09-03,OGE Energy,31,8,1,40,0.025000
2025-09-03,ON Semiconductor,7,24,9,40,0.225000
2025-09-03,Occidental Petroleum,18,15,7,40,0.175000
2025-09-03,Old Dominion Freight Line,18,16,6,40,0.150000
2025-09-03,Old National Bancorp,14,20,6,40,0.150000
2025-09-03,Old Republic International,21,15,4,40,0.100000
2025-09-03,Olin,15,16,9,40,0.225000
2025-09-03,Omnicom Group,15,13,12,40,0.300000
2025-09-03,OneMain,21,16,3,40,0.075000
2025-09-03,Oneok,24,13,3,40,0.075000
2025-09-03,Opendoor Technologies,10,19,11,40,0.275000
2025-09-03,Option Care Health,39,1,0,40,0.000000
2025-09-03,Oracle,11,22,7,40,0.175000
2025-09-03,Organon,17,18,5,40,0.125000
2025-09-03,Oscar Health,20,11,9,40,0.225000
2025-09-03,Oshkosh,18,14,8,40,0.200000
2025-09-03,Otis Worldwide,21,13,6,40,0.150000
2025-09-03,Ovintiv,20,10,10,40,0.250000
2025-09-03,Owens & Minor,8,22,10,40,0.250000
2025-09-03,Owens Corning,20,16,4,40,0.100000
2025-09-03,PACS Group,20,13,7,40,0.175000
2025-09-03,PBF Energy,36,4,0,40,0.000000
2025-09-03,PC Connection Inc,22,16,2,40,0.050000
2025-09-03,PENN Entertainment,40,0,0,40,0.000000
2025-09-03,PG&E,14,15,11,40,0.275000
2025-09-03,PNC Financial Services,21,16,3,40,0.075000
2025-09-03,PPG Industries,18,15,7,40,0.175000
2025-09-03,PPL,24,13,3,40,0.075000
2025-09-03,PVH,20,14,6,40,0.150000
2025-09-03,Paccar,16,15,9,40,0.225000
2025-09-03,Pacific Life,16,23,1,40,0.025000
2025-09-03,Packaging Corp of America,10,26,4,40,0.100000
2025-09-03,Palo Alto Networks,12,17,11,40,0.275000
2025-09-03,Par Pacific,23,13,4,40,0.100000
2025-09-03,Paramount Global,12,25,3,40,0.075000
2025-09-03,Park Hotels & Resorts,14,22,4,40,0.100000
2025-09-03,Parker-Hannifin,20,16,4,40,0.100000
2025-09-03,Parsons Corporation,20,18,2,40,0.050000
2025-09-03,Patrick Industries,18,18,4,40,0.100000
2025-09-03,Patterson Companies Inc,9,27,4,40,0.100000
2025-09-03,Patterson-UTI Energy,34,2,4,40,0.100000
2025-09-03,PayPal,14,16,10,40,0.250000
2025-09-03,Paychex,21,14,5,40,0.125000
2025-09-03,Peabody Energy,32,5,3,40,0.075000
2025-09-03,Peloton,18,17,5,40,0.125000
2025-09-03,Penn Mutual Life Insurance,19,18,3,40,0.075000
2025-09-03,PennyMac Financial Services,24,13,3,40,0.075000
2025-09-03,Penske Automotive,21,16,3,40,0.075000
2025-09-03,PepsiCo,14,19,7,40,0.175000
2025-09-03,Performance Food,17,17,6,40,0.150000
2025-09-03,Permian Resources,23,15,2,40,0.050000
2025-09-03,Petco Health and Wellness,36,2,2,40,0.050000
2025-09-03,Peter Kiewit Sons',5,21,14,40,0.350000
2025-09-03,Pfizer,14,16,10,40,0.250000
2025-09-03,Philip Morris,22,15,3,40,0.075000
2025-09-03,Phillips 66,16,17,7,40,0.175000
2025-09-03,Pinnacle West Capital,18,17,5,40,0.125000
2025-09-03,Pinterest,17,18,5,40,0.125000
2025-09-03,Pioneer Natural Resources,18,10,12,40,0.300000
2025-09-03,Pitney Bowes,25,8,7,40,0.175000
2025-09-03,Plains GP,14,4,22,40,0.550000
2025-09-03,Playtika Holding,15,20,5,40,0.125000
2025-09-03,Plexus,8,20,12,40,0.300000
2025-09-03,Polaris Inc,13,20,7,40,0.175000
2025-09-03,Pool Corporation,18,18,4,40,0.100000
2025-09-03,Popular inc,38,1,1,40,0.025000
2025-09-03,Portland General Electric,15,22,3,40,0.075000
2025-09-03,Post Holdings,18,21,1,40,0.025000
2025-09-03,PriceSmart,20,18,2,40,0.050000
2025-09-03,Primerica,21,13,6,40,0.150000
2025-09-03,Primoris Services,16,15,9,40,0.225000
2025-09-03,Principal Financial,16,20,4,40,0.100000
2025-09-03,ProFrac Holding,16,20,4,40,0.100000
2025-09-03,Procter & Gamble,21,12,7,40,0.175000
2025-09-03,Progressive Insurance,17,20,3,40,0.075000
2025-09-03,Prologis,14,23,3,40,0.075000
2025-09-03,Prudential Financial,25,10,5,40,0.125000
2025-09-03,Public Service Enterprise Group,23,12,5,40,0.125000
2025-09-03,Public Storage,13,22,5,40,0.125000
2025-09-03,Publix Super Markets,18,17,5,40,0.125000
2025-09-03,Puget Sound Energy,28,10,2,40,0.050000
2025-09-03,PulteGroup,27,7,6,40,0.150000
2025-09-03,Pure Storage,17,16,7,40,0.175000
2025-09-03,QVC,19,17,4,40,0.100000
2025-09-03,Qorvo,19,17,4,40,0.100000
2025-09-03,Quad/Graphics,19,12,9,40,0.225000
2025-09-03,Qualcomm,16,16,8,40,0.200000
2025-09-03,Quanta Services,22,12,6,40,0.150000
2025-09-03,Quest Diagnostics,18,20,2,40,0.050000
2025-09-03,QuidelOrtho,20,16,4,40,0.100000
2025-09-03,REV Group,21,14,5,40,0.125000
2025-09-03,RPM International,17,17,6,40,0.150000
2025-09-03,RTX,22,13,5,40,0.125000
2025-09-03,RXO inc,17,15,8,40,0.200000
2025-09-03,Rackspace Technology,15,17,8,40,0.200000
2025-09-03,Radius Recycling,13,15,12,40,0.300000
2025-09-03,Ralph Lauren,25,14,1,40,0.025000
2025-09-03,Range Resources,17,19,4,40,0.100000
2025-09-03,Raymond James Financial,19,19,2,40,0.050000
2025-09-03,Realty Income,17,19,4,40,0.100000
2025-09-03,Regal Rexnord,18,19,3,40,0.075000
2025-09-03,Regeneron Pharmaceuticals,21,17,2,40,0.050000
2025-09-03,Regions Financial,19,18,3,40,0.075000
2025-09-03,Reinsurance Group of America,19,18,3,40,0.075000
2025-09-03,Reliance Inc,25,10,5,40,0.125000
2025-09-03,Republic Services,18,11,11,40,0.275000
2025-09-03,ResMed,20,17,3,40,0.075000
2025-09-03,Resideo Technologies,24,14,2,40,0.050000
2025-09-03,Restoration Hardware,11,24,5,40,0.125000
2025-09-03,Revvity,24,10,6,40,0.150000
2025-09-03,Rite Aid,8,27,5,40,0.125000
2025-09-03,Rithm Capital,20,17,3,40,0.075000
2025-09-03,Rivian Automotive,17,17,6,40,0.150000
2025-09-03,Robert Half,20,14,6,40,0.150000
2025-09-03,Roblox,16,9,15,40,0.375000
2025-09-03,Rocket Companies,19,16,5,40,0.125000
2025-09-03,Rockwell Automation,23,15,2,40,0.050000
2025-09-03,Roku,19,18,3,40,0.075000
2025-09-03,Rollins inc,18,17,5,40,0.125000
2025-09-03,Roper Technologies,16,17,7,40,0.175000
2025-09-03,Ross Stores,18,18,4,40,0.100000
2025-09-03,Rush Enterprises,20,17,3,40,0.075000
2025-09-03,Ryder System,17,14,9,40,0.225000
2025-09-03,Ryerson Holding,17,15,8,40,0.200000
2025-09-03,S&P Global,9,26,5,40,0.125000
2025-09-03,SBA Communications,22,14,4,40,0.100000
2025-09-03,SS&C Technologies,22,16,2,40,0.050000
2025-09-03,Sabre Corporation,20,14,6,40,0.150000
2025-09-03,Saia inc,21,17,2,40,0.050000
2025-09-03,Salesforce,8,17,15,40,0.375000
2025-09-03,Sallie Mae,15,22,3,40,0.075000
2025-09-03,Sally Beauty,40,0,0,40,0.000000
2025-09-03,Sanmina,16,21,3,40,0.075000
2025-09-03,ScanSource,25,11,4,40,0.100000
2025-09-03,Schneider National,15,19,6,40,0.150000
2025-09-03,Science Applications International,24,13,3,40,0.075000
2025-09-03,Scotts Miracle-Gro,33,2,5,40,0.125000
2025-09-03,Seaboard,24,11,5,40,0.125000
2025-09-03,Sealed Air Corporation,17,21,2,40,0.050000
2025-09-03,Securian Financial,11,24,5,40,0.125000
2025-09-03,Select Medical,19,16,5,40,0.125000
2025-09-03,Selective Insurance Group,26,13,1,40,0.025000
2025-09-03,Sempra,22,18,0,40,0.000000
2025-09-03,Sentry Insurance Group,3,7,0,10,0.000000
2025-09-03,Service Corp International,10,8,7,25,0.280000
2025-09-03,ServiceNow,19,18,3,40,0.075000
2025-09-03,Sherwin-Williams,14,19,7,40,0.175000
2025-09-03,Shift4 Payments,12,18,10,40,0.250000
2025-09-03,Silgan,13,20,7,40,0.175000
2025-09-03,Simon Property Group,15,21,4,40,0.100000
2025-09-03,Sinclair,13,23,4,40,0.100000
2025-09-03,SiteOne Landscape Supply,20,16,4,40,0.100000
2025-09-03,Skechers USA,16,19,5,40,0.125000
2025-09-03,SkyWest,8,16,16,40,0.400000
2025-09-03,Skyline Champion,33,4,3,40,0.075000
2025-09-03,Skyworks Solutions,31,4,5,40,0.125000
2025-09-03,Smurfit Westrock,11,23,6,40,0.150000
2025-09-03,Snap Inc,15,11,14,40,0.350000
2025-09-03,Snap-on,17,19,4,40,0.100000
2025-09-03,Snowflake inc,23,13,4,40,0.100000
2025-09-03,Sonic Automotive,18,19,3,40,0.075000
2025-09-03,Sonoco Products,23,12,5,40,0.125000
2025-09-03,Southern Company,29,5,6,40,0.150000
2025-09-03,Southwest Airlines,22,11,7,40,0.175000
2025-09-03,Southwest Gas,16,19,5,40,0.125000
2025-09-03,Southwestern Energy,35,2,3,40,0.075000
2025-09-03,SpartanNash,17,17,6,40,0.150000
2025-09-03,Spectrum Brands,18,17,5,40,0.125000
2025-09-03,Spire inc,14,16,10,40,0.250000
2025-09-03,Spirit AeroSystems,34,1,5,40,0.125000
2025-09-03,Spirit Airlines,29,4,7,40,0.175000
2025-09-03,Splunk,16,16,8,40,0.200000
2025-09-03,Sprouts Farmers Market,11,24,5,40,0.125000
2025-09-03,Stagwell,20,19,1,40,0.025000
2025-09-03,Stanley Black & Decker,12,22,6,40,0.150000
2025-09-03,Starbucks,13,24,3,40,0.075000
2025-09-03,State Farm Insurance,15,19,6,40,0.150000
2025-09-03,State Street,13,25,2,40,0.050000
2025-09-03,Steel Dynamics,31,7,2,40,0.050000
2025-09-03,Steelcase,19,19,2,40,0.050000
2025-09-03,Stericycle,12,9,19,40,0.475000
2025-09-03,Stifel Financial,25,14,1,40,0.025000
2025-09-03,StoneX,17,21,2,40,0.050000
2025-09-03,Stryker,15,16,9,40,0.225000
2025-09-03,Summit Materials,11,24,5,40,0.125000
2025-09-03,Sun Communities,17,18,5,40,0.125000
2025-09-03,Super Micro Computer,32,6,2,40,0.050000
2025-09-03,Surgery Partners,20,15,5,40,0.125000
2025-09-03,Sylvamo,18,18,4,40,0.100000
2025-09-03,Synchrony Financial,17,17,6,40,0.150000
2025-09-03,Synopsys,16,19,5,40,0.125000
2025-09-03,Synovus Financial,16,21,3,40,0.075000
2025-09-03,Sysco,16,17,7,40,0.175000
2025-09-03,T Rowe Price,20,16,4,40,0.100000
2025-09-03,TD Synnex,17,16,7,40,0.175000
2025-09-03,TEGNA,12,26,2,40,0.050000
2025-09-03,TIAA,13,25,2,40,0.050000
2025-09-03,TJX,17,17,6,40,0.150000
2025-09-03,Take-Two Interactive Software,21,17,2,40,0.050000
2025-09-03,Talen Energy,35,4,1,40,0.025000
2025-09-03,Tapestry,14,18,8,40,0.200000
2025-09-03,Targa Resources,22,12,6,40,0.150000
2025-09-03,Target,11,23,6,40,0.150000
2025-09-03,Taylor Morrison Home,16,16,8,40,0.200000
2025-09-03,Teladoc Health,19,16,5,40,0.125000
2025-09-03,Teledyne Technologies,20,12,8,40,0.200000
2025-09-03,Teleflex,20,18,2,40,0.050000
2025-09-03,Telephone & Data Systems,18,14,8,40,0.200000
2025-09-03,TelevisaUnivision,20,16,4,40,0.100000
2025-09-03,Tempur Sealy International,11,23,6,40,0.150000
2025-09-03,Tenet Healthcare,24,14,2,40,0.050000
2025-09-03,Teradyne,11,23,6,40,0.150000
2025-09-03,Terex,19,15,6,40,0.150000
2025-09-03,Tesla,7,13,20,40,0.500000
2025-09-03,Tetra Tech,14,22,4,40,0.100000
2025-09-03,Texas Instruments,11,23,6,40,0.150000
2025-09-03,Texas Roadhouse,14,16,10,40,0.250000
2025-09-03,Textron,16,19,5,40,0.125000
2025-09-03,The Andersons Inc,13,18,9,40,0.225000
2025-09-03,The Coca-Cola Company,14,20,6,40,0.150000
2025-09-03,The Hartford,13,16,11,40,0.275000
2025-09-03,Thermo Fisher Scientific,16,22,2,40,0.050000
2025-09-03,Thor Industries,16,17,7,40,0.175000
2025-09-03,Thrivent Financial for Lutherans,16,20,4,40,0.100000
2025-09-03,Timken,15,22,3,40,0.075000
2025-09-03,Titan Machinery,14,20,6,40,0.150000
2025-09-03,Toast inc,24,14,2,40,0.050000
2025-09-03,Toll Brothers,10,28,2,40,0.050000
2025-09-03,TopBuild,21,17,2,40,0.050000
2025-09-03,Topgolf Callaway Brands,20,15,5,40,0.125000
2025-09-03,Toro Company,16,16,8,40,0.200000
2025-09-03,Tractor Supply,24,14,2,40,0.050000
2025-09-03,TransDigm,19,16,5,40,0.125000
2025-09-03,TransUnion,15,16,9,40,0.225000
2025-09-03,Travelers Insurance,13,18,9,40,0.225000
2025-09-03,TreeHouse Foods,16,19,5,40,0.125000
2025-09-03,Tri Pointe Homes,18,21,1,40,0.025000
2025-09-03,TriNet Group,18,17,5,40,0.125000
2025-09-03,Trimble,10,25,5,40,0.125000
2025-09-03,Trinity Industries,20,13,7,40,0.175000
2025-09-03,TruStage,28,10,2,40,0.050000
2025-09-03,Truist Financial,20,16,4,40,0.100000
2025-09-03,Tutor Perini Corporation,19,13,8,40,0.200000
2025-09-03,Twilio,23,15,2,40,0.050000
2025-09-03,Tyson Foods,17,18,5,40,0.125000
2025-09-03,U-Haul,8,12,20,40,0.500000
2025-09-03,UFP Industries,23,14,3,40,0.075000
2025-09-03,UGI Utilities Inc,19,16,5,40,0.125000
2025-09-03,UL Solutions,38,0,2,40,0.050000
2025-09-03,UPS,9,23,8,40,0.200000
2025-09-03,US Bancorp,23,12,5,40,0.125000
2025-09-03,US Foods,23,14,3,40,0.075000
2025-09-03,USAA,17,12,11,40,0.275000
2025-09-03,Uber,21,13,6,40,0.150000
2025-09-03,Ulta Beauty,38,2,0,40,0.000000
2025-09-03,Under Armour,15,17,8,40,0.200000
2025-09-03,Union Pacific,18,15,7,40,0.175000
2025-09-03,United Airlines,31,4,5,40,0.125000
2025-09-03,United Natural Foods,39,0,1,40,0.025000
2025-09-03,United Rentals,39,1,0,40,0.000000
2025-09-03,United States Steel,36,2,2,40,0.050000
2025-09-03,UnitedHealth,15,16,9,40,0.225000
2025-09-03,Universal Corporation,25,13,2,40,0.050000
2025-09-03,Universal Health Services,17,18,5,40,0.125000
2025-09-03,Unum Group,20,16,4,40,0.100000
2025-09-03,Upbound Group,20,16,4,40,0.100000
2025-09-03,Urban Outfitters,18,16,6,40,0.150000
2025-09-03,V2X,19,17,4,40,0.100000
2025-09-03,VF Corporation,20,16,4,40,0.100000
2025-09-03,VICI Properties,21,18,1,40,0.025000
2025-09-03,Vail Resorts,18,11,11,40,0.275000
2025-09-03,Valero Energy,38,1,1,40,0.025000
2025-09-03,Valley National Bancorp,22,15,3,40,0.075000
2025-09-03,Valmont Industries,23,16,1,40,0.025000
2025-09-03,Valvoline inc,20,18,2,40,0.050000
2025-09-03,Ventas inc,23,13,4,40,0.100000
2025-09-03,Verisk Analytics,14,19,7,40,0.175000
2025-09-03,Verizon,8,23,9,40,0.225000
2025-09-03,Vertex Pharmaceuticals,21,14,5,40,0.125000
2025-09-03,Vertiv,13,23,4,40,0.100000
2025-09-03,Viasat,26,11,3,40,0.075000
2025-09-03,Viatris,13,19,8,40,0.200000
2025-09-03,Victorias Secret,12,16,12,40,0.300000
2025-09-03,Visa,9,15,16,40,0.400000
2025-09-03,Vishay Intertechnology,19,14,7,40,0.175000
2025-09-03,Vista Outdoor,14,22,4,40,0.100000
2025-09-03,Visteon,19,17,4,40,0.100000
2025-09-03,Vistra,21,15,4,40,0.100000
2025-09-03,Vontier,15,23,2,40,0.050000
2025-09-03,Voya Financial,18,16,6,40,0.150000
2025-09-03,Vulcan Materials,16,21,3,40,0.075000
2025-09-03,WEC Energy,35,2,3,40,0.075000
2025-09-03,WESCO International,26,11,3,40,0.075000
2025-09-03,WEX,19,16,5,40,0.125000
2025-09-03,WR Berkley,16,22,2,40,0.050000
2025-09-03,WW Grainger,20,15,5,40,0.125000
2025-09-03,Wabash National,18,15,7,40,0.175000
2025-09-03,Walgreens,6,28,6,40,0.150000
2025-09-03,Walmart,10,17,13,40,0.325000
2025-09-03,Walt Disney,21,16,3,40,0.075000
2025-09-03,Warner Bros Discovery,16,19,5,40,0.125000
2025-09-03,Warner Music Group,13,23,4,40,0.100000
2025-09-03,Waters Corporation,17,15,8,40,0.200000
2025-09-03,Watsco,20,12,8,40,0.200000
2025-09-03,Wayfair,20,19,1,40,0.025000
2025-09-03,Webster Financial,24,13,3,40,0.075000
2025-09-03,Weis Markets,19,15,6,40,0.150000
2025-09-03,Wells Fargo,33,3,4,40,0.100000
2025-09-03,Welltower,35,5,0,40,0.000000
2025-09-03,Werner Enterprises,26,9,5,40,0.125000
2025-09-03,West Pharmaceutical Services,21,16,3,40,0.075000
2025-09-03,Western & Southern Financial,17,20,3,40,0.075000
2025-09-03,Western Alliance Bancorp,16,16,8,40,0.200000
2025-09-03,Western Digital,19,18,3,40,0.075000
2025-09-03,Western Midstream Partners,11,8,21,40,0.525000
2025-09-03,Western Union,12,25,3,40,0.075000
2025-09-03,Westinghouse Air Brake Technologies,12,20,8,40,0.200000
2025-09-03,Westlake Corporation,26,11,3,40,0.075000
2025-09-03,Weyerhaeuser,14,20,6,40,0.150000
2025-09-03,Whirlpool,13,23,4,40,0.100000
2025-09-03,Williams,8,24,8,40,0.200000
2025-09-03,Williams-Sonoma,18,17,5,40,0.125000
2025-09-03,Winnebago Industries,20,12,8,40,0.200000
2025-09-03,Wintrust Financial,22,14,4,40,0.100000
2025-09-03,Woodward inc,18,18,4,40,0.100000
2025-09-03,Workday,12,17,11,40,0.275000
2025-09-03,World Kinect,22,12,6,40,0.150000
2025-09-03,Worthington Enterprises,23,14,3,40,0.075000
2025-09-03,Wynn Resorts,13,15,12,40,0.300000
2025-09-03,XPO,19,18,3,40,0.075000
2025-09-03,Xcel Energy,32,6,2,40,0.050000
2025-09-03,Xerox,15,22,3,40,0.075000
2025-09-03,Xylem Inc,28,6,6,40,0.150000
2025-09-03,Yum Brands,15,23,2,40,0.050000
2025-09-03,Yum China,18,20,2,40,0.050000
2025-09-03,Zebra Technologies,22,14,4,40,0.100000
2025-09-03,Zimmer Biomet,20,20,0,40,0.000000
2025-09-03,Zions Bancorp,18,15,7,40,0.175000
2025-09-03,Zoetis,22,13,5,40,0.125000
2025-09-03,Zoom Video Communications,14,22,4,40,0.100000
2025-09-03,eXp World,17,17,6,40,0.150000
2025-09-03,iHeartMedia,18,16,6,40,0.150000
2025-09-04,3M,14,20,6,40,0.150000
2025-09-04,A O Smith,16,23,1,40,0.025000
2025-09-04,A-Mark Precious Metals,40,0,0,40,0.000000
2025-09-04,ABM Industries,21,17,2,40,0.050000
2025-09-04,ADT,15,20,5,40,0.125000
2025-09-04,AECOM,24,14,2,40,0.050000
2025-09-04,AES,14,17,9,40,0.225000
2025-09-04,AGCO,21,13,6,40,0.150000
2025-09-04,AGNC Investment,17,22,1,40,0.025000
2025-09-04,AMC Entertainment,36,3,1,40,0.025000
2025-09-04,AMC Networks,17,15,8,40,0.200000
2025-09-04,AMN Healthcare Services,21,17,2,40,0.050000
2025-09-04,APA,18,9,13,40,0.325000
2025-09-04,APi Group,18,18,4,40,0.100000
2025-09-04,ARKO,15,20,5,40,0.125000
2025-09-04,ASGN,19,14,7,40,0.175000
2025-09-04,AT&T,22,16,2,40,0.050000
2025-09-04,ATI inc,20,11,9,40,0.225000
2025-09-04,AbbVie,7,25,8,40,0.200000
2025-09-04,Abbott Laboratories,19,15,6,40,0.150000
2025-09-04,Abercrombie & Fitch,18,20,2,40,0.050000
2025-09-04,Academy Sports and Outdoors,16,17,7,40,0.175000
2025-09-04,Acadia Healthcare,17,17,6,40,0.150000
2025-09-04,Acuity Inc,24,15,1,40,0.025000
2025-09-04,Adams Resources & Energy,21,8,1,30,0.033333
2025-09-04,AdaptHealth,19,19,2,40,0.050000
2025-09-04,Adobe,16,19,5,40,0.125000
2025-09-04,Advance Auto Parts,21,14,5,40,0.125000
2025-09-04,Advanced Drainage Systems,35,5,0,40,0.000000
2025-09-04,Advanced Micro Devices,34,3,3,40,0.075000
2025-09-04,Advantage Solutions,37,1,2,40,0.050000
2025-09-04,Aflac,13,14,13,40,0.325000
2025-09-04,Agilent Technologies,19,17,4,40,0.100000
2025-09-04,Agilon Health,18,19,3,40,0.075000
2025-09-04,Air Lease,9,29,2,40,0.050000
2025-09-04,Air Products & Chemicals,16,19,5,40,0.125000
2025-09-04,Airbnb,19,16,5,40,0.125000
2025-09-04,Akamai Technologies,16,18,6,40,0.150000
2025-09-04,Alaska Air,18,16,6,40,0.150000
2025-09-04,Albemarle Corporation,16,20,4,40,0.100000
2025-09-04,Albertsons,17,19,4,40,0.100000
2025-09-04,Alcoa Corporation,14,20,6,40,0.150000
2025-09-04,Alexandria Real Estate Equities,20,12,8,40,0.200000
2025-09-04,Alight Solutions,16,21,3,40,0.075000
2025-09-04,Align Technology,11,20,9,40,0.225000
2025-09-04,Allegiant Travel Company,17,16,7,40,0.175000
2025-09-04,Alliance Resource Partners,11,14,15,40,0.375000
2025-09-04,Alliant Energy,33,6,1,40,0.025000
2025-09-04,Allison Transmission,18,15,7,40,0.175000
2025-09-04,Allstate,23,15,2,40,0.050000
2025-09-04,Ally Financial,18,19,3,40,0.075000
2025-09-04,Alpha Metallurgical Resources,23,10,7,40,0.175000
2025-09-04,Alphabet,20,11,9,40,0.225000
2025-09-04,Altice,13,19,8,40,0.200000
2025-09-04,Altria,18,17,5,40,0.125000
2025-09-04,Amazon,33,5,2,40,0.050000
2025-09-04,Ameren,18,19,3,40,0.075000
2025-09-04,American Airlines,8,23,9,40,0.225000
2025-09-04,American Axle & Manufacturing,17,19,4,40,0.100000
2025-09-04,American Eagle Outfitters,17,20,3,40,0.075000
2025-09-04,American Electric Power,19,16,5,40,0.125000
2025-09-04,American Express,23,11,6,40,0.150000
2025-09-04,American Family Insurance,22,15,3,40,0.075000
2025-09-04,American Financial,21,16,3,40,0.075000
2025-09-04,American International Group,25,15,0,40,0.000000
2025-09-04,American Tower,16,20,4,40,0.100000
2025-09-04,American Water Works,17,22,1,40,0.025000
2025-09-04,Americold Realty Trust,40,0,0,40,0.000000
2025-09-04,Ameriprise Financial,24,13,3,40,0.075000
2025-09-04,Ametek,26,12,2,40,0.050000
2025-09-04,Amgen,14,19,7,40,0.175000
2025-09-04,Amica Mutual Insurance,14,24,2,40,0.050000
2025-09-04,Amkor Technology,13,23,4,40,0.100000
2025-09-04,Amphenol,17,22,1,40,0.025000
2025-09-04,Analog Devices,14,20,6,40,0.150000
2025-09-04,Antero Resources,22,12,6,40,0.150000
2025-09-04,Anywhere Real Estate Inc,21,13,6,40,0.150000
2025-09-04,Apollo Global Management,13,26,1,40,0.025000
2025-09-04,AppLovin,17,20,3,40,0.075000
2025-09-04,Apple,14,20,6,40,0.150000
2025-09-04,Applied Industrial Technologies,12,23,5,40,0.125000
2025-09-04,Applied Materials,10,16,14,40,0.350000
2025-09-04,AptarGroup,21,15,4,40,0.100000
2025-09-04,Aramark,22,16,2,40,0.050000
2025-09-04,ArcBest,14,23,3,40,0.075000
2025-09-04,Arch Resources,29,6,5,40,0.125000
2025-09-04,Archer Daniels Midland,22,11,7,40,0.175000
2025-09-04,Ares Management,26,11,3,40,0.075000
2025-09-04,Arista Networks,20,19,1,40,0.025000
2025-09-04,Arrow Electronics,20,11,9,40,0.225000
2025-09-04,Arthur J Gallagher,9,26,5,40,0.125000
2025-09-04,Asbury Automotive Group,17,21,2,40,0.050000
2025-09-04,Assurant,20,14,6,40,0.150000
2025-09-04,Atkore,20,14,6,40,0.150000
2025-09-04,Atlassian,16,16,8,40,0.200000
2025-09-04,Atmos Energy,37,2,1,40,0.025000
2025-09-04,Auto-Owners Insurance,15,20,5,40,0.125000
2025-09-04,AutoNation,15,20,5,40,0.125000
2025-09-04,AutoZone,19,15,6,40,0.150000
2025-09-04,Autodesk,19,19,2,40,0.050000
2025-09-04,Autoliv,26,13,1,40,0.025000
2025-09-04,Automatic Data Processing,22,14,4,40,0.100000
2025-09-04,AvalonBay Communities,21,14,5,40,0.125000
2025-09-04,Avantor,12,20,8,40,0.200000
2025-09-04,Avery Dennison,19,17,4,40,0.100000
2025-09-04,Avient,14,20,6,40,0.150000
2025-09-04,Avis Budget,15,22,3,40,0.075000
2025-09-04,Avnet,11,20,9,40,0.225000
2025-09-04,BJs Wholesale Club,14,22,4,40,0.100000
2025-09-04,BOK Financial,17,19,4,40,0.100000
2025-09-04,BWX Technologies,30,9,1,40,0.025000
2025-09-04,Baker Hughes,23,16,1,40,0.025000
2025-09-04,Ball,18,14,8,40,0.200000
2025-09-04,Bank of America,17,16,7,40,0.175000
2025-09-04,Bank of New York Mellon,25,12,3,40,0.075000
2025-09-04,Bath & Body Works,13,19,8,40,0.200000
2025-09-04,Baxter International,13,19,8,40,0.200000
2025-09-04,Beacon Roofing Supply,8,23,9,40,0.225000
2025-09-04,Becton Dickinson,20,17,3,40,0.075000
2025-09-04,Belden,18,16,6,40,0.150000
2025-09-04,Benchmark Electronics,19,16,5,40,0.125000
2025-09-04,Berkshire Hathaway,13,23,4,40,0.100000
2025-09-04,Best Buy,39,1,0,40,0.000000
2025-09-04,Big Lots,7,32,1,40,0.025000
2025-09-04,Bio-Rad Laboratories,16,19,5,40,0.125000
2025-09-04,Biogen,18,21,1,40,0.025000
2025-09-04,BlackRock,18,12,10,40,0.250000
2025-09-04,Blackstone,15,20,5,40,0.125000
2025-09-04,Bloomin Brands,11,21,8,40,0.200000
2025-09-04,BlueLinx,25,11,4,40,0.100000
2025-09-04,Boeing,5,17,18,40,0.450000
2025-09-04,Boise Cascade,13,20,7,40,0.175000
2025-09-04,Booking Holdings,17,21,2,40,0.050000
2025-09-04,Booz Allen Hamilton,19,16,5,40,0.125000
2025-09-04,BorgWarner,20,17,3,40,0.075000
2025-09-04,Boston Properties,19,14,7,40,0.175000
2025-09-04,Boston Scientific,15,19,6,40,0.150000
2025-09-04,Boyd Gaming,19,20,1,40,0.025000
2025-09-04,Bread Financial,22,12,6,40,0.150000
2025-09-04,BrightSpring Health Services,24,10,6,40,0.150000
2025-09-04,BrightView Holdings,22,11,7,40,0.175000
2025-09-04,Brighthouse Financial,15,22,3,40,0.075000
2025-09-04,Brinker International,23,11,6,40,0.150000
2025-09-04,Brinks Company,8,3,5,16,0.312500
2025-09-04,Bristol-Myers Squibb,10,26,4,40,0.100000
2025-09-04,Broadcom,5,28,7,40,0.175000
2025-09-04,Broadridge Financial Solutions,36,2,2,40,0.050000
2025-09-04,Brookdale Senior Living,22,13,5,40,0.125000
2025-09-04,Brown & Brown,9,29,2,40,0.050000
2025-09-04,Brown-Forman,9,19,12,40,0.300000
2025-09-04,Bruker,15,10,15,40,0.375000
2025-09-04,Brunswick,10,20,10,40,0.250000
2025-09-04,Builders FirstSource,22,14,4,40,0.100000
2025-09-04,Burlington Stores,19,20,1,40,0.025000
2025-09-04,CACI International,23,13,4,40,0.100000
2025-09-04,CBRE Group,18,21,1,40,0.025000
2025-09-04,CDW,16,21,3,40,0.075000
2025-09-04,CF Industries,20,14,6,40,0.150000
2025-09-04,CH Robinson Worldwide,19,18,3,40,0.075000
2025-09-04,CHS,16,22,2,40,0.050000
2025-09-04,CME Group,19,20,1,40,0.025000
2025-09-04,CMS Energy,36,1,3,40,0.075000
2025-09-04,CNO Financial Group,21,16,3,40,0.075000
2025-09-04,CNX Resources,18,17,5,40,0.125000
2025-09-04,CSX,10,20,10,40,0.250000
2025-09-04,CVS Health,14,16,10,40,0.250000
2025-09-04,Cabot Corporation,22,15,3,40,0.075000
2025-09-04,Cadence,16,21,3,40,0.075000
2025-09-04,Caesars Entertainment,33,6,1,40,0.025000
2025-09-04,Cal-Maine Foods,23,13,4,40,0.100000
2025-09-04,Caleres inc,19,17,4,40,0.100000
2025-09-04,California Resources,20,13,7,40,0.175000
2025-09-04,Calumet,14,17,9,40,0.225000
2025-09-04,Campbell Soup,13,21,6,40,0.150000
2025-09-04,Camping World,12,19,9,40,0.225000
2025-09-04,Capital One,17,19,4,40,0.100000
2025-09-04,CarMax,14,25,1,40,0.025000
2025-09-04,Cardinal Health,16,18,6,40,0.150000
2025-09-04,Carlisle Companies,20,15,5,40,0.125000
2025-09-04,Carlyle Group,18,20,2,40,0.050000
2025-09-04,Carpenter Technology,13,20,7,40,0.175000
2025-09-04,Carrier Global,22,11,7,40,0.175000
2025-09-04,Carters inc,10,22,2,34,0.058824
2025-09-04,Carvana,16,20,4,40,0.100000
2025-09-04,Caseys General Stores,12,23,5,40,0.125000
2025-09-04,Catalent,8,27,5,40,0.125000
2025-09-04,Caterpillar,13,20,7,40,0.175000
2025-09-04,Cboe Global Markets,18,19,3,40,0.075000
2025-09-04,Celanese,17,10,13,40,0.325000
2025-09-04,Cencora,24,14,2,40,0.050000
2025-09-04,Centene,15,9,16,40,0.400000
2025-09-04,CenterPoint Energy,29,7,4,40,0.100000
2025-09-04,Central Garden & Pet,12,23,5,40,0.125000
2025-09-04,Century Communities,21,14,5,40,0.125000
2025-09-04,ChampionX,20,16,4,40,0.100000
2025-09-04,Charles River Laboratories International,20,13,7,40,0.175000
2025-09-04,Charles Schwab,20,16,4,40,0.100000
2025-09-04,Chart Industries,15,20,5,40,0.125000
2025-09-04,Charter Communications,7,19,14,40,0.350000
2025-09-04,Cheesecake Factory,17,18,5,40,0.125000
2025-09-04,Chefs Warehouse,17,16,7,40,0.175000
2025-09-04,Chemours,14,14,12,40,0.300000
2025-09-04,Cheniere Energy,33,3,4,40,0.100000
2025-09-04,Chevron,20,12,8,40,0.200000
2025-09-04,Chewy,23,16,1,40,0.025000
2025-09-04,Chipotle Mexican Grill,14,21,5,40,0.125000
2025-09-04,Chord Energy,35,2,3,40,0.075000
2025-09-04,Church & Dwight,20,17,3,40,0.075000
2025-09-04,Ciena,17,21,2,40,0.050000
2025-09-04,Cigna,17,19,4,40,0.100000
2025-09-04,Cincinnati Financial,22,18,0,40,0.000000
2025-09-04,Cinemark,11,25,4,40,0.100000
2025-09-04,Cintas,23,13,4,40,0.100000
2025-09-04,Cisco Systems,13,22,5,40,0.125000
2025-09-04,Citigroup,26,11,3,40,0.075000
2025-09-04,Citizens Financial Group,18,17,5,40,0.125000
2025-09-04,Civitas Resources,16,17,7,40,0.175000
2025-09-04,Clean Harbors,32,5,3,40,0.075000
2025-09-04,Clear Channel Outdoor Hldgs,8,0,2,10,0.200000
2025-09-04,Cleveland-Cliffs,10,14,16,40,0.400000
2025-09-04,Clorox,23,9,8,40,0.200000
2025-09-04,Cognizant Technology Solutions,34,1,5,40,0.125000
2025-09-04,Coherent,15,22,3,40,0.075000
2025-09-04,Coinbase Global,11,29,0,40,0.000000
2025-09-04,Colgate-Palmolive,16,14,10,40,0.250000
2025-09-04,Columbia Banking System,15,19,6,40,0.150000
2025-09-04,Columbia Sportswear,18,16,6,40,0.150000
2025-09-04,Comcast,19,17,4,40,0.100000
2025-09-04,Comerica,29,7,4,40,0.100000
2025-09-04,Comfort Systems USA,40,0,0,40,0.000000
2025-09-04,CommScope,18,21,1,40,0.025000
2025-09-04,Commercial Metals,16,16,8,40,0.200000
2025-09-04,Community Health Systems,16,17,7,40,0.175000
2025-09-04,Compass,12,20,8,40,0.200000
2025-09-04,Conagra Brands,20,18,2,40,0.050000
2025-09-04,Concentrix,20,14,6,40,0.150000
2025-09-04,Conduent,14,19,7,40,0.175000
2025-09-04,ConocoPhillips,6,20,14,40,0.350000
2025-09-04,Consol Energy,34,5,1,40,0.025000
2025-09-04,Consolidated Edison,18,19,3,40,0.075000
2025-09-04,Constellation Brands,5,12,23,40,0.575000
2025-09-04,Constellation Energy,34,5,1,40,0.025000
2025-09-04,Continental Resources,19,13,8,40,0.200000
2025-09-04,Cooper Cos,8,28,4,40,0.100000
2025-09-04,Cooper-Standard,16,21,3,40,0.075000
2025-09-04,Copart,18,19,3,40,0.075000
2025-09-04,Core & Main,16,21,3,40,0.075000
2025-09-04,Cornerstone Building Brands,16,20,4,40,0.100000
2025-09-04,Corning,12,20,8,40,0.200000
2025-09-04,Corpay,16,20,4,40,0.100000
2025-09-04,Corteva,21,14,5,40,0.125000
2025-09-04,Costco,15,18,7,40,0.175000
2025-09-04,Coterra Energy,34,4,2,40,0.050000
2025-09-04,Coty,17,16,7,40,0.175000
2025-09-04,Country Financial,14,20,6,40,0.150000
2025-09-04,Coupang,20,16,4,40,0.100000
2025-09-04,Cracker Barrel Old Country Store,14,16,10,40,0.250000
2025-09-04,Crocs,5,29,6,40,0.150000
2025-09-04,CrossAmerica Partners,17,5,18,40,0.450000
2025-09-04,CrowdStrike,17,14,9,40,0.225000
2025-09-04,Crown Castle,15,23,2,40,0.050000
2025-09-04,Crown Holdings,19,19,2,40,0.050000
2025-09-04,Cullen Frost Bankers,22,13,5,40,0.125000
2025-09-04,Cummins,12,18,10,40,0.250000
2025-09-04,Curtiss-Wright,18,21,1,40,0.025000
2025-09-04,DR Horton,15,16,9,40,0.225000
2025-09-04,DTE Energy,34,4,2,40,0.050000
2025-09-04,DXC Technology,21,17,2,40,0.050000
2025-09-04,DaVita,15,13,12,40,0.300000
2025-09-04,Dana Incorporated,16,19,5,40,0.125000
2025-09-04,Danaher,21,15,4,40,0.100000
2025-09-04,Darden Restaurants,17,14,9,40,0.225000
2025-09-04,Darling Ingredients,40,0,0,40,0.000000
2025-09-04,Deckers Outdoor,26,13,1,40,0.025000
2025-09-04,Deere,9,23,8,40,0.200000
2025-09-04,Delek US,28,9,3,40,0.075000
2025-09-04,Dell Technologies,20,11,9,40,0.225000
2025-09-04,Delta Air Lines,5,17,18,40,0.450000
2025-09-04,Dentsply Sirona,18,18,4,40,0.100000
2025-09-04,Designer Brands,15,22,3,40,0.075000
2025-09-04,Devon Energy,39,0,1,40,0.025000
2025-09-04,DexCom,12,20,8,40,0.200000
2025-09-04,Diamondback Energy,30,3,7,40,0.175000
2025-09-04,Dicks Sporting Goods,12,23,5,40,0.125000
2025-09-04,Diebold Nixdorf,18,18,4,40,0.100000
2025-09-04,Digital Realty Trust,38,2,0,40,0.000000
2025-09-04,Dillards,13,21,6,40,0.150000
2025-09-04,DocuSign,17,12,11,40,0.275000
2025-09-04,Dollar General,11,23,6,40,0.150000
2025-09-04,Dollar Tree,13,19,8,40,0.200000
2025-09-04,Dominion Energy,5,3,0,8,0.000000
2025-09-04,Dominos Pizza inc,18,16,6,40,0.150000
2025-09-04,Domtar,9,24,7,40,0.175000
2025-09-04,Donaldson Company,19,11,10,40,0.250000
2025-09-04,DoorDash,24,10,6,40,0.150000
2025-09-04,Dover Corporation,18,17,5,40,0.125000
2025-09-04,DraftKings,21,16,3,40,0.075000
2025-09-04,Dream Finders Homes,36,1,3,40,0.075000
2025-09-04,Dropbox,18,21,1,40,0.025000
2025-09-04,DuPont,16,19,5,40,0.125000
2025-09-04,Duke Energy,38,0,2,40,0.050000
2025-09-04,Dycom Industries,22,14,4,40,0.100000
2025-09-04,EMCOR Group,15,19,6,40,0.150000
2025-09-04,EOG Resources,22,16,2,40,0.050000
2025-09-04,EPAM Systems,18,18,4,40,0.100000
2025-09-04,EQT,20,14,6,40,0.150000
2025-09-04,ESAB,18,19,3,40,0.075000
2025-09-04,East West Bancorp,21,16,3,40,0.075000
2025-09-04,Eastman Chemical,8,21,11,40,0.275000
2025-09-04,Ebay,20,15,5,40,0.125000
2025-09-04,EchoStar,12,21,7,40,0.175000
2025-09-04,Ecolab,16,17,7,40,0.175000
2025-09-04,Edison International,8,24,8,40,0.200000
2025-09-04,Edward Jones,14,22,4,40,0.100000
2025-09-04,Edwards Lifesciences,14,10,16,40,0.400000
2025-09-04,Elanco Animal Health,17,20,3,40,0.075000
2025-09-04,Electronic Arts,11,22,7,40,0.175000
2025-09-04,Elevance Health,13,12,15,40,0.375000
2025-09-04,Eli Lilly,15,15,10,40,0.250000
2025-09-04,Emerson Electric,15,21,4,40,0.100000
2025-09-04,EnLink Midstream,15,19,6,40,0.150000
2025-09-04,Encompass Health,16,20,4,40,0.100000
2025-09-04,Endeavor Group,12,23,5,40,0.125000
2025-09-04,EnerSys,22,16,2,40,0.050000
2025-09-04,Energy Transfer,35,1,4,40,0.100000
2025-09-04,Ensign Group,26,11,3,40,0.075000
2025-09-04,Entegris,17,19,4,40,0.100000
2025-09-04,Entergy,24,14,2,40,0.050000
2025-09-04,Enterprise Products Partners,16,10,14,40,0.350000
2025-09-04,Envista,22,15,3,40,0.075000
2025-09-04,Equifax,20,14,6,40,0.150000
2025-09-04,Equinix,22,18,0,40,0.000000
2025-09-04,Equitable,21,18,1,40,0.025000
2025-09-04,Equity Residential,17,11,12,40,0.300000
2025-09-04,Erie Insurance,15,13,12,40,0.300000
2025-09-04,Estée Lauder,13,20,7,40,0.175000
2025-09-04,Etsy,19,11,10,40,0.250000
2025-09-04,Euronet Worldwide,17,17,6,40,0.150000
2025-09-04,Evergy,22,13,5,40,0.125000
2025-09-04,Eversource Energy,29,3,8,40,0.200000
2025-09-04,Exact Sciences,12,16,12,40,0.300000
2025-09-04,Exelon,23,13,4,40,0.100000
2025-09-04,Expand Energy,40,0,0,40,0.000000
2025-09-04,Expedia,20,17,3,40,0.075000
2025-09-04,Expeditors International of Washington,23,13,4,40,0.100000
2025-09-04,Extra Space Storage,19,16,5,40,0.125000
2025-09-04,Exxon Mobil,20,17,3,40,0.075000
2025-09-04,F5,16,21,3,40,0.075000
2025-09-04,FM Global,12,18,10,40,0.250000
2025-09-04,FMC Corporation,19,18,3,40,0.075000
2025-09-04,FTI Consulting,15,17,8,40,0.200000
2025-09-04,Fannie Mae,7,30,3,40,0.075000
2025-09-04,Farmers Insurance Exchange,9,18,13,40,0.325000
2025-09-04,Fastenal,19,17,4,40,0.100000
2025-09-04,FedEx,19,12,9,40,0.225000
2025-09-04,Federated Mutual Insurance,19,15,6,40,0.150000
2025-09-04,Fidelity National Financial,14,21,5,40,0.125000
2025-09-04,Fidelity National Information Services,22,16,2,40,0.050000
2025-09-04,Fifth Third Bancorp,19,19,2,40,0.050000
2025-09-04,First American Financial,23,14,3,40,0.075000
2025-09-04,First Citizens BancShares,19,17,4,40,0.100000
2025-09-04,First Horizon,18,20,2,40,0.050000
2025-09-04,First National of Nebraska,18,22,0,40,0.000000
2025-09-04,First Solar,22,9,9,40,0.225000
2025-09-04,FirstCash,16,20,4,40,0.100000
2025-09-04,FirstEnergy,16,16,8,40,0.200000
2025-09-04,Fiserv,18,19,3,40,0.075000
2025-09-04,Five Below,16,21,3,40,0.075000
2025-09-04,Flagstar Financial,20,18,2,40,0.050000
2025-09-04,Floor & Decor,23,14,3,40,0.075000
2025-09-04,Flowers Foods,14,24,2,40,0.050000
2025-09-04,Flowserve,26,11,3,40,0.075000
2025-09-04,Fluor,16,13,11,40,0.275000
2025-09-04,Foot Locker,15,16,9,40,0.225000
2025-09-04,Ford Motor,15,22,3,40,0.075000
2025-09-04,Fortinet,14,17,9,40,0.225000
2025-09-04,Fortive,21,15,4,40,0.100000
2025-09-04,Fortune Brands Innovations,22,16,2,40,0.050000
2025-09-04,Franklin Resources,20,15,5,40,0.125000
2025-09-04,Freddie Mac,10,27,3,40,0.075000
2025-09-04,Freeport-McMoRan,22,13,5,40,0.125000
2025-09-04,Frontier Airlines,19,14,7,40,0.175000
2025-09-04,Frontier Communications,22,14,4,40,0.100000
2025-09-04,G-III Apparel Group,18,17,5,40,0.125000
2025-09-04,GE HealthCare Technologies,20,18,2,40,0.050000
2025-09-04,GMS,13,21,6,40,0.150000
2025-09-04,GXO Logistics,17,19,4,40,0.100000
2025-09-04,GameStop,15,17,8,40,0.200000
2025-09-04,Gannett,18,10,12,40,0.300000
2025-09-04,Garrett Motion inc,15,17,8,40,0.200000
2025-09-04,Gartner,11,20,9,40,0.225000
2025-09-04,Gen Digital,23,11,6,40,0.150000
2025-09-04,Generac,17,18,5,40,0.125000
2025-09-04,General Dynamics,38,1,1,40,0.025000
2025-09-04,General Electric,10,26,4,40,0.100000
2025-09-04,General Mills,21,16,3,40,0.075000
2025-09-04,General Motors,18,16,6,40,0.150000
2025-09-04,Genesis Energy,34,2,4,40,0.100000
2025-09-04,Genuine Parts,26,10,4,40,0.100000
2025-09-04,Genworth Financial,18,19,3,40,0.075000
2025-09-04,Gilead Sciences,15,23,2,40,0.050000
2025-09-04,Global Partners,15,16,9,40,0.225000
2025-09-04,Global Payments,16,23,1,40,0.025000
2025-09-04,Globe Life,23,16,1,40,0.025000
2025-09-04,GoDaddy,11,21,8,40,0.200000
2025-09-04,Goldman Sachs,12,22,6,40,0.150000
2025-09-04,Goodyear Tire & Rubber,13,21,6,40,0.150000
2025-09-04,Graham Holdings Company,24,11,5,40,0.125000
2025-09-04,Granite Construction,23,15,2,40,0.050000
2025-09-04,Graphic Packaging,15,16,9,40,0.225000
2025-09-04,Gray Television,11,21,8,40,0.200000
2025-09-04,Graybar Electric,14,22,4,40,0.100000
2025-09-04,Green Plains inc,15,18,7,40,0.175000
2025-09-04,Greenbrier,12,14,14,40,0.350000
2025-09-04,Greif,13,20,7,40,0.175000
2025-09-04,Griffon Corporation,18,19,3,40,0.075000
2025-09-04,Grocery Outlet Holding,17,16,7,40,0.175000
2025-09-04,Group 1 Automotive,15,16,9,40,0.225000
2025-09-04,Guardian Life insurance,18,22,0,40,0.000000
2025-09-04,Guess inc,22,16,2,40,0.050000
2025-09-04,H B Fuller,15,20,5,40,0.125000
2025-09-04,HCA Healthcare,21,13,6,40,0.150000
2025-09-04,HEICO,18,20,2,40,0.050000
2025-09-04,HF Sinclair,20,16,4,40,0.100000
2025-09-04,Halliburton,19,10,11,40,0.275000
2025-09-04,Hanesbrands,13,25,2,40,0.050000
2025-09-04,Hanover Insurance Group,22,15,3,40,0.075000
2025-09-04,Harley-Davidson,14,18,8,40,0.200000
2025-09-04,Hasbro,19,13,8,40,0.200000
2025-09-04,Hawaiian Airlines inc,18,22,0,40,0.000000
2025-09-04,Hawaiian Electric Industries,24,14,2,40,0.050000
2025-09-04,Helmerich & Payne,15,22,3,40,0.075000
2025-09-04,Henry Schein,11,22,7,40,0.175000
2025-09-04,Herc Rentals,18,16,6,40,0.150000
2025-09-04,Hershey,23,15,2,40,0.050000
2025-09-04,Hertz,21,6,13,40,0.325000
2025-09-04,Hewlett Packard,19,18,3,40,0.075000
2025-09-04,Hewlett Packard Enterprise,17,20,3,40,0.075000
2025-09-04,Hillenbrand,12,23,5,40,0.125000
2025-09-04,Hilton Grand Vacations,39,0,1,40,0.025000
2025-09-04,Hilton Worldwide,14,22,4,40,0.100000
2025-09-04,Hologic,11,24,5,40,0.125000
2025-09-04,Home Depot,18,14,8,40,0.200000
2025-09-04,Honeywell,14,24,2,40,0.050000
2025-09-04,Hormel Foods,11,18,11,40,0.275000
2025-09-04,Host Hotels & Resorts,11,28,1,40,0.025000
2025-09-04,Hovnanian Enterprises,24,13,3,40,0.075000
2025-09-04,Howmet Aerospace,14,21,5,40,0.125000
2025-09-04,Hub Group,19,18,3,40,0.075000
2025-09-04,Hubbell,19,15,6,40,0.150000
2025-09-04,Humana,18,14,8,40,0.200000
2025-09-04,Huntington Bancshares,22,14,4,40,0.100000
2025-09-04,Huntington Ingalls Industries,20,14,6,40,0.150000
2025-09-04,Huntsman,13,17,10,40,0.250000
2025-09-04,Hyatt Hotels,23,16,1,40,0.025000
2025-09-04,Hyster-Yale,16,16,8,40,0.200000
2025-09-04,IAC,21,16,3,40,0.075000
2025-09-04,IBM,17,21,2,40,0.050000
2025-09-04,IDEX,18,16,6,40,0.150000
2025-09-04,IDEXX Laboratories,20,17,3,40,0.075000
2025-09-04,IQVIA,27,13,0,40,0.000000
2025-09-04,ITT,16,20,4,40,0.100000
2025-09-04,Icahn Enterprises,19,16,5,40,0.125000
2025-09-04,Illinois Tool Works,19,17,4,40,0.100000
2025-09-04,Illumina inc,19,16,5,40,0.125000
2025-09-04,Incyte,18,17,5,40,0.125000
2025-09-04,Ingersoll Rand,18,15,7,40,0.175000
2025-09-04,Ingles Markets,14,18,8,40,0.200000
2025-09-04,Ingram Micro,16,17,7,40,0.175000
2025-09-04,Ingredion,20,18,2,40,0.050000
2025-09-04,Insight Enterprises,15,17,8,40,0.200000
2025-09-04,Insperity,17,10,13,40,0.325000
2025-09-04,Instacart,24,11,5,40,0.125000
2025-09-04,Installed Building Products,17,16,7,40,0.175000
2025-09-04,Intel,11,23,6,40,0.150000
2025-09-04,Interactive Brokers,11,28,1,40,0.025000
2025-09-04,Intercontinental Exchange,15,21,4,40,0.100000
2025-09-04,International Flavors & Fragrances,15,19,6,40,0.150000
2025-09-04,International Paper,5,31,4,40,0.100000
2025-09-04,Interpublic Group,23,14,3,40,0.075000
2025-09-04,Intuit,16,21,3,40,0.075000
2025-09-04,Intuitive Surgical,12,16,12,40,0.300000
2025-09-04,Iron Mountain,11,21,8,40,0.200000
2025-09-04,JB Hunt Transport Services,19,16,5,40,0.125000
2025-09-04,JELD-WEN Holding,25,13,2,40,0.050000
2025-09-04,JM Smucker,19,16,5,40,0.125000
2025-09-04,JPMorgan Chase,18,19,3,40,0.075000
2025-09-04,Jabil,20,15,5,40,0.125000
2025-09-04,Jackson Financial,15,21,4,40,0.100000
2025-09-04,Jacobs Solutions,33,0,7,40,0.175000
2025-09-04,Jefferies Financial,20,17,3,40,0.075000
2025-09-04,JetBlue Airways,25,13,2,40,0.050000
2025-09-04,Johnson & Johnson,24,15,1,40,0.025000
2025-09-04,Jones Lang LaSalle,16,16,8,40,0.200000
2025-09-04,Juniper Networks,15,19,6,40,0.150000
2025-09-04,KB Home,20,16,4,40,0.100000
2025-09-04,KBR,29,9,2,40,0.050000
2025-09-04,KKR,18,20,2,40,0.050000
2025-09-04,KLA,15,19,6,40,0.150000
2025-09-04,Kaiser Aluminum,15,21,4,40,0.100000
2025-09-04,Kellanova,20,11,9,40,0.225000
2025-09-04,Kelly Services inc,25,10,5,40,0.125000
2025-09-04,Kemper,13,18,9,40,0.225000
2025-09-04,Keurig Dr Pepper,6,29,5,40,0.125000
2025-09-04,KeyCorp,11,23,6,40,0.150000
2025-09-04,Keysight Technologies,23,14,3,40,0.075000
2025-09-04,Kimberly-Clark,18,15,7,40,0.175000
2025-09-04,Kinder Morgan,40,0,0,40,0.000000
2025-09-04,Kirby Corporation,26,12,2,40,0.050000
2025-09-04,Knife River Corporation,18,19,3,40,0.075000
2025-09-04,Knight Swift Transportation,31,2,7,40,0.175000
2025-09-04,Kohls,11,20,9,40,0.225000
2025-09-04,Kontoor Brands,20,16,4,40,0.100000
2025-09-04,Korn Ferry,19,14,7,40,0.175000
2025-09-04,Kraft Heinz,12,24,4,40,0.100000
2025-09-04,Kroger,17,15,8,40,0.200000
2025-09-04,Kyndryl,11,26,3,40,0.075000
2025-09-04,L3Harris Technologies,21,16,3,40,0.075000
2025-09-04,LCI Industries,14,22,4,40,0.100000
2025-09-04,LKQ,21,17,2,40,0.050000
2025-09-04,LPL Financial,24,14,2,40,0.050000
2025-09-04,Labcorp Holdings,19,16,5,40,0.125000
2025-09-04,Lam Research,16,18,6,40,0.150000
2025-09-04,Lamb Weston,23,11,6,40,0.150000
2025-09-04,Land O'Lakes,13,22,5,40,0.125000
2025-09-04,Landstar System,15,17,8,40,0.200000
2025-09-04,Las Vegas Sands,19,19,2,40,0.050000
2025-09-04,Lear Corporation,20,15,5,40,0.125000
2025-09-04,Leggett & Platt,19,17,4,40,0.100000
2025-09-04,Leidos,24,15,1,40,0.025000
2025-09-04,Lennar,11,26,3,40,0.075000
2025-09-04,Lennox International,21,13,6,40,0.150000
2025-09-04,Levi Strauss,12,27,1,40,0.025000
2025-09-04,Liberty Energy,40,0,0,40,0.000000
2025-09-04,Liberty Media,39,1,0,40,0.000000
2025-09-04,Liberty Mutual Insurance,35,1,4,40,0.100000
2025-09-04,Light & Wonder,12,23,5,40,0.125000
2025-09-04,Lincoln Electric,11,26,3,40,0.075000
2025-09-04,Lincoln National,19,13,8,40,0.200000
2025-09-04,Lithia Motors,14,21,5,40,0.125000
2025-09-04,Live Nation Entertainment,37,2,1,40,0.025000
2025-09-04,Lockheed Martin,25,10,5,40,0.125000
2025-09-04,Loews,17,14,9,40,0.225000
2025-09-04,Louisiana-Pacific Corporation,17,15,8,40,0.200000
2025-09-04,Lowes,10,27,3,40,0.075000
2025-09-04,Lululemon athletica,12,20,8,40,0.200000
2025-09-04,Lumen Technologies,10,25,5,40,0.125000
2025-09-04,Lyft,16,18,6,40,0.150000
2025-09-04,M&T Bank,22,16,2,40,0.050000
2025-09-04,M/I Homes,17,18,5,40,0.125000
2025-09-04,MDU Resources Group,23,11,6,40,0.150000
2025-09-04,MGM Resorts International,16,19,5,40,0.125000
2025-09-04,MKS Instruments,21,14,5,40,0.125000
2025-09-04,MRC Global,20,13,7,40,0.175000
2025-09-04,MSC Industrial Direct,20,17,3,40,0.075000
2025-09-04,MSCI,27,12,1,40,0.025000
2025-09-04,MYR Group,19,18,3,40,0.075000
2025-09-04,Macys,24,12,4,40,0.100000
2025-09-04,ManpowerGroup,22,13,5,40,0.125000
2025-09-04,Marathon Oil,13,23,4,40,0.100000
2025-09-04,Marathon Petroleum,27,12,1,40,0.025000
2025-09-04,Markel Group,28,8,4,40,0.100000
2025-09-04,Marriott International,14,22,4,40,0.100000
2025-09-04,Marriott Vacations Worldwide,17,17,6,40,0.150000
2025-09-04,Marsh & McLennan,16,23,1,40,0.025000
2025-09-04,Martin Marietta Materials,18,15,7,40,0.175000
2025-09-04,Marvell Technology,13,16,11,40,0.275000
2025-09-04,MasTec,17,17,6,40,0.150000
2025-09-04,Masco,13,19,8,40,0.200000
2025-09-04,Mass Mutual,13,24,3,40,0.075000
2025-09-04,MasterBrand,13,25,2,40,0.050000
2025-09-04,Mastercard,17,19,4,40,0.100000
2025-09-04,Matador Resources,20,15,5,40,0.125000
2025-09-04,Match Group,12,14,14,40,0.350000
2025-09-04,Mativ,18,16,6,40,0.150000
2025-09-04,Matson inc,23,13,4,40,0.100000
2025-09-04,Mattel,17,18,5,40,0.125000
2025-09-04,Maximus,18,18,4,40,0.100000
2025-09-04,McCormick & Company,21,15,4,40,0.100000
2025-09-04,McDonalds,18,11,11,40,0.275000
2025-09-04,McKesson,17,18,5,40,0.125000
2025-09-04,Medical Mutual of Ohio,15,19,6,40,0.150000
2025-09-04,Merck,22,15,3,40,0.075000
2025-09-04,Mercury General,17,19,4,40,0.100000
2025-09-04,Meritage Homes,25,14,1,40,0.025000
2025-09-04,MetLife,18,17,5,40,0.125000
2025-09-04,Meta,14,19,7,40,0.175000
2025-09-04,Mettler-Toledo International,22,15,3,40,0.075000
2025-09-04,Microchip Technology,13,21,6,40,0.150000
2025-09-04,Micron Technology,17,18,5,40,0.125000
2025-09-04,Microsoft,11,18,11,40,0.275000
2025-09-04,Middleby,13,20,7,40,0.175000
2025-09-04,MillerKnoll,13,24,3,40,0.075000
2025-09-04,Moderna,14,11,15,40,0.375000
2025-09-04,ModivCare,15,16,9,40,0.225000
2025-09-04,Mohawk Industries,22,10,8,40,0.200000
2025-09-04,Molina Healthcare,15,14,11,40,0.275000
2025-09-04,Molson Coors Beverage,19,14,7,40,0.175000
2025-09-04,Mondelez,15,18,7,40,0.175000
2025-09-04,Monster Beverage,23,14,3,40,0.075000
2025-09-04,Moodys Corporation,3,11,2,16,0.125000
2025-09-04,Moog inc,19,15,6,40,0.150000
2025-09-04,Morgan Stanley,10,21,9,40,0.225000
2025-09-04,Mosaic,17,21,2,40,0.050000
2025-09-04,Motorola Solutions,34,1,5,40,0.125000
2025-09-04,Mueller Industries,19,18,3,40,0.075000
2025-09-04,Murphy Oil,21,11,8,40,0.200000
2025-09-04,Murphy USA,21,15,4,40,0.100000
2025-09-04,Mutual of Omaha,19,17,4,40,0.100000
2025-09-04,NCR Atleos,22,16,2,40,0.050000
2025-09-04,NCR Voyix,20,15,5,40,0.125000
2025-09-04,NGL Energy Partners,36,1,3,40,0.075000
2025-09-04,NLV Financial,4,4,2,10,0.200000
2025-09-04,NOV,13,21,6,40,0.150000
2025-09-04,NRG Energy,36,1,3,40,0.075000
2025-09-04,NVR,18,18,4,40,0.100000
2025-09-04,Nasdaq,13,20,7,40,0.175000
2025-09-04,Nationwide,10,12,18,40,0.450000
2025-09-04,Navient,19,14,7,40,0.175000
2025-09-04,NetApp,16,17,7,40,0.175000
2025-09-04,Netflix,17,12,11,40,0.275000
2025-09-04,NeueHealth,18,18,4,40,0.100000
2025-09-04,New York Life Insurance,14,24,2,40,0.050000
2025-09-04,NewMarket Corporation,15,21,4,40,0.100000
2025-09-04,Newell Brands,19,17,4,40,0.100000
2025-09-04,Newmont,18,16,6,40,0.150000
2025-09-04,News Corp,14,17,9,40,0.225000
2025-09-04,Nexstar Media Group,15,23,2,40,0.050000
2025-09-04,NextEra Energy,31,8,1,40,0.025000
2025-09-04,NiSource,17,15,8,40,0.200000
2025-09-04,Nike,13,24,3,40,0.075000
2025-09-04,Nordson,22,16,2,40,0.050000
2025-09-04,Nordstrom,14,23,3,40,0.075000
2025-09-04,Norfolk Southern,16,14,10,40,0.250000
2025-09-04,Northern Trust,39,1,0,40,0.000000
2025-09-04,Northrop Grumman,22,16,2,40,0.050000
2025-09-04,Northwestern Mutual,32,5,3,40,0.075000
2025-09-04,Nucor,13,25,2,40,0.050000
2025-09-04,Nvidia,12,21,7,40,0.175000
2025-09-04,O'Reilly Automotive,28,10,2,40,0.050000
2025-09-04,O-I Glass,23,11,6,40,0.150000
2025-09-04,ODP Business Solutions,22,17,1,40,0.025000
2025-09-04,OGE Energy,33,7,0,40,0.000000
2025-09-04,Occidental Petroleum,18,12,10,40,0.250000
2025-09-04,Old Dominion Freight Line,19,16,5,40,0.125000
2025-09-04,Old National Bancorp,11,23,6,40,0.150000
2025-09-04,Old Republic International,18,20,2,40,0.050000
2025-09-04,Olin,16,16,8,40,0.200000
2025-09-04,Omnicom Group,20,12,8,40,0.200000
2025-09-04,OneMain,20,17,3,40,0.075000
2025-09-04,Oneok,24,13,3,40,0.075000
2025-09-04,Opendoor Technologies,11,21,8,40,0.200000
2025-09-04,Option Care Health,40,0,0,40,0.000000
2025-09-04,Oracle,10,22,8,40,0.200000
2025-09-04,Organon,14,21,5,40,0.125000
2025-09-04,Oscar Health,15,17,8,40,0.200000
2025-09-04,Oshkosh,16,20,4,40,0.100000
2025-09-04,Otis Worldwide,17,14,9,40,0.225000
2025-09-04,Ovintiv,21,12,7,40,0.175000
2025-09-04,Owens & Minor,8,23,9,40,0.225000
2025-09-04,Owens Corning,21,14,5,40,0.125000
2025-09-04,PACS Group,25,11,4,40,0.100000
2025-09-04,PBF Energy,35,3,2,40,0.050000
2025-09-04,PC Connection Inc,23,15,2,40,0.050000
2025-09-04,PENN Entertainment,37,2,1,40,0.025000
2025-09-04,PG&E,17,13,10,40,0.250000
2025-09-04,PNC Financial Services,20,16,4,40,0.100000
2025-09-04,PPG Industries,23,11,6,40,0.150000
2025-09-04,PPL,23,16,1,40,0.025000
2025-09-04,PVH,17,20,3,40,0.075000
2025-09-04,Paccar,18,14,8,40,0.200000
2025-09-04,Pacific Life,15,24,1,40,0.025000
2025-09-04,Packaging Corp of America,10,25,5,40,0.125000
2025-09-04,Palo Alto Networks,12,16,12,40,0.300000
2025-09-04,Par Pacific,21,15,4,40,0.100000
2025-09-04,Paramount Global,10,28,2,40,0.050000
2025-09-04,Park Hotels & Resorts,12,24,4,40,0.100000
2025-09-04,Parker-Hannifin,18,22,0,40,0.000000
2025-09-04,Parsons Corporation,25,11,4,40,0.100000
2025-09-04,Patrick Industries,19,19,2,40,0.050000
2025-09-04,Patterson Companies Inc,9,27,4,40,0.100000
2025-09-04,Patterson-UTI Energy,33,2,5,40,0.125000
2025-09-04,PayPal,16,14,10,40,0.250000
2025-09-04,Paychex,27,8,5,40,0.125000
2025-09-04,Peabody Energy,35,3,2,40,0.050000
2025-09-04,Peloton,18,14,8,40,0.200000
2025-09-04,Penn Mutual Life Insurance,20,17,3,40,0.075000
2025-09-04,PennyMac Financial Services,26,11,3,40,0.075000
2025-09-04,Penske Automotive,17,18,5,40,0.125000
2025-09-04,PepsiCo,17,18,5,40,0.125000
2025-09-04,Performance Food,15,18,7,40,0.175000
2025-09-04,Permian Resources,20,19,1,40,0.025000
2025-09-04,Petco Health and Wellness,32,7,1,40,0.025000
2025-09-04,Peter Kiewit Sons',6,20,14,40,0.350000
2025-09-04,Pfizer,21,12,7,40,0.175000
2025-09-04,Philip Morris,25,14,1,40,0.025000
2025-09-04,Phillips 66,19,10,11,40,0.275000
2025-09-04,Pinnacle West Capital,22,16,2,40,0.050000
2025-09-04,Pinterest,17,19,4,40,0.100000
2025-09-04,Pioneer Natural Resources,17,13,10,40,0.250000
2025-09-04,Pitney Bowes,30,6,4,40,0.100000
2025-09-04,Plains GP,19,5,16,40,0.400000
2025-09-04,Playtika Holding,15,16,9,40,0.225000
2025-09-04,Plexus,9,20,11,40,0.275000
2025-09-04,Polaris Inc,21,14,5,40,0.125000
2025-09-04,Pool Corporation,19,18,3,40,0.075000
2025-09-04,Popular inc,39,1,0,40,0.000000
2025-09-04,Portland General Electric,18,17,5,40,0.125000
2025-09-04,Post Holdings,17,23,0,40,0.000000
2025-09-04,PriceSmart,17,18,5,40,0.125000
2025-09-04,Primerica,16,21,3,40,0.075000
2025-09-04,Primoris Services,18,17,5,40,0.125000
2025-09-04,Principal Financial,15,20,5,40,0.125000
2025-09-04,ProFrac Holding,14,21,5,40,0.125000
2025-09-04,Procter & Gamble,20,14,6,40,0.150000
2025-09-04,Progressive Insurance,17,20,3,40,0.075000
2025-09-04,Prologis,14,21,5,40,0.125000
2025-09-04,Prudential Financial,21,15,4,40,0.100000
2025-09-04,Public Service Enterprise Group,25,11,4,40,0.100000
2025-09-04,Public Storage,13,20,7,40,0.175000
2025-09-04,Publix Super Markets,22,12,6,40,0.150000
2025-09-04,Puget Sound Energy,29,10,1,40,0.025000
2025-09-04,PulteGroup,27,9,4,40,0.100000
2025-09-04,Pure Storage,16,19,5,40,0.125000
2025-09-04,QVC,18,20,2,40,0.050000
2025-09-04,Qorvo,21,14,5,40,0.125000
2025-09-04,Quad/Graphics,19,14,7,40,0.175000
2025-09-04,Qualcomm,14,21,5,40,0.125000
2025-09-04,Quanta Services,18,15,7,40,0.175000
2025-09-04,Quest Diagnostics,15,22,3,40,0.075000
2025-09-04,QuidelOrtho,19,19,2,40,0.050000
2025-09-04,REV Group,17,18,5,40,0.125000
2025-09-04,RPM International,20,14,6,40,0.150000
2025-09-04,RTX,24,9,7,40,0.175000
2025-09-04,RXO inc,11,20,9,40,0.225000
2025-09-04,Rackspace Technology,17,14,9,40,0.225000
2025-09-04,Radius Recycling,13,14,13,40,0.325000
2025-09-04,Ralph Lauren,27,12,1,40,0.025000
2025-09-04,Range Resources,21,16,3,40,0.075000
2025-09-04,Raymond James Financial,19,18,3,40,0.075000
2025-09-04,Realty Income,19,14,7,40,0.175000
2025-09-04,Regal Rexnord,12,26,2,40,0.050000
2025-09-04,Regeneron Pharmaceuticals,17,18,5,40,0.125000
2025-09-04,Regions Financial,20,20,0,40,0.000000
2025-09-04,Reinsurance Group of America,14,23,3,40,0.075000
2025-09-04,Reliance Inc,24,12,4,40,0.100000
2025-09-04,Republic Services,14,14,12,40,0.300000
2025-09-04,ResMed,12,24,4,40,0.100000
2025-09-04,Resideo Technologies,25,13,2,40,0.050000
2025-09-04,Restoration Hardware,10,25,5,40,0.125000
2025-09-04,Revvity,22,11,7,40,0.175000
2025-09-04,Rite Aid,5,30,5,40,0.125000
2025-09-04,Rithm Capital,18,19,3,40,0.075000
2025-09-04,Rivian Automotive,19,17,4,40,0.100000
2025-09-04,Robert Half,19,18,3,40,0.075000
2025-09-04,Roblox,15,16,9,40,0.225000
2025-09-04,Rocket Companies,17,18,5,40,0.125000
2025-09-04,Rockwell Automation,23,17,0,40,0.000000
2025-09-04,Roku,20,16,4,40,0.100000
2025-09-04,Rollins inc,17,19,4,40,0.100000
2025-09-04,Roper Technologies,23,15,2,40,0.050000
2025-09-04,Ross Stores,10,26,4,40,0.100000
2025-09-04,Rush Enterprises,23,16,1,40,0.025000
2025-09-04,Ryder System,15,16,9,40,0.225000
2025-09-04,Ryerson Holding,21,10,9,40,0.225000
2025-09-04,S&P Global,12,25,3,40,0.075000
2025-09-04,SBA Communications,22,13,5,40,0.125000
2025-09-04,SS&C Technologies,18,20,2,40,0.050000
2025-09-04,Sabre Corporation,23,10,7,40,0.175000
2025-09-04,Saia inc,20,17,3,40,0.075000
2025-09-04,Salesforce,10,12,18,40,0.450000
2025-09-04,Sallie Mae,14,22,4,40,0.100000
2025-09-04,Sally Beauty,40,0,0,40,0.000000
2025-09-04,Sanmina,19,18,3,40,0.075000
2025-09-04,ScanSource,21,16,3,40,0.075000
2025-09-04,Schneider National,13,20,7,40,0.175000
2025-09-04,Science Applications International,21,16,3,40,0.075000
2025-09-04,Scotts Miracle-Gro,27,6,7,40,0.175000
2025-09-04,Seaboard,22,11,7,40,0.175000
2025-09-04,Sealed Air Corporation,14,24,2,40,0.050000
2025-09-04,Securian Financial,11,25,4,40,0.100000
2025-09-04,Select Medical,16,20,4,40,0.100000
2025-09-04,Selective Insurance Group,23,13,4,40,0.100000
2025-09-04,Sempra,23,17,0,40,0.000000
2025-09-04,Sentry Insurance Group,3,7,0,10,0.000000
2025-09-04,Service Corp International,10,8,8,26,0.307692
2025-09-04,ServiceNow,19,14,7,40,0.175000
2025-09-04,Sherwin-Williams,11,22,7,40,0.175000
2025-09-04,Shift4 Payments,13,20,7,40,0.175000
2025-09-04,Silgan,6,26,8,40,0.200000
2025-09-04,Simon Property Group,15,20,5,40,0.125000
2025-09-04,Sinclair,14,23,3,40,0.075000
2025-09-04,SiteOne Landscape Supply,20,18,2,40,0.050000
2025-09-04,Skechers USA,19,16,5,40,0.125000
2025-09-04,SkyWest,9,17,14,40,0.350000
2025-09-04,Skyline Champion,33,4,3,40,0.075000
2025-09-04,Skyworks Solutions,30,4,6,40,0.150000
2025-09-04,Smurfit Westrock,10,22,8,40,0.200000
2025-09-04,Snap Inc,11,15,12,38,0.315789
2025-09-04,Snap-on,13,25,2,40,0.050000
2025-09-04,Snowflake inc,26,11,3,40,0.075000
2025-09-04,Sonic Automotive,20,18,2,40,0.050000
2025-09-04,Sonoco Products,24,12,4,40,0.100000
2025-09-04,Southern Company,27,9,4,40,0.100000
2025-09-04,Southwest Airlines,18,9,13,40,0.325000
2025-09-04,Southwest Gas,20,19,1,40,0.025000
2025-09-04,Southwestern Energy,35,2,3,40,0.075000
2025-09-04,SpartanNash,16,21,3,40,0.075000
2025-09-04,Spectrum Brands,17,17,6,40,0.150000
2025-09-04,Spire inc,19,15,6,40,0.150000
2025-09-04,Spirit AeroSystems,31,2,7,40,0.175000
2025-09-04,Spirit Airlines,29,2,9,40,0.225000
2025-09-04,Splunk,15,15,10,40,0.250000
2025-09-04,Sprouts Farmers Market,11,25,4,40,0.100000
2025-09-04,Stagwell,21,18,1,40,0.025000
2025-09-04,Stanley Black & Decker,11,22,7,40,0.175000
2025-09-04,Starbucks,12,24,4,40,0.100000
2025-09-04,State Farm Insurance,15,18,7,40,0.175000
2025-09-04,State Street,13,21,6,40,0.150000
2025-09-04,Steel Dynamics,33,3,4,40,0.100000
2025-09-04,Steelcase,18,19,3,40,0.075000
2025-09-04,Stericycle,11,9,20,40,0.500000
2025-09-04,Stifel Financial,25,15,0,40,0.000000
2025-09-04,StoneX,21,17,2,40,0.050000
2025-09-04,Stryker,15,15,10,40,0.250000
2025-09-04,Summit Materials,12,24,4,40,0.100000
2025-09-04,Sun Communities,20,18,2,40,0.050000
2025-09-04,Super Micro Computer,33,5,2,40,0.050000
2025-09-04,Surgery Partners,19,16,5,40,0.125000
2025-09-04,Sylvamo,15,21,4,40,0.100000
2025-09-04,Synchrony Financial,20,13,7,40,0.175000
2025-09-04,Synopsys,16,19,5,40,0.125000
2025-09-04,Synovus Financial,16,22,2,40,0.050000
2025-09-04,Sysco,19,17,4,40,0.100000
2025-09-04,T Rowe Price,15,23,2,40,0.050000
2025-09-04,TD Synnex,21,12,7,40,0.175000
2025-09-04,TEGNA,14,23,3,40,0.075000
2025-09-04,TIAA,13,25,2,40,0.050000
2025-09-04,TJX,23,14,3,40,0.075000
2025-09-04,Take-Two Interactive Software,19,17,4,40,0.100000
2025-09-04,Talen Energy,37,2,1,40,0.025000
2025-09-04,Tapestry,14,18,8,40,0.200000
2025-09-04,Targa Resources,21,14,5,40,0.125000
2025-09-04,Target,15,13,12,40,0.300000
2025-09-04,Taylor Morrison Home,15,20,5,40,0.125000
2025-09-04,Teladoc Health,21,15,4,40,0.100000
2025-09-04,Teledyne Technologies,16,16,8,40,0.200000
2025-09-04,Teleflex,14,21,5,40,0.125000
2025-09-04,Telephone & Data Systems,16,16,8,40,0.200000
2025-09-04,TelevisaUnivision,18,17,5,40,0.125000
2025-09-04,Tempur Sealy International,11,23,6,40,0.150000
2025-09-04,Tenet Healthcare,19,18,3,40,0.075000
2025-09-04,Teradyne,11,25,4,40,0.100000
2025-09-04,Terex,17,19,4,40,0.100000
2025-09-04,Tesla,12,18,10,40,0.250000
2025-09-04,Tetra Tech,21,15,4,40,0.100000
2025-09-04,Texas Instruments,12,24,4,40,0.100000
2025-09-04,Texas Roadhouse,16,17,7,40,0.175000
2025-09-04,Textron,16,19,5,40,0.125000
2025-09-04,The Andersons Inc,12,24,4,40,0.100000
2025-09-04,The Coca-Cola Company,12,21,7,40,0.175000
2025-09-04,The Hartford,15,20,5,40,0.125000
2025-09-04,Thermo Fisher Scientific,17,21,2,40,0.050000
2025-09-04,Thor Industries,18,14,8,40,0.200000
2025-09-04,Thrivent Financial for Lutherans,15,20,5,40,0.125000
2025-09-04,Timken,12,24,4,40,0.100000
2025-09-04,Titan Machinery,13,21,6,40,0.150000
2025-09-04,Toast inc,26,13,1,40,0.025000
2025-09-04,Toll Brothers,13,24,3,40,0.075000
2025-09-04,TopBuild,19,17,4,40,0.100000
2025-09-04,Topgolf Callaway Brands,15,16,9,40,0.225000
2025-09-04,Toro Company,18,18,4,40,0.100000
2025-09-04,Tractor Supply,21,13,6,40,0.150000
2025-09-04,TransDigm,19,14,7,40,0.175000
2025-09-04,TransUnion,15,16,9,40,0.225000
2025-09-04,Travelers Insurance,13,18,9,40,0.225000
2025-09-04,TreeHouse Foods,17,18,5,40,0.125000
2025-09-04,Tri Pointe Homes,19,20,1,40,0.025000
2025-09-04,TriNet Group,19,12,9,40,0.225000
2025-09-04,Trimble,8,26,6,40,0.150000
2025-09-04,Trinity Industries,17,16,7,40,0.175000
2025-09-04,TruStage,27,11,2,40,0.050000
2025-09-04,Truist Financial,17,18,5,40,0.125000
2025-09-04,Tutor Perini Corporation,25,6,9,40,0.225000
2025-09-04,Twilio,21,15,4,40,0.100000
2025-09-04,Tyson Foods,10,20,10,40,0.250000
2025-09-04,U-Haul,9,12,19,40,0.475000
2025-09-04,UFP Industries,18,19,3,40,0.075000
2025-09-04,UGI Utilities Inc,20,15,5,40,0.125000
2025-09-04,UL Solutions,36,1,3,40,0.075000
2025-09-04,UPS,12,20,8,40,0.200000
2025-09-04,US Bancorp,19,19,2,40,0.050000
2025-09-04,US Foods,21,17,2,40,0.050000
2025-09-04,USAA,19,13,8,40,0.200000
2025-09-04,Uber,18,15,7,40,0.175000
2025-09-04,Ulta Beauty,37,2,1,40,0.025000
2025-09-04,Under Armour,16,20,4,40,0.100000
2025-09-04,Union Pacific,23,12,5,40,0.125000
2025-09-04,United Airlines,36,1,3,40,0.075000
2025-09-04,United Natural Foods,40,0,0,40,0.000000
2025-09-04,United Rentals,38,2,0,40,0.000000
2025-09-04,United States Steel,35,1,4,40,0.100000
2025-09-04,UnitedHealth,12,18,10,40,0.250000
2025-09-04,Universal Corporation,19,17,4,40,0.100000
2025-09-04,Universal Health Services,14,19,7,40,0.175000
2025-09-04,Unum Group,21,16,3,40,0.075000
2025-09-04,Upbound Group,25,11,4,40,0.100000
2025-09-04,Urban Outfitters,15,17,8,40,0.200000
2025-09-04,V2X,21,15,4,40,0.100000
2025-09-04,VF Corporation,20,19,1,40,0.025000
2025-09-04,VICI Properties,22,17,1,40,0.025000
2025-09-04,Vail Resorts,15,12,13,40,0.325000
2025-09-04,Valero Energy,33,3,4,40,0.100000
2025-09-04,Valley National Bancorp,16,22,2,40,0.050000
2025-09-04,Valmont Industries,17,21,2,40,0.050000
2025-09-04,Valvoline inc,15,20,5,40,0.125000
2025-09-04,Ventas inc,23,11,6,40,0.150000
2025-09-04,Verisk Analytics,11,18,11,40,0.275000
2025-09-04,Verizon,12,19,9,40,0.225000
2025-09-04,Vertex Pharmaceuticals,19,11,10,40,0.250000
2025-09-04,Vertiv,18,19,3,40,0.075000
2025-09-04,Viasat,23,14,3,40,0.075000
2025-09-04,Viatris,11,20,9,40,0.225000
2025-09-04,Victorias Secret,11,18,11,40,0.275000
2025-09-04,Visa,7,20,13,40,0.325000
2025-09-04,Vishay Intertechnology,16,19,5,40,0.125000
2025-09-04,Vista Outdoor,14,22,4,40,0.100000
2025-09-04,Visteon,22,15,3,40,0.075000
2025-09-04,Vistra,19,14,7,40,0.175000
2025-09-04,Vontier,20,17,3,40,0.075000
2025-09-04,Voya Financial,16,16,8,40,0.200000
2025-09-04,Vulcan Materials,15,22,3,40,0.075000
2025-09-04,WEC Energy,36,1,3,40,0.075000
2025-09-04,WESCO International,22,12,6,40,0.150000
2025-09-04,WEX,17,18,5,40,0.125000
2025-09-04,WR Berkley,12,23,5,40,0.125000
2025-09-04,WW Grainger,15,19,6,40,0.150000
2025-09-04,Wabash National,21,13,6,40,0.150000
2025-09-04,Walgreens,6,27,7,40,0.175000
2025-09-04,Walmart,11,15,14,40,0.350000
2025-09-04,Walt Disney,18,17,5,40,0.125000
2025-09-04,Warner Bros Discovery,13,25,2,40,0.050000
2025-09-04,Warner Music Group,20,19,1,40,0.025000
2025-09-04,Waters Corporation,22,15,3,40,0.075000
2025-09-04,Watsco,18,15,7,40,0.175000
2025-09-04,Wayfair,17,21,2,40,0.050000
2025-09-04,Webster Financial,24,10,6,40,0.150000
2025-09-04,Weis Markets,22,13,5,40,0.125000
2025-09-04,Wells Fargo,37,0,3,40,0.075000
2025-09-04,Welltower,33,7,0,40,0.000000
2025-09-04,Werner Enterprises,27,10,3,40,0.075000
2025-09-04,West Pharmaceutical Services,24,15,1,40,0.025000
2025-09-04,Western & Southern Financial,17,20,3,40,0.075000
2025-09-04,Western Alliance Bancorp,14,17,9,40,0.225000
2025-09-04,Western Digital,19,19,2,40,0.050000
2025-09-04,Western Midstream Partners,16,9,15,40,0.375000
2025-09-04,Western Union,17,18,5,40,0.125000
2025-09-04,Westinghouse Air Brake Technologies,19,13,8,40,0.200000
2025-09-04,Westlake Corporation,22,14,4,40,0.100000
2025-09-04,Weyerhaeuser,10,24,6,40,0.150000
2025-09-04,Whirlpool,16,20,4,40,0.100000
2025-09-04,Williams,6,21,13,40,0.325000
2025-09-04,Williams-Sonoma,19,17,4,40,0.100000
2025-09-04,Winnebago Industries,17,15,8,40,0.200000
2025-09-04,Wintrust Financial,18,20,2,40,0.050000
2025-09-04,Woodward inc,18,17,5,40,0.125000
2025-09-04,Workday,16,14,10,40,0.250000
2025-09-04,World Kinect,25,10,5,40,0.125000
2025-09-04,Worthington Enterprises,25,13,2,40,0.050000
2025-09-04,Wynn Resorts,11,18,11,40,0.275000
2025-09-04,XPO,16,22,2,40,0.050000
2025-09-04,Xcel Energy,34,5,1,40,0.025000
2025-09-04,Xerox,13,22,5,40,0.125000
2025-09-04,Xylem Inc,25,11,4,40,0.100000
2025-09-04,Yum Brands,17,21,2,40,0.050000
2025-09-04,Yum China,19,19,2,40,0.050000
2025-09-04,Zebra Technologies,24,13,3,40,0.075000
2025-09-04,Zimmer Biomet,14,21,5,40,0.125000
2025-09-04,Zions Bancorp,18,15,7,40,0.175000
2025-09-04,Zoetis,23,12,5,40,0.125000
2025-09-04,Zoom Video Communications,14,22,4,40,0.100000
2025-09-04,eXp World,13,20,7,40,0.175000
2025-09-04,iHeartMedia,15,21,4,40,0.100000
2025-09-05,3M,16,19,5,40,0.125000
2025-09-05,A O Smith,15,24,1,40,0.025000
2025-09-05,A-Mark Precious Metals,40,0,0,40,0.000000
2025-09-05,ABM Industries,13,17,10,40,0.250000
2025-09-05,ADT,15,19,6,40,0.150000
2025-09-05,AECOM,24,16,0,40,0.000000
2025-09-05,AES,16,19,5,40,0.125000
2025-09-05,AGCO,23,14,3,40,0.075000
2025-09-05,AGNC Investment,17,18,5,40,0.125000
2025-09-05,AMC Entertainment,36,3,1,40,0.025000
2025-09-05,AMC Networks,18,14,8,40,0.200000
2025-09-05,AMN Healthcare Services,20,18,2,40,0.050000
2025-09-05,APA,22,9,9,40,0.225000
2025-09-05,APi Group,19,15,6,40,0.150000
2025-09-05,ARKO,13,24,3,40,0.075000
2025-09-05,ASGN,18,14,8,40,0.200000
2025-09-05,AT&T,12,23,5,40,0.125000
2025-09-05,ATI inc,21,14,5,40,0.125000
2025-09-05,AbbVie,9,25,6,40,0.150000
2025-09-05,Abbott Laboratories,19,15,6,40,0.150000
2025-09-05,Abercrombie & Fitch,15,23,2,40,0.050000
2025-09-05,Academy Sports and Outdoors,17,17,6,40,0.150000
2025-09-05,Acadia Healthcare,14,19,7,40,0.175000
2025-09-05,Acuity Inc,24,15,1,40,0.025000
2025-09-05,Adams Resources & Energy,21,7,1,29,0.034483
2025-09-05,AdaptHealth,20,18,2,40,0.050000
2025-09-05,Adobe,20,14,6,40,0.150000
2025-09-05,Advance Auto Parts,16,15,9,40,0.225000
2025-09-05,Advanced Drainage Systems,33,7,0,40,0.000000
2025-09-05,Advanced Micro Devices,31,7,2,40,0.050000
2025-09-05,Advantage Solutions,37,1,2,40,0.050000
2025-09-05,Aflac,11,15,14,40,0.350000
2025-09-05,Agilent Technologies,16,21,3,40,0.075000
2025-09-05,Agilon Health,19,19,2,40,0.050000
2025-09-05,Air Lease,16,22,2,40,0.050000
2025-09-05,Air Products & Chemicals,15,18,7,40,0.175000
2025-09-05,Airbnb,4,4,2,10,0.200000
2025-09-05,Akamai Technologies,15,20,5,40,0.125000
2025-09-05,Alaska Air,9,25,6,40,0.150000
2025-09-05,Albemarle Corporation,13,22,5,40,0.125000
2025-09-05,Albertsons,17,17,6,40,0.150000
2025-09-05,Alcoa Corporation,14,21,5,40,0.125000
2025-09-05,Alexandria Real Estate Equities,20,15,5,40,0.125000
2025-09-05,Alight Solutions,16,21,3,40,0.075000
2025-09-05,Align Technology,10,18,12,40,0.300000
2025-09-05,Allegiant Travel Company,19,17,4,40,0.100000
2025-09-05,Alliance Resource Partners,14,15,11,40,0.275000
2025-09-05,Alliant Energy,35,2,3,40,0.075000
2025-09-05,Allison Transmission,20,15,5,40,0.125000
2025-09-05,Allstate,21,16,3,40,0.075000
2025-09-05,Ally Financial,13,24,3,40,0.075000
2025-09-05,Alpha Metallurgical Resources,26,11,3,40,0.075000
2025-09-05,Alphabet,24,7,9,40,0.225000
2025-09-05,Altice,14,17,9,40,0.225000
2025-09-05,Altria,17,19,4,40,0.100000
2025-09-05,Amazon,33,4,3,40,0.075000
2025-09-05,Ameren,16,18,6,40,0.150000
2025-09-05,American Airlines,11,21,8,40,0.200000
2025-09-05,American Axle & Manufacturing,18,18,4,40,0.100000
2025-09-05,American Eagle Outfitters,19,17,4,40,0.100000
2025-09-05,American Electric Power,19,16,5,40,0.125000
2025-09-05,American Express,23,9,8,40,0.200000
2025-09-05,American Family Insurance,20,17,3,40,0.075000
2025-09-05,American Financial,19,15,6,40,0.150000
2025-09-05,American International Group,23,16,1,40,0.025000
2025-09-05,American Tower,21,19,0,40,0.000000
2025-09-05,American Water Works,16,19,5,40,0.125000
2025-09-05,Americold Realty Trust,37,2,1,40,0.025000
2025-09-05,Ameriprise Financial,22,16,2,40,0.050000
2025-09-05,Ametek,23,15,2,40,0.050000
2025-09-05,Amgen,14,19,7,40,0.175000
2025-09-05,Amica Mutual Insurance,14,24,2,40,0.050000
2025-09-05,Amkor Technology,10,26,4,40,0.100000
2025-09-05,Amphenol,20,17,3,40,0.075000
2025-09-05,Analog Devices,13,23,4,40,0.100000
2025-09-05,Antero Resources,22,13,5,40,0.125000
2025-09-05,Anywhere Real Estate Inc,22,12,6,40,0.150000
2025-09-05,Apollo Global Management,14,25,1,40,0.025000
2025-09-05,AppLovin,13,22,5,40,0.125000
2025-09-05,Apple,13,26,1,40,0.025000
2025-09-05,Applied Industrial Technologies,13,25,2,40,0.050000
2025-09-05,Applied Materials,8,18,14,40,0.350000
2025-09-05,AptarGroup,17,16,7,40,0.175000
2025-09-05,Aramark,19,19,2,40,0.050000
2025-09-05,ArcBest,12,24,4,40,0.100000
2025-09-05,Arch Resources,30,6,4,40,0.100000
2025-09-05,Archer Daniels Midland,23,13,4,40,0.100000
2025-09-05,Ares Management,22,16,2,40,0.050000
2025-09-05,Arista Networks,20,19,1,40,0.025000
2025-09-05,Arrow Electronics,16,19,5,40,0.125000
2025-09-05,Arthur J Gallagher,12,23,5,40,0.125000
2025-09-05,Asbury Automotive Group,17,22,1,40,0.025000
2025-09-05,Assurant,23,13,4,40,0.100000
2025-09-05,Atkore,22,14,4,40,0.100000
2025-09-05,Atlassian,5,32,3,40,0.075000
2025-09-05,Atmos Energy,36,2,2,40,0.050000
2025-09-05,Auto-Owners Insurance,15,19,6,40,0.150000
2025-09-05,AutoNation,16,21,3,40,0.075000
2025-09-05,AutoZone,17,17,6,40,0.150000
2025-09-05,Autodesk,15,22,3,40,0.075000
2025-09-05,Autoliv,21,17,2,40,0.050000
2025-09-05,Automatic Data Processing,20,16,4,40,0.100000
2025-09-05,AvalonBay Communities,23,13,4,40,0.100000
2025-09-05,Avantor,15,16,9,40,0.225000
2025-09-05,Avery Dennison,11,22,7,40,0.175000
2025-09-05,Avient,14,19,7,40,0.175000
2025-09-05,Avis Budget,14,17,9,40,0.225000
2025-09-05,Avnet,11,22,7,40,0.175000
2025-09-05,BJs Wholesale Club,13,22,5,40,0.125000
2025-09-05,BOK Financial,18,17,5,40,0.125000
2025-09-05,BWX Technologies,29,10,1,40,0.025000
2025-09-05,Baker Hughes,23,15,2,40,0.050000
2025-09-05,Ball,11,22,7,40,0.175000
2025-09-05,Bank of America,13,18,9,40,0.225000
2025-09-05,Bank of New York Mellon,23,14,3,40,0.075000
2025-09-05,Bath & Body Works,13,19,8,40,0.200000
2025-09-05,Baxter International,18,15,7,40,0.175000
2025-09-05,Beacon Roofing Supply,9,23,8,40,0.200000
2025-09-05,Becton Dickinson,14,22,4,40,0.100000
2025-09-05,Belden,16,18,6,40,0.150000
2025-09-05,Benchmark Electronics,25,12,3,40,0.075000
2025-09-05,Berkshire Hathaway,16,15,9,40,0.225000
2025-09-05,Best Buy,40,0,0,40,0.000000
2025-09-05,Big Lots,6,32,2,40,0.050000
2025-09-05,Biogen,21,18,1,40,0.025000
2025-09-05,BlackRock,20,12,8,40,0.200000
2025-09-05,Blackstone,14,23,3,40,0.075000
2025-09-05,Bloomin Brands,10,24,6,40,0.150000
2025-09-05,BlueLinx,26,12,2,40,0.050000
2025-09-05,Boeing,7,20,13,40,0.325000
2025-09-05,Boise Cascade,12,20,8,40,0.200000
2025-09-05,Booking Holdings,13,23,4,40,0.100000
2025-09-05,Booz Allen Hamilton,18,18,4,40,0.100000
2025-09-05,BorgWarner,25,15,0,40,0.000000
2025-09-05,Boston Properties,16,18,6,40,0.150000
2025-09-05,Boston Scientific,17,16,7,40,0.175000
2025-09-05,Boyd Gaming,18,21,1,40,0.025000
2025-09-05,Bread Financial,26,10,4,40,0.100000
2025-09-05,BrightSpring Health Services,22,15,3,40,0.075000
2025-09-05,BrightView Holdings,21,15,4,40,0.100000
2025-09-05,Brighthouse Financial,16,19,5,40,0.125000
2025-09-05,Brinker International,24,13,3,40,0.075000
2025-09-05,Brinks Company,8,3,5,16,0.312500
2025-09-05,Bristol-Myers Squibb,12,23,5,40,0.125000
2025-09-05,Broadcom,14,23,3,40,0.075000
2025-09-05,Broadridge Financial Solutions,32,4,4,40,0.100000
2025-09-05,Brookdale Senior Living,20,12,8,40,0.200000
2025-09-05,Brown & Brown,9,28,3,40,0.075000
2025-09-05,Brown-Forman,8,19,13,40,0.325000
2025-09-05,Bruker,15,16,9,40,0.225000
2025-09-05,Brunswick,10,21,9,40,0.225000
2025-09-05,Builders FirstSource,22,13,5,40,0.125000
2025-09-05,Burlington Stores,18,19,3,40,0.075000
2025-09-05,CACI International,21,15,4,40,0.100000
2025-09-05,CBRE Group,20,19,1,40,0.025000
2025-09-05,CDW,13,24,3,40,0.075000
2025-09-05,CF Industries,23,14,3,40,0.075000
2025-09-05,CH Robinson Worldwide,22,11,7,40,0.175000
2025-09-05,CHS,15,22,3,40,0.075000
2025-09-05,CME Group,18,21,1,40,0.025000
2025-09-05,CMS Energy,36,1,3,40,0.075000
2025-09-05,CNO Financial Group,17,20,3,40,0.075000
2025-09-05,CNX Resources,18,15,7,40,0.175000
2025-09-05,CSX,9,19,12,40,0.300000
2025-09-05,CVS Health,16,16,8,40,0.200000
2025-09-05,Cabot Corporation,17,20,3,40,0.075000
2025-09-05,Cadence,15,24,1,40,0.025000
2025-09-05,Caesars Entertainment,34,6,0,40,0.000000
2025-09-05,Cal-Maine Foods,21,16,3,40,0.075000
2025-09-05,Caleres inc,21,15,4,40,0.100000
2025-09-05,California Resources,21,14,5,40,0.125000
2025-09-05,Calumet,14,14,12,40,0.300000
2025-09-05,Campbell Soup,15,19,6,40,0.150000
2025-09-05,Camping World,9,21,10,40,0.250000
2025-09-05,Capital One,23,13,4,40,0.100000
2025-09-05,CarMax,10,29,1,40,0.025000
2025-09-05,Cardinal Health,21,14,5,40,0.125000
2025-09-05,Carlisle Companies,22,13,5,40,0.125000
2025-09-05,Carlyle Group,14,25,1,40,0.025000
2025-09-05,Carpenter Technology,10,23,7,40,0.175000
2025-09-05,Carrier Global,15,19,6,40,0.150000
2025-09-05,Carters inc,10,23,2,35,0.057143
2025-09-05,Carvana,17,20,3,40,0.075000
2025-09-05,Caseys General Stores,12,23,5,40,0.125000
2025-09-05,Catalent,10,26,4,40,0.100000
2025-09-05,Caterpillar,10,24,6,40,0.150000
2025-09-05,Cboe Global Markets,13,25,2,40,0.050000
2025-09-05,Celanese,15,12,13,40,0.325000
2025-09-05,Cencora,21,13,6,40,0.150000
2025-09-05,Centene,14,9,17,40,0.425000
2025-09-05,CenterPoint Energy,32,4,4,40,0.100000
2025-09-05,Central Garden & Pet,14,20,6,40,0.150000
2025-09-05,Century Communities,18,15,7,40,0.175000
2025-09-05,ChampionX,24,14,2,40,0.050000
2025-09-05,Charles River Laboratories International,19,13,8,40,0.200000
2025-09-05,Charles Schwab,21,17,2,40,0.050000
2025-09-05,Chart Industries,14,25,1,40,0.025000
2025-09-05,Charter Communications,11,20,9,40,0.225000
2025-09-05,Cheesecake Factory,14,15,11,40,0.275000
2025-09-05,Chefs Warehouse,18,14,8,40,0.200000
2025-09-05,Chemours,12,20,8,40,0.200000
2025-09-05,Cheniere Energy,35,2,3,40,0.075000
2025-09-05,Chevron,17,12,11,40,0.275000
2025-09-05,Chewy,25,12,3,40,0.075000
2025-09-05,Chipotle Mexican Grill,13,23,4,40,0.100000
2025-09-05,Chord Energy,35,1,4,40,0.100000
2025-09-05,Church & Dwight,19,19,2,40,0.050000
2025-09-05,Ciena,17,22,1,40,0.025000
2025-09-05,Cigna,18,16,6,40,0.150000
2025-09-05,Cincinnati Financial,17,19,4,40,0.100000
2025-09-05,Cinemark,8,29,3,40,0.075000
2025-09-05,Cintas,22,13,5,40,0.125000
2025-09-05,Cisco Systems,12,24,4,40,0.100000
2025-09-05,Citigroup,26,13,1,40,0.025000
2025-09-05,Citizens Financial Group,14,20,6,40,0.150000
2025-09-05,Civitas Resources,16,15,9,40,0.225000
2025-09-05,Clean Harbors,34,3,3,40,0.075000
2025-09-05,Clear Channel Outdoor Hldgs,8,0,2,10,0.200000
2025-09-05,Cleveland-Cliffs,7,13,20,40,0.500000
2025-09-05,Clorox,18,12,10,40,0.250000
2025-09-05,Cognizant Technology Solutions,37,1,2,40,0.050000
2025-09-05,Coherent,16,18,6,40,0.150000
2025-09-05,Coinbase Global,14,22,4,40,0.100000
2025-09-05,Colgate-Palmolive,12,14,14,40,0.350000
2025-09-05,Columbia Banking System,13,20,7,40,0.175000
2025-09-05,Columbia Sportswear,16,16,8,40,0.200000
2025-09-05,Comcast,19,15,6,40,0.150000
2025-09-05,Comerica,22,17,1,40,0.025000
2025-09-05,Comfort Systems USA,40,0,0,40,0.000000
2025-09-05,CommScope,15,23,2,40,0.050000
2025-09-05,Commercial Metals,16,16,8,40,0.200000
2025-09-05,Community Health Systems,19,15,6,40,0.150000
2025-09-05,Compass,15,19,6,40,0.150000
2025-09-05,Conagra Brands,18,20,2,40,0.050000
2025-09-05,Concentrix,18,15,7,40,0.175000
2025-09-05,Conduent,13,22,5,40,0.125000
2025-09-05,ConocoPhillips,11,21,8,40,0.200000
2025-09-05,Consol Energy,32,6,2,40,0.050000
2025-09-05,Consolidated Edison,16,15,9,40,0.225000
2025-09-05,Constellation Brands,5,13,22,40,0.550000
2025-09-05,Constellation Energy,32,7,1,40,0.025000
2025-09-05,Continental Resources,19,13,8,40,0.200000
2025-09-05,Cooper Cos,8,28,4,40,0.100000
2025-09-05,Cooper-Standard,16,21,3,40,0.075000
2025-09-05,Copart,21,16,3,40,0.075000
2025-09-05,Core & Main,15,23,2,40,0.050000
2025-09-05,Cornerstone Building Brands,16,20,4,40,0.100000
2025-09-05,Corning,11,23,6,40,0.150000
2025-09-05,Corpay,11,26,3,40,0.075000
2025-09-05,Corteva,19,18,3,40,0.075000
2025-09-05,Costco,19,19,2,40,0.050000
2025-09-05,Coterra Energy,36,3,1,40,0.025000
2025-09-05,Coty,14,15,11,40,0.275000
2025-09-05,Country Financial,14,20,6,40,0.150000
2025-09-05,Coupang,18,20,2,40,0.050000
2025-09-05,Cracker Barrel Old Country Store,13,20,7,40,0.175000
2025-09-05,Crocs,6,29,5,40,0.125000
2025-09-05,CrossAmerica Partners,20,8,12,40,0.300000
2025-09-05,CrowdStrike,19,13,8,40,0.200000
2025-09-05,Crown Castle,19,17,4,40,0.100000
2025-09-05,Crown Holdings,18,21,1,40,0.025000
2025-09-05,Cullen Frost Bankers,21,14,5,40,0.125000
2025-09-05,Cummins,9,21,10,40,0.250000
2025-09-05,Curtiss-Wright,14,24,2,40,0.050000
2025-09-05,DR Horton,14,19,7,40,0.175000
2025-09-05,DTE Energy,33,4,3,40,0.075000
2025-09-05,DXC Technology,17,20,3,40,0.075000
2025-09-05,DaVita,12,13,15,40,0.375000
2025-09-05,Dana Incorporated,20,15,5,40,0.125000
2025-09-05,Danaher,11,23,6,40,0.150000
2025-09-05,Darden Restaurants,20,15,5,40,0.125000
2025-09-05,Darling Ingredients,39,1,0,40,0.000000
2025-09-05,Deckers Outdoor,27,13,0,40,0.000000
2025-09-05,Deere,9,20,11,40,0.275000
2025-09-05,Delek US,25,11,4,40,0.100000
2025-09-05,Dell Technologies,18,15,7,40,0.175000
2025-09-05,Delta Air Lines,8,18,14,40,0.350000
2025-09-05,Dentsply Sirona,15,24,1,40,0.025000
2025-09-05,Designer Brands,14,22,4,40,0.100000
2025-09-05,Devon Energy,40,0,0,40,0.000000
2025-09-05,DexCom,14,18,8,40,0.200000
2025-09-05,Diamondback Energy,30,2,8,40,0.200000
2025-09-05,Dicks Sporting Goods,10,25,5,40,0.125000
2025-09-05,Diebold Nixdorf,20,17,3,40,0.075000
2025-09-05,Digital Realty Trust,34,6,0,40,0.000000
2025-09-05,Dillards,13,18,9,40,0.225000
2025-09-05,DocuSign,23,15,2,40,0.050000
2025-09-05,Dollar General,10,20,10,40,0.250000
2025-09-05,Dollar Tree,14,13,13,40,0.325000
2025-09-05,Dominion Energy,29,8,3,40,0.075000
2025-09-05,Dominos Pizza inc,16,18,6,40,0.150000
2025-09-05,Domtar,9,24,7,40,0.175000
2025-09-05,Donaldson Company,24,11,5,40,0.125000
2025-09-05,DoorDash,25,9,6,40,0.150000
2025-09-05,Dover Corporation,21,15,4,40,0.100000
2025-09-05,DraftKings,23,13,4,40,0.100000
2025-09-05,Dream Finders Homes,35,2,3,40,0.075000
2025-09-05,Dropbox,15,21,4,40,0.100000
2025-09-05,DuPont,14,22,4,40,0.100000
2025-09-05,Duke Energy,39,1,0,40,0.000000
2025-09-05,Dycom Industries,18,14,8,40,0.200000
2025-09-05,EMCOR Group,14,19,7,40,0.175000
2025-09-05,EOG Resources,21,17,2,40,0.050000
2025-09-05,EPAM Systems,17,20,3,40,0.075000
2025-09-05,EQT,19,15,6,40,0.150000
2025-09-05,ESAB,13,25,2,40,0.050000
2025-09-05,East West Bancorp,17,20,3,40,0.075000
2025-09-05,Eastman Chemical,8,23,9,40,0.225000
2025-09-05,Ebay,19,17,4,40,0.100000
2025-09-05,EchoStar,14,22,4,40,0.100000
2025-09-05,Ecolab,14,20,6,40,0.150000
2025-09-05,Edison International,9,24,7,40,0.175000
2025-09-05,Edward Jones,15,21,4,40,0.100000
2025-09-05,Edwards Lifesciences,11,13,16,40,0.400000
2025-09-05,Elanco Animal Health,16,22,2,40,0.050000
2025-09-05,Electronic Arts,9,23,8,40,0.200000
2025-09-05,Elevance Health,12,11,17,40,0.425000
2025-09-05,Eli Lilly,15,18,7,40,0.175000
2025-09-05,Emerson Electric,16,23,1,40,0.025000
2025-09-05,EnLink Midstream,16,19,5,40,0.125000
2025-09-05,Encompass Health,15,20,5,40,0.125000
2025-09-05,Endeavor Group,14,21,5,40,0.125000
2025-09-05,EnerSys,18,18,4,40,0.100000
2025-09-05,Energizer,37,3,0,40,0.000000
2025-09-05,Energy Transfer,35,2,3,40,0.075000
2025-09-05,Ensign Group,24,13,3,40,0.075000
2025-09-05,Entegris,20,16,4,40,0.100000
2025-09-05,Entergy,23,12,5,40,0.125000
2025-09-05,Enterprise Products Partners,17,12,11,40,0.275000
2025-09-05,Envista,20,17,3,40,0.075000
2025-09-05,Equifax,22,14,4,40,0.100000
2025-09-05,Equinix,22,17,1,40,0.025000
2025-09-05,Equitable,20,17,3,40,0.075000
2025-09-05,Equity Residential,16,13,11,40,0.275000
2025-09-05,Erie Insurance,14,14,12,40,0.300000
2025-09-05,Estée Lauder,12,21,7,40,0.175000
2025-09-05,Etsy,12,18,10,40,0.250000
2025-09-05,Euronet Worldwide,18,18,4,40,0.100000
2025-09-05,Evergy,23,11,6,40,0.150000
2025-09-05,Eversource Energy,31,4,5,40,0.125000
2025-09-05,Exact Sciences,13,16,11,40,0.275000
2025-09-05,Exelon,19,19,2,40,0.050000
2025-09-05,Expand Energy,39,1,0,40,0.000000
2025-09-05,Expedia,19,20,1,40,0.025000
2025-09-05,Expeditors International of Washington,23,14,3,40,0.075000
2025-09-05,Extra Space Storage,17,19,4,40,0.100000
2025-09-05,Exxon Mobil,14,24,2,40,0.050000
2025-09-05,F5,14,23,3,40,0.075000
2025-09-05,FM Global,13,17,10,40,0.250000
2025-09-05,FMC Corporation,13,24,3,40,0.075000
2025-09-05,FTI Consulting,16,17,7,40,0.175000
2025-09-05,Fannie Mae,6,31,3,40,0.075000
2025-09-05,Farmers Insurance Exchange,10,17,13,40,0.325000
2025-09-05,Fastenal,17,19,4,40,0.100000
2025-09-05,FedEx,12,17,11,40,0.275000
2025-09-05,Federated Mutual Insurance,19,19,2,40,0.050000
2025-09-05,Fidelity National Financial,16,19,5,40,0.125000
2025-09-05,Fidelity National Information Services,25,14,1,40,0.025000
2025-09-05,Fifth Third Bancorp,26,12,2,40,0.050000
2025-09-05,First American Financial,19,17,4,40,0.100000
2025-09-05,First Citizens BancShares,16,18,6,40,0.150000
2025-09-05,First Horizon,12,27,1,40,0.025000
2025-09-05,First National of Nebraska,18,22,0,40,0.000000
2025-09-05,First Solar,22,11,7,40,0.175000
2025-09-05,FirstCash,17,18,5,40,0.125000
2025-09-05,FirstEnergy,18,17,5,40,0.125000
2025-09-05,Fiserv,18,18,4,40,0.100000
2025-09-05,Five Below,14,19,7,40,0.175000
2025-09-05,Flagstar Financial,19,18,3,40,0.075000
2025-09-05,Floor & Decor,21,16,3,40,0.075000
2025-09-05,Flowers Foods,15,19,6,40,0.150000
2025-09-05,Flowserve,19,14,7,40,0.175000
2025-09-05,Fluor,13,18,9,40,0.225000
2025-09-05,Foot Locker,13,19,8,40,0.200000
2025-09-05,Ford Motor,19,18,3,40,0.075000
2025-09-05,Fortinet,14,18,8,40,0.200000
2025-09-05,Fortive,20,16,4,40,0.100000
2025-09-05,Fortune Brands Innovations,21,16,3,40,0.075000
2025-09-05,Franklin Resources,16,19,5,40,0.125000
2025-09-05,Freddie Mac,13,22,5,40,0.125000
2025-09-05,Freeport-McMoRan,21,16,3,40,0.075000
2025-09-05,Frontier Airlines,10,22,8,40,0.200000
2025-09-05,Frontier Communications,20,15,5,40,0.125000
2025-09-05,G-III Apparel Group,15,22,3,40,0.075000
2025-09-05,GE HealthCare Technologies,16,19,5,40,0.125000
2025-09-05,GMS,20,18,2,40,0.050000
2025-09-05,GXO Logistics,15,18,7,40,0.175000
2025-09-05,GameStop,10,18,12,40,0.300000
2025-09-05,Gannett,17,12,11,40,0.275000
2025-09-05,Garrett Motion inc,14,21,5,40,0.125000
2025-09-05,Gartner,13,20,7,40,0.175000
2025-09-05,Gen Digital,22,15,3,40,0.075000
2025-09-05,Generac,17,17,6,40,0.150000
2025-09-05,General Dynamics,40,0,0,40,0.000000
2025-09-05,General Electric,11,25,4,40,0.100000
2025-09-05,General Mills,19,18,3,40,0.075000
2025-09-05,General Motors,12,18,10,40,0.250000
2025-09-05,Genesis Energy,36,2,2,40,0.050000
2025-09-05,Genuine Parts,15,21,4,40,0.100000
2025-09-05,Genworth Financial,21,16,3,40,0.075000
2025-09-05,Gilead Sciences,11,24,5,40,0.125000
2025-09-05,Global Partners,16,13,11,40,0.275000
2025-09-05,Global Payments,14,23,3,40,0.075000
2025-09-05,Globe Life,20,15,5,40,0.125000
2025-09-05,GoDaddy,15,17,8,40,0.200000
2025-09-05,Goldman Sachs,11,24,5,40,0.125000
2025-09-05,Goodyear Tire & Rubber,13,22,5,40,0.125000
2025-09-05,Graham Holdings Company,24,12,4,40,0.100000
2025-09-05,Granite Construction,18,17,5,40,0.125000
2025-09-05,Graphic Packaging,14,21,5,40,0.125000
2025-09-05,Gray Television,12,22,6,40,0.150000
2025-09-05,Graybar Electric,13,23,4,40,0.100000
2025-09-05,Green Plains inc,18,16,6,40,0.150000
2025-09-05,Greenbrier,12,13,15,40,0.375000
2025-09-05,Greif,11,23,6,40,0.150000
2025-09-05,Griffon Corporation,20,17,3,40,0.075000
2025-09-05,Grocery Outlet Holding,17,18,5,40,0.125000
2025-09-05,Group 1 Automotive,14,21,5,40,0.125000
2025-09-05,Guardian Life insurance,18,22,0,40,0.000000
2025-09-05,Guess inc,18,19,3,40,0.075000
2025-09-05,H B Fuller,22,16,2,40,0.050000
2025-09-05,HCA Healthcare,22,10,8,40,0.200000
2025-09-05,HEICO,17,22,1,40,0.025000
2025-09-05,HF Sinclair,19,18,3,40,0.075000
2025-09-05,Halliburton,14,15,11,40,0.275000
2025-09-05,Hanesbrands,11,26,3,40,0.075000
2025-09-05,Hanover Insurance Group,20,19,1,40,0.025000
2025-09-05,Harley-Davidson,12,19,9,40,0.225000
2025-09-05,Hasbro,22,14,4,40,0.100000
2025-09-05,Hawaiian Airlines inc,17,23,0,40,0.000000
2025-09-05,Hawaiian Electric Industries,23,16,1,40,0.025000
2025-09-05,Helmerich & Payne,14,23,3,40,0.075000
2025-09-05,Henry Schein,16,19,5,40,0.125000
2025-09-05,Herc Rentals,18,16,6,40,0.150000
2025-09-05,Hershey,17,20,3,40,0.075000
2025-09-05,Hertz,24,5,11,40,0.275000
2025-09-05,Hewlett Packard,20,19,1,40,0.025000
2025-09-05,Hewlett Packard Enterprise,19,21,0,40,0.000000
2025-09-05,Hillenbrand,15,23,2,40,0.050000
2025-09-05,Hilton Grand Vacations,39,0,1,40,0.025000
2025-09-05,Hilton Worldwide,17,20,3,40,0.075000
2025-09-05,Hologic,13,23,4,40,0.100000
2025-09-05,Home Depot,20,14,6,40,0.150000
2025-09-05,Honeywell,15,23,2,40,0.050000
2025-09-05,Hormel Foods,10,24,6,40,0.150000
2025-09-05,Host Hotels & Resorts,11,26,3,40,0.075000
2025-09-05,Hovnanian Enterprises,26,12,2,40,0.050000
2025-09-05,Howmet Aerospace,15,20,5,40,0.125000
2025-09-05,Hub Group,15,19,6,40,0.150000
2025-09-05,Hubbell,11,22,7,40,0.175000
2025-09-05,Humana,17,19,4,40,0.100000
2025-09-05,Huntington Bancshares,18,18,4,40,0.100000
2025-09-05,Huntington Ingalls Industries,21,15,4,40,0.100000
2025-09-05,Huntsman,12,18,10,40,0.250000
2025-09-05,Hyatt Hotels,21,18,1,40,0.025000
2025-09-05,Hyster-Yale,22,16,2,40,0.050000
2025-09-05,IAC,15,18,7,40,0.175000
2025-09-05,IBM,15,22,3,40,0.075000
2025-09-05,IDEX,22,14,4,40,0.100000
2025-09-05,IDEXX Laboratories,21,16,3,40,0.075000
2025-09-05,IQVIA,27,12,1,40,0.025000
2025-09-05,ITT,14,21,5,40,0.125000
2025-09-05,Icahn Enterprises,8,20,12,40,0.300000
2025-09-05,Illinois Tool Works,21,14,5,40,0.125000
2025-09-05,Illumina inc,19,18,3,40,0.075000
2025-09-05,Incyte,20,18,2,40,0.050000
2025-09-05,Ingersoll Rand,18,15,7,40,0.175000
2025-09-05,Ingles Markets,12,20,8,40,0.200000
2025-09-05,Ingram Micro,10,18,12,40,0.300000
2025-09-05,Ingredion,23,14,3,40,0.075000
2025-09-05,Insight Enterprises,10,25,5,40,0.125000
2025-09-05,Insperity,16,15,9,40,0.225000
2025-09-05,Instacart,24,10,6,40,0.150000
2025-09-05,Installed Building Products,14,20,6,40,0.150000
2025-09-05,Intel,13,20,7,40,0.175000
2025-09-05,Interactive Brokers,13,24,3,40,0.075000
2025-09-05,Intercontinental Exchange,10,29,1,40,0.025000
2025-09-05,International Flavors & Fragrances,16,17,7,40,0.175000
2025-09-05,International Paper,6,31,3,40,0.075000
2025-09-05,Interpublic Group,25,13,2,40,0.050000
2025-09-05,Intuit,16,22,2,40,0.050000
2025-09-05,Intuitive Surgical,10,23,7,40,0.175000
2025-09-05,Iron Mountain,8,26,6,40,0.150000
2025-09-05,JB Hunt Transport Services,13,22,5,40,0.125000
2025-09-05,JELD-WEN Holding,21,14,5,40,0.125000
2025-09-05,JM Smucker,14,21,5,40,0.125000
2025-09-05,JPMorgan Chase,12,27,1,40,0.025000
2025-09-05,Jabil,11,25,4,40,0.100000
2025-09-05,Jackson Financial,15,24,1,40,0.025000
2025-09-05,Jacobs Solutions,32,1,7,40,0.175000
2025-09-05,Jefferies Financial,15,21,4,40,0.100000
2025-09-05,JetBlue Airways,25,11,4,40,0.100000
2025-09-05,Johnson & Johnson,19,18,3,40,0.075000
2025-09-05,Jones Lang LaSalle,17,18,5,40,0.125000
2025-09-05,Juniper Networks,18,19,3,40,0.075000
2025-09-05,KB Home,21,14,5,40,0.125000
2025-09-05,KBR,28,10,2,40,0.050000
2025-09-05,KKR,14,23,3,40,0.075000
2025-09-05,KLA,15,18,7,40,0.175000
2025-09-05,Kaiser Aluminum,18,17,5,40,0.125000
2025-09-05,Kellanova,18,16,6,40,0.150000
2025-09-05,Kelly Services inc,21,12,7,40,0.175000
2025-09-05,Kemper,17,17,6,40,0.150000
2025-09-05,Keurig Dr Pepper,2,34,4,40,0.100000
2025-09-05,KeyCorp,13,19,8,40,0.200000
2025-09-05,Keysight Technologies,21,17,2,40,0.050000
2025-09-05,Kimberly-Clark,13,20,7,40,0.175000
2025-09-05,Kinder Morgan,40,0,0,40,0.000000
2025-09-05,Kirby Corporation,23,12,5,40,0.125000
2025-09-05,Knife River Corporation,22,17,1,40,0.025000
2025-09-05,Knight Swift Transportation,29,3,8,40,0.200000
2025-09-05,Kohls,14,19,7,40,0.175000
2025-09-05,Kontoor Brands,16,23,1,40,0.025000
2025-09-05,Korn Ferry,21,11,8,40,0.200000
2025-09-05,Kraft Heinz,8,27,5,40,0.125000
2025-09-05,Kroger,17,12,11,40,0.275000
2025-09-05,Kyndryl,15,22,3,40,0.075000
2025-09-05,L3Harris Technologies,22,13,5,40,0.125000
2025-09-05,LCI Industries,19,18,3,40,0.075000
2025-09-05,LKQ,20,19,1,40,0.025000
2025-09-05,LPL Financial,26,10,4,40,0.100000
2025-09-05,Labcorp Holdings,14,20,6,40,0.150000
2025-09-05,Lam Research,15,18,7,40,0.175000
2025-09-05,Lamb Weston,16,20,4,40,0.100000
2025-09-05,Land O'Lakes,14,23,3,40,0.075000
2025-09-05,Landstar System,13,19,8,40,0.200000
2025-09-05,Las Vegas Sands,17,19,4,40,0.100000
2025-09-05,Lear Corporation,20,15,5,40,0.125000
2025-09-05,Leggett & Platt,19,16,5,40,0.125000
2025-09-05,Leidos,25,12,3,40,0.075000
2025-09-05,Lennar,11,26,3,40,0.075000
2025-09-05,Lennox International,22,13,5,40,0.125000
2025-09-05,Levi Strauss,15,23,2,40,0.050000
2025-09-05,Liberty Energy,40,0,0,40,0.000000
2025-09-05,Liberty Media,39,1,0,40,0.000000
2025-09-05,Liberty Mutual Insurance,35,1,4,40,0.100000
2025-09-05,Light & Wonder,15,21,4,40,0.100000
2025-09-05,Lincoln Electric,13,23,4,40,0.100000
2025-09-05,Lincoln National,14,17,9,40,0.225000
2025-09-05,Lithia Motors,18,18,4,40,0.100000
2025-09-05,Live Nation Entertainment,35,3,2,40,0.050000
2025-09-05,Lockheed Martin,21,9,10,40,0.250000
2025-09-05,Loews,16,17,7,40,0.175000
2025-09-05,Louisiana-Pacific Corporation,17,17,6,40,0.150000
2025-09-05,Lowes,13,24,3,40,0.075000
2025-09-05,Lululemon athletica,10,15,15,40,0.375000
2025-09-05,Lumen Technologies,13,22,5,40,0.125000
2025-09-05,Lyft,16,16,8,40,0.200000
2025-09-05,M&T Bank,21,17,2,40,0.050000
2025-09-05,M/I Homes,16,19,5,40,0.125000
2025-09-05,MDU Resources Group,19,12,9,40,0.225000
2025-09-05,MGM Resorts International,14,23,3,40,0.075000
2025-09-05,MKS Instruments,21,15,4,40,0.100000
2025-09-05,MRC Global,20,17,3,40,0.075000
2025-09-05,MSC Industrial Direct,21,16,3,40,0.075000
2025-09-05,MSCI,22,15,3,40,0.075000
2025-09-05,MYR Group,20,17,3,40,0.075000
2025-09-05,Macys,23,12,5,40,0.125000
2025-09-05,ManpowerGroup,21,16,3,40,0.075000
2025-09-05,Marathon Oil,14,22,4,40,0.100000
2025-09-05,Marathon Petroleum,25,15,0,40,0.000000
2025-09-05,Markel Group,28,10,2,40,0.050000
2025-09-05,Marriott International,10,25,5,40,0.125000
2025-09-05,Marriott Vacations Worldwide,19,17,4,40,0.100000
2025-09-05,Marsh & McLennan,15,22,3,40,0.075000
2025-09-05,Martin Marietta Materials,20,15,5,40,0.125000
2025-09-05,Marvell Technology,15,16,9,40,0.225000
2025-09-05,MasTec,14,22,4,40,0.100000
2025-09-05,Masco,14,15,11,40,0.275000
2025-09-05,Mass Mutual,13,24,3,40,0.075000
2025-09-05,MasterBrand,18,21,1,40,0.025000
2025-09-05,Mastercard,15,20,5,40,0.125000
2025-09-05,Matador Resources,19,18,3,40,0.075000
2025-09-05,Match Group,13,15,12,40,0.300000
2025-09-05,Mativ,15,19,6,40,0.150000
2025-09-05,Matson inc,17,20,3,40,0.075000
2025-09-05,Mattel,13,19,8,40,0.200000
2025-09-05,Maximus,19,18,3,40,0.075000
2025-09-05,McCormick & Company,19,18,3,40,0.075000
2025-09-05,McDonalds,20,9,11,40,0.275000
2025-09-05,McKesson,18,18,4,40,0.100000
2025-09-05,Medical Mutual of Ohio,16,19,5,40,0.125000
2025-09-05,Merck,19,17,4,40,0.100000
2025-09-05,Mercury General,12,21,7,40,0.175000
2025-09-05,Meritage Homes,22,15,3,40,0.075000
2025-09-05,MetLife,14,21,5,40,0.125000
2025-09-05,Meta,13,19,8,40,0.200000
2025-09-05,Mettler-Toledo International,18,17,5,40,0.125000
2025-09-05,Microchip Technology,17,19,4,40,0.100000
2025-09-05,Micron Technology,18,16,6,40,0.150000
2025-09-05,Microsoft,7,22,11,40,0.275000
2025-09-05,Middleby,14,20,6,40,0.150000
2025-09-05,MillerKnoll,16,22,2,40,0.050000
2025-09-05,Moderna,15,11,14,40,0.350000
2025-09-05,ModivCare,10,21,9,40,0.225000
2025-09-05,Mohawk Industries,22,11,7,40,0.175000
2025-09-05,Molina Healthcare,11,16,13,40,0.325000
2025-09-05,Molson Coors Beverage,18,15,7,40,0.175000
2025-09-05,Mondelez,13,18,9,40,0.225000
2025-09-05,Monster Beverage,22,15,3,40,0.075000
2025-09-05,Moodys Corporation,3,11,2,16,0.125000
2025-09-05,Moog inc,18,17,5,40,0.125000
2025-09-05,Morgan Stanley,15,16,9,40,0.225000
2025-09-05,Mosaic,18,20,2,40,0.050000
2025-09-05,Motorola Solutions,35,0,5,40,0.125000
2025-09-05,Mueller Industries,18,19,3,40,0.075000
2025-09-05,Murphy Oil,21,12,7,40,0.175000
2025-09-05,Murphy USA,20,16,4,40,0.100000
2025-09-05,Mutual of Omaha,18,18,4,40,0.100000
2025-09-05,NCR Atleos,17,17,6,40,0.150000
2025-09-05,NCR Voyix,13,23,4,40,0.100000
2025-09-05,NGL Energy Partners,36,1,3,40,0.075000
2025-09-05,NLV Financial,4,4,2,10,0.200000
2025-09-05,NOV,7,26,7,40,0.175000
2025-09-05,NRG Energy,37,1,2,40,0.050000
2025-09-05,NVR,11,24,5,40,0.125000
2025-09-05,Nasdaq,12,22,6,40,0.150000
2025-09-05,Nationwide,15,8,17,40,0.425000
2025-09-05,Navient,17,17,6,40,0.150000
2025-09-05,NetApp,16,22,2,40,0.050000
2025-09-05,Netflix,17,10,13,40,0.325000
2025-09-05,NeueHealth,18,19,3,40,0.075000
2025-09-05,New York Life Insurance,15,23,2,40,0.050000
2025-09-05,NewMarket Corporation,16,18,6,40,0.150000
2025-09-05,Newell Brands,22,13,5,40,0.125000
2025-09-05,Newmont,17,18,5,40,0.125000
2025-09-05,News Corp,14,17,9,40,0.225000
2025-09-05,Nexstar Media Group,12,26,2,40,0.050000
2025-09-05,NextEra Energy,32,5,3,40,0.075000
2025-09-05,NiSource,20,12,8,40,0.200000
2025-09-05,Nike,13,20,7,40,0.175000
2025-09-05,Nordson,20,17,3,40,0.075000
2025-09-05,Nordstrom,17,22,1,40,0.025000
2025-09-05,Norfolk Southern,17,16,7,40,0.175000
2025-09-05,Northern Trust,38,2,0,40,0.000000
2025-09-05,Northrop Grumman,21,16,3,40,0.075000
2025-09-05,Northwestern Mutual,27,10,3,40,0.075000
2025-09-05,Nucor,14,24,2,40,0.050000
2025-09-05,Nvidia,17,15,8,40,0.200000
2025-09-05,O'Reilly Automotive,25,11,4,40,0.100000
2025-09-05,O-I Glass,15,17,8,40,0.200000
2025-09-05,ODP Business Solutions,22,17,1,40,0.025000
2025-09-05,OGE Energy,33,7,0,40,0.000000
2025-09-05,ON Semiconductor,15,16,9,40,0.225000
2025-09-05,Occidental Petroleum,11,20,9,40,0.225000
2025-09-05,Old Dominion Freight Line,21,12,7,40,0.175000
2025-09-05,Old National Bancorp,15,23,2,40,0.050000
2025-09-05,Old Republic International,20,17,3,40,0.075000
2025-09-05,Olin,12,17,11,40,0.275000
2025-09-05,Omnicom Group,20,15,5,40,0.125000
2025-09-05,OneMain,14,24,2,40,0.050000
2025-09-05,Oneok,25,14,1,40,0.025000
2025-09-05,Opendoor Technologies,7,22,11,40,0.275000
2025-09-05,Option Care Health,40,0,0,40,0.000000
2025-09-05,Oracle,7,20,13,40,0.325000
2025-09-05,Organon,14,20,6,40,0.150000
2025-09-05,Oscar Health,14,17,9,40,0.225000
2025-09-05,Oshkosh,14,18,8,40,0.200000
2025-09-05,Otis Worldwide,18,17,5,40,0.125000
2025-09-05,Ovintiv,22,13,5,40,0.125000
2025-09-05,Owens & Minor,7,25,8,40,0.200000
2025-09-05,Owens Corning,14,24,2,40,0.050000
2025-09-05,PACS Group,22,13,5,40,0.125000
2025-09-05,PBF Energy,36,2,2,40,0.050000
2025-09-05,PC Connection Inc,19,18,3,40,0.075000
2025-09-05,PENN Entertainment,38,2,0,40,0.000000
2025-09-05,PG&E,19,14,7,40,0.175000
2025-09-05,PNC Financial Services,17,21,2,40,0.050000
2025-09-05,PPG Industries,20,13,7,40,0.175000
2025-09-05,PPL,23,16,1,40,0.025000
2025-09-05,PVH,12,21,7,40,0.175000
2025-09-05,Paccar,17,15,8,40,0.200000
2025-09-05,Pacific Life,15,24,1,40,0.025000
2025-09-05,Packaging Corp of America,10,25,5,40,0.125000
2025-09-05,Palo Alto Networks,16,13,11,40,0.275000
2025-09-05,Par Pacific,22,16,2,40,0.050000
2025-09-05,Paramount Global,9,24,7,40,0.175000
2025-09-05,Park Hotels & Resorts,10,26,4,40,0.100000
2025-09-05,Parker-Hannifin,22,16,2,40,0.050000
2025-09-05,Parsons Corporation,24,12,4,40,0.100000
2025-09-05,Patrick Industries,18,19,3,40,0.075000
2025-09-05,Patterson Companies Inc,8,26,6,40,0.150000
2025-09-05,Patterson-UTI Energy,35,2,3,40,0.075000
2025-09-05,PayPal,18,13,9,40,0.225000
2025-09-05,Paychex,23,15,2,40,0.050000
2025-09-05,Peabody Energy,36,3,1,40,0.025000
2025-09-05,Peloton,17,20,3,40,0.075000
2025-09-05,Penn Mutual Life Insurance,20,17,3,40,0.075000
2025-09-05,PennyMac Financial Services,25,13,2,40,0.050000
2025-09-05,Penske Automotive,18,16,6,40,0.150000
2025-09-05,PepsiCo,10,25,5,40,0.125000
2025-09-05,Performance Food,13,20,7,40,0.175000
2025-09-05,Permian Resources,23,15,2,40,0.050000
2025-09-05,Petco Health and Wellness,34,5,1,40,0.025000
2025-09-05,Peter Kiewit Sons',6,20,14,40,0.350000
2025-09-05,Pfizer,23,10,7,40,0.175000
2025-09-05,Philip Morris,21,16,3,40,0.075000
2025-09-05,Phillips 66,20,10,10,40,0.250000
2025-09-05,Pinnacle West Capital,22,13,5,40,0.125000
2025-09-05,Pinterest,16,21,3,40,0.075000
2025-09-05,Pioneer Natural Resources,20,10,10,40,0.250000
2025-09-05,Pitney Bowes,26,12,2,40,0.050000
2025-09-05,Plains GP,14,10,16,40,0.400000
2025-09-05,Playtika Holding,15,18,7,40,0.175000
2025-09-05,Plexus,7,20,13,40,0.325000
2025-09-05,Polaris Inc,20,14,6,40,0.150000
2025-09-05,Pool Corporation,18,19,3,40,0.075000
2025-09-05,Popular inc,39,1,0,40,0.000000
2025-09-05,Portland General Electric,17,23,0,40,0.000000
2025-09-05,Post Holdings,16,24,0,40,0.000000
2025-09-05,PriceSmart,19,18,3,40,0.075000
2025-09-05,Primerica,17,18,5,40,0.125000
2025-09-05,Primoris Services,22,17,1,40,0.025000
2025-09-05,Principal Financial,18,19,3,40,0.075000
2025-09-05,ProFrac Holding,18,18,4,40,0.100000
2025-09-05,Procter & Gamble,20,17,3,40,0.075000
2025-09-05,Progressive Insurance,17,20,3,40,0.075000
2025-09-05,Prologis,21,16,3,40,0.075000
2025-09-05,Prudential Financial,24,13,3,40,0.075000
2025-09-05,Public Service Enterprise Group,23,12,5,40,0.125000
2025-09-05,Public Storage,12,22,6,40,0.150000
2025-09-05,Publix Super Markets,19,16,5,40,0.125000
2025-09-05,Puget Sound Energy,28,11,1,40,0.025000
2025-09-05,PulteGroup,25,10,5,40,0.125000
2025-09-05,Pure Storage,15,17,8,40,0.200000
2025-09-05,QVC,17,21,2,40,0.050000
2025-09-05,Qorvo,16,22,2,40,0.050000
2025-09-05,Quad/Graphics,17,17,6,40,0.150000
2025-09-05,Qualcomm,17,22,1,40,0.025000
2025-09-05,Quanta Services,15,20,5,40,0.125000
2025-09-05,Quest Diagnostics,15,21,4,40,0.100000
2025-09-05,QuidelOrtho,20,15,5,40,0.125000
2025-09-05,REV Group,21,11,8,40,0.200000
2025-09-05,RPM International,18,20,2,40,0.050000
2025-09-05,RTX,21,15,4,40,0.100000
2025-09-05,RXO inc,19,14,7,40,0.175000
2025-09-05,Rackspace Technology,18,15,7,40,0.175000
2025-09-05,Radius Recycling,13,13,14,40,0.350000
2025-09-05,Ralph Lauren,20,14,6,40,0.150000
2025-09-05,Range Resources,19,18,3,40,0.075000
2025-09-05,Raymond James Financial,19,20,1,40,0.025000
2025-09-05,Realty Income,19,15,6,40,0.150000
2025-09-05,Regal Rexnord,15,19,6,40,0.150000
2025-09-05,Regeneron Pharmaceuticals,22,15,3,40,0.075000
2025-09-05,Regions Financial,19,20,1,40,0.025000
2025-09-05,Reinsurance Group of America,17,18,5,40,0.125000
2025-09-05,Reliance Inc,23,10,7,40,0.175000
2025-09-05,Republic Services,14,14,12,40,0.300000
2025-09-05,ResMed,15,21,4,40,0.100000
2025-09-05,Resideo Technologies,25,14,1,40,0.025000
2025-09-05,Restoration Hardware,11,26,3,40,0.075000
2025-09-05,Revvity,18,14,8,40,0.200000
2025-09-05,Rite Aid,4,29,7,40,0.175000
2025-09-05,Rithm Capital,17,23,0,40,0.000000
2025-09-05,Rivian Automotive,12,22,6,40,0.150000
2025-09-05,Robert Half,23,15,2,40,0.050000
2025-09-05,Roblox,16,12,12,40,0.300000
2025-09-05,Rocket Companies,21,17,2,40,0.050000
2025-09-05,Rockwell Automation,21,18,1,40,0.025000
2025-09-05,Roku,22,15,3,40,0.075000
2025-09-05,Rollins inc,15,20,5,40,0.125000
2025-09-05,Roper Technologies,18,18,4,40,0.100000
2025-09-05,Ross Stores,14,22,4,40,0.100000
2025-09-05,Rush Enterprises,22,16,2,40,0.050000
2025-09-05,Ryder System,21,13,6,40,0.150000
2025-09-05,Ryerson Holding,16,18,6,40,0.150000
2025-09-05,S&P Global,11,25,4,40,0.100000
2025-09-05,SBA Communications,20,13,7,40,0.175000
2025-09-05,SS&C Technologies,19,18,3,40,0.075000
2025-09-05,Sabre Corporation,22,12,6,40,0.150000
2025-09-05,Saia inc,20,16,4,40,0.100000
2025-09-05,Salesforce,8,15,17,40,0.425000
2025-09-05,Sallie Mae,16,20,4,40,0.100000
2025-09-05,Sally Beauty,40,0,0,40,0.000000
2025-09-05,Sanmina,17,20,3,40,0.075000
2025-09-05,ScanSource,22,16,2,40,0.050000
2025-09-05,Schneider National,19,16,5,40,0.125000
2025-09-05,Science Applications International,23,15,2,40,0.050000
2025-09-05,Scotts Miracle-Gro,24,11,5,40,0.125000
2025-09-05,Seaboard,19,15,6,40,0.150000
2025-09-05,Sealed Air Corporation,21,17,2,40,0.050000
2025-09-05,Securian Financial,11,25,4,40,0.100000
2025-09-05,Select Medical,18,16,6,40,0.150000
2025-09-05,Selective Insurance Group,23,13,4,40,0.100000
2025-09-05,Sempra,22,17,1,40,0.025000
2025-09-05,Sentry Insurance Group,3,7,0,10,0.000000
2025-09-05,Service Corp International,10,9,8,27,0.296296
2025-09-05,ServiceNow,18,17,5,40,0.125000
2025-09-05,Sherwin-Williams,14,17,9,40,0.225000
2025-09-05,Shift4 Payments,14,18,8,40,0.200000
2025-09-05,Silgan,10,23,7,40,0.175000
2025-09-05,Simon Property Group,15,19,6,40,0.150000
2025-09-05,Sinclair,8,23,9,40,0.225000
2025-09-05,SiteOne Landscape Supply,17,16,7,40,0.175000
2025-09-05,Skechers USA,11,23,6,40,0.150000
2025-09-05,SkyWest,8,16,16,40,0.400000
2025-09-05,Skyline Champion,33,4,3,40,0.075000
2025-09-05,Skyworks Solutions,32,5,3,40,0.075000
2025-09-05,Smurfit Westrock,9,23,8,40,0.200000
2025-09-05,Snap Inc,14,14,12,40,0.300000
2025-09-05,Snap-on,8,28,4,40,0.100000
2025-09-05,Snowflake inc,24,11,5,40,0.125000
2025-09-05,Sonic Automotive,20,15,5,40,0.125000
2025-09-05,Sonoco Products,25,10,5,40,0.125000
2025-09-05,Southern Company,25,11,4,40,0.100000
2025-09-05,Southwest Airlines,24,8,8,40,0.200000
2025-09-05,Southwest Gas,23,13,4,40,0.100000
2025-09-05,Southwestern Energy,34,3,3,40,0.075000
2025-09-05,SpartanNash,16,21,3,40,0.075000
2025-09-05,Spectrum Brands,14,21,5,40,0.125000
2025-09-05,Spire inc,20,13,7,40,0.175000
2025-09-05,Spirit AeroSystems,31,1,8,40,0.200000
2025-09-05,Spirit Airlines,23,3,14,40,0.350000
2025-09-05,Splunk,13,17,10,40,0.250000
2025-09-05,Sprouts Farmers Market,13,24,3,40,0.075000
2025-09-05,Stagwell,12,27,1,40,0.025000
2025-09-05,Stanley Black & Decker,14,20,6,40,0.150000
2025-09-05,Starbucks,16,20,4,40,0.100000
2025-09-05,State Farm Insurance,14,20,6,40,0.150000
2025-09-05,State Street,14,19,7,40,0.175000
2025-09-05,Steel Dynamics,35,3,2,40,0.050000
2025-09-05,Steelcase,11,25,4,40,0.100000
2025-09-05,Stericycle,11,9,20,40,0.500000
2025-09-05,Stifel Financial,22,16,2,40,0.050000
2025-09-05,StoneX,18,21,1,40,0.025000
2025-09-05,Stryker,17,16,7,40,0.175000
2025-09-05,Summit Materials,10,26,4,40,0.100000
2025-09-05,Sun Communities,22,16,2,40,0.050000
2025-09-05,Super Micro Computer,33,5,2,40,0.050000
2025-09-05,Surgery Partners,16,16,8,40,0.200000
2025-09-05,Sylvamo,16,16,8,40,0.200000
2025-09-05,Synchrony Financial,22,15,3,40,0.075000
2025-09-05,Synopsys,13,23,4,40,0.100000
2025-09-05,Synovus Financial,21,18,1,40,0.025000
2025-09-05,Sysco,23,14,3,40,0.075000
2025-09-05,T Rowe Price,15,24,1,40,0.025000
2025-09-05,TD Synnex,18,17,5,40,0.125000
2025-09-05,TEGNA,11,27,2,40,0.050000
2025-09-05,TIAA,13,24,3,40,0.075000
2025-09-05,TJX,21,14,5,40,0.125000
2025-09-05,Take-Two Interactive Software,16,22,2,40,0.050000
2025-09-05,Talen Energy,38,2,0,40,0.000000
2025-09-05,Tapestry,14,18,8,40,0.200000
2025-09-05,Targa Resources,22,13,5,40,0.125000
2025-09-05,Target,12,17,11,40,0.275000
2025-09-05,Taylor Morrison Home,16,19,5,40,0.125000
2025-09-05,Teladoc Health,16,19,5,40,0.125000
2025-09-05,Teledyne Technologies,17,20,3,40,0.075000
2025-09-05,Teleflex,13,22,5,40,0.125000
2025-09-05,Telephone & Data Systems,15,18,7,40,0.175000
2025-09-05,TelevisaUnivision,18,18,4,40,0.100000
2025-09-05,Tempur Sealy International,12,22,6,40,0.150000
2025-09-05,Tenet Healthcare,20,18,2,40,0.050000
2025-09-05,Teradyne,15,21,4,40,0.100000
2025-09-05,Terex,17,18,5,40,0.125000
2025-09-05,Tesla,19,10,11,40,0.275000
2025-09-05,Tetra Tech,19,15,6,40,0.150000
2025-09-05,Texas Instruments,10,17,13,40,0.325000
2025-09-05,Texas Roadhouse,13,19,8,40,0.200000
2025-09-05,Textron,20,16,4,40,0.100000
2025-09-05,The Andersons Inc,15,19,6,40,0.150000
2025-09-05,The Coca-Cola Company,13,24,3,40,0.075000
2025-09-05,The Hartford,15,15,10,40,0.250000
2025-09-05,Thermo Fisher Scientific,17,19,4,40,0.100000
2025-09-05,Thor Industries,16,18,6,40,0.150000
2025-09-05,Thrivent Financial for Lutherans,14,20,6,40,0.150000
2025-09-05,Timken,12,23,5,40,0.125000
2025-09-05,Titan Machinery,17,18,5,40,0.125000
2025-09-05,Toast inc,25,14,1,40,0.025000
2025-09-05,Toll Brothers,9,27,4,40,0.100000
2025-09-05,TopBuild,18,18,4,40,0.100000
2025-09-05,Topgolf Callaway Brands,20,11,9,40,0.225000
2025-09-05,Toro Company,13,23,4,40,0.100000
2025-09-05,Tractor Supply,19,15,6,40,0.150000
2025-09-05,TransDigm,17,19,4,40,0.100000
2025-09-05,TransUnion,16,15,9,40,0.225000
2025-09-05,Travelers Insurance,13,18,9,40,0.225000
2025-09-05,TreeHouse Foods,10,21,9,40,0.225000
2025-09-05,Tri Pointe Homes,15,22,3,40,0.075000
2025-09-05,TriNet Group,24,11,5,40,0.125000
2025-09-05,Trimble,10,27,3,40,0.075000
2025-09-05,Trinity Industries,20,15,5,40,0.125000
2025-09-05,TruStage,28,10,2,40,0.050000
2025-09-05,Truist Financial,23,14,3,40,0.075000
2025-09-05,Tutor Perini Corporation,25,6,9,40,0.225000
2025-09-05,Twilio,18,18,4,40,0.100000
2025-09-05,Tyson Foods,12,18,10,40,0.250000
2025-09-05,U-Haul,6,7,27,40,0.675000
2025-09-05,UFP Industries,18,19,3,40,0.075000
2025-09-05,UGI Utilities Inc,20,15,5,40,0.125000
2025-09-05,UL Solutions,37,1,2,40,0.050000
2025-09-05,UPS,12,19,9,40,0.225000
2025-09-05,US Bancorp,21,16,3,40,0.075000
2025-09-05,US Foods,21,17,2,40,0.050000
2025-09-05,USAA,18,13,9,40,0.225000
2025-09-05,Uber,12,21,7,40,0.175000
2025-09-05,Ulta Beauty,35,5,0,40,0.000000
2025-09-05,Under Armour,11,24,5,40,0.125000
2025-09-05,Union Pacific,22,13,5,40,0.125000
2025-09-05,United Airlines,31,4,5,40,0.125000
2025-09-05,United Natural Foods,38,2,0,40,0.000000
2025-09-05,United Rentals,38,2,0,40,0.000000
2025-09-05,United States Steel,29,6,5,40,0.125000
2025-09-05,UnitedHealth,9,25,6,40,0.150000
2025-09-05,Universal Corporation,20,16,4,40,0.100000
2025-09-05,Universal Health Services,14,21,5,40,0.125000
2025-09-05,Unum Group,22,15,3,40,0.075000
2025-09-05,Upbound Group,23,16,1,40,0.025000
2025-09-05,Urban Outfitters,14,19,7,40,0.175000
2025-09-05,V2X,23,16,1,40,0.025000
2025-09-05,VF Corporation,17,21,2,40,0.050000
2025-09-05,VICI Properties,21,18,1,40,0.025000
2025-09-05,Vail Resorts,14,12,14,40,0.350000
2025-09-05,Valero Energy,37,1,2,40,0.050000
2025-09-05,Valley National Bancorp,17,21,2,40,0.050000
2025-09-05,Valmont Industries,21,17,2,40,0.050000
2025-09-05,Valvoline inc,13,22,5,40,0.125000
2025-09-05,Ventas inc,23,15,2,40,0.050000
2025-09-05,Verisk Analytics,14,18,8,40,0.200000
2025-09-05,Verizon,15,21,4,40,0.100000
2025-09-05,Vertex Pharmaceuticals,15,16,9,40,0.225000
2025-09-05,Vertiv,18,20,2,40,0.050000
2025-09-05,Viasat,19,19,2,40,0.050000
2025-09-05,Viatris,12,18,10,40,0.250000
2025-09-05,Victorias Secret,11,17,12,40,0.300000
2025-09-05,Visa,10,15,15,40,0.375000
2025-09-05,Vishay Intertechnology,14,22,4,40,0.100000
2025-09-05,Vista Outdoor,15,21,4,40,0.100000
2025-09-05,Visteon,18,19,3,40,0.075000
2025-09-05,Vistra,20,13,7,40,0.175000
2025-09-05,Vontier,14,20,6,40,0.150000
2025-09-05,Voya Financial,14,18,8,40,0.200000
2025-09-05,Vulcan Materials,15,22,3,40,0.075000
2025-09-05,WEC Energy,35,0,5,40,0.125000
2025-09-05,WESCO International,22,15,3,40,0.075000
2025-09-05,WEX,16,20,4,40,0.100000
2025-09-05,WR Berkley,14,20,6,40,0.150000
2025-09-05,WW Grainger,17,16,7,40,0.175000
2025-09-05,Wabash National,19,12,9,40,0.225000
2025-09-05,Walgreens,5,28,7,40,0.175000
2025-09-05,Walmart,15,14,11,40,0.275000
2025-09-05,Walt Disney,19,17,4,40,0.100000
2025-09-05,Warner Bros Discovery,8,21,11,40,0.275000
2025-09-05,Warner Music Group,16,23,1,40,0.025000
2025-09-05,Waters Corporation,15,19,6,40,0.150000
2025-09-05,Watsco,19,13,8,40,0.200000
2025-09-05,Wayfair,18,18,4,40,0.100000
2025-09-05,Webster Financial,16,18,6,40,0.150000
2025-09-05,Weis Markets,17,18,5,40,0.125000
2025-09-05,Wells Fargo,36,1,3,40,0.075000
2025-09-05,Welltower,32,8,0,40,0.000000
2025-09-05,Werner Enterprises,21,14,5,40,0.125000
2025-09-05,West Pharmaceutical Services,20,15,5,40,0.125000
2025-09-05,Western & Southern Financial,16,20,4,40,0.100000
2025-09-05,Western Alliance Bancorp,15,16,9,40,0.225000
2025-09-05,Western Digital,16,22,2,40,0.050000
2025-09-05,Western Midstream Partners,19,13,8,40,0.200000
2025-09-05,Western Union,15,22,3,40,0.075000
2025-09-05,Westinghouse Air Brake Technologies,18,16,6,40,0.150000
2025-09-05,Westlake Corporation,18,20,2,40,0.050000
2025-09-05,Weyerhaeuser,10,25,5,40,0.125000
2025-09-05,Whirlpool,13,23,4,40,0.100000
2025-09-05,Williams,8,20,12,40,0.300000
2025-09-05,Williams-Sonoma,18,16,6,40,0.150000
2025-09-05,Winnebago Industries,13,18,9,40,0.225000
2025-09-05,Wintrust Financial,22,14,4,40,0.100000
2025-09-05,Woodward inc,17,20,3,40,0.075000
2025-09-05,Workday,12,19,9,40,0.225000
2025-09-05,World Kinect,27,10,3,40,0.075000
2025-09-05,Worthington Enterprises,21,17,2,40,0.050000
2025-09-05,Wynn Resorts,15,19,6,40,0.150000
2025-09-05,XPO,13,25,2,40,0.050000
2025-09-05,Xcel Energy,35,4,1,40,0.025000
2025-09-05,Xerox,14,21,5,40,0.125000
2025-09-05,Xylem Inc,20,15,5,40,0.125000
2025-09-05,Yum Brands,16,23,1,40,0.025000
2025-09-05,Yum China,12,26,2,40,0.050000
2025-09-05,Zebra Technologies,21,17,2,40,0.050000
2025-09-05,Zimmer Biomet,16,21,3,40,0.075000
2025-09-05,Zions Bancorp,19,14,7,40,0.175000
2025-09-05,Zoetis,25,11,4,40,0.100000
2025-09-05,Zoom Video Communications,13,23,4,40,0.100000
2025-09-05,eXp World,13,19,8,40,0.200000
2025-09-05,iHeartMedia,17,19,4,40,0.100000
2025-09-06,3M,21,13,6,40,0.150000
2025-09-06,A O Smith,12,26,2,40,0.050000
2025-09-06,A-Mark Precious Metals,39,1,0,40,0.000000
2025-09-06,ABM Industries,10,22,8,40,0.200000
2025-09-06,ADT,17,17,6,40,0.150000
2025-09-06,AECOM,23,15,2,40,0.050000
2025-09-06,AES,16,18,6,40,0.150000
2025-09-06,AGCO,15,21,4,40,0.100000
2025-09-06,AGNC Investment,23,15,2,40,0.050000
2025-09-06,AMC Entertainment,35,2,3,40,0.075000
2025-09-06,AMC Networks,15,16,9,40,0.225000
2025-09-06,AMN Healthcare Services,17,20,3,40,0.075000
2025-09-06,APA,20,11,9,40,0.225000
2025-09-06,APi Group,13,23,4,40,0.100000
2025-09-06,ARKO,17,19,4,40,0.100000
2025-09-06,ASGN,16,17,7,40,0.175000
2025-09-06,AT&T,17,20,3,40,0.075000
2025-09-06,ATI inc,22,14,4,40,0.100000
2025-09-06,AbbVie,12,22,6,40,0.150000
2025-09-06,Abbott Laboratories,16,18,6,40,0.150000
2025-09-06,Abercrombie & Fitch,13,25,2,40,0.050000
2025-09-06,Academy Sports and Outdoors,12,23,5,40,0.125000
2025-09-06,Acadia Healthcare,12,21,7,40,0.175000
2025-09-06,Acuity Inc,24,16,0,40,0.000000
2025-09-06,Adams Resources & Energy,19,7,1,27,0.037037
2025-09-06,AdaptHealth,18,19,3,40,0.075000
2025-09-06,Adobe,22,13,5,40,0.125000
2025-09-06,Advance Auto Parts,11,18,11,40,0.275000
2025-09-06,Advanced Drainage Systems,31,7,2,40,0.050000
2025-09-06,Advanced Micro Devices,27,5,8,40,0.200000
2025-09-06,Advantage Solutions,36,1,3,40,0.075000
2025-09-06,Aflac,11,16,13,40,0.325000
2025-09-06,Agilent Technologies,14,22,4,40,0.100000
2025-09-06,Agilon Health,14,23,3,40,0.075000
2025-09-06,Air Lease,11,28,1,40,0.025000
2025-09-06,Air Products & Chemicals,15,19,6,40,0.150000
2025-09-06,Airbnb,16,18,6,40,0.150000
2025-09-06,Akamai Technologies,17,18,5,40,0.125000
2025-09-06,Alaska Air,9,18,13,40,0.325000
2025-09-06,Albemarle Corporation,15,20,5,40,0.125000
2025-09-06,Albertsons,15,22,3,40,0.075000
2025-09-06,Alcoa Corporation,15,20,5,40,0.125000
2025-09-06,Alexandria Real Estate Equities,19,19,2,40,0.050000
2025-09-06,Alight Solutions,17,19,4,40,0.100000
2025-09-06,Align Technology,10,21,9,40,0.225000
2025-09-06,Allegiant Travel Company,17,18,5,40,0.125000
2025-09-06,Alliance Resource Partners,15,14,11,40,0.275000
2025-09-06,Alliant Energy,30,5,5,40,0.125000
2025-09-06,Allison Transmission,16,19,5,40,0.125000
2025-09-06,Allstate,19,19,2,40,0.050000
2025-09-06,Ally Financial,15,22,3,40,0.075000
2025-09-06,Alphabet,22,9,9,40,0.225000
2025-09-06,Altice,10,21,9,40,0.225000
2025-09-06,Altria,17,15,8,40,0.200000
2025-09-06,Amazon,31,5,4,40,0.100000
2025-09-06,Ameren,19,17,4,40,0.100000
2025-09-06,American Airlines,11,23,6,40,0.150000
2025-09-06,American Axle & Manufacturing,18,19,3,40,0.075000
2025-09-06,American Eagle Outfitters,21,15,4,40,0.100000
2025-09-06,American Electric Power,17,18,5,40,0.125000
2025-09-06,American Express,22,10,8,40,0.200000
2025-09-06,American Family Insurance,20,17,3,40,0.075000
2025-09-06,American Financial,19,16,5,40,0.125000
2025-09-06,American International Group,18,20,2,40,0.050000
2025-09-06,American Tower,19,18,3,40,0.075000
2025-09-06,American Water Works,14,21,5,40,0.125000
2025-09-06,Americold Realty Trust,37,2,1,40,0.025000
2025-09-06,Ameriprise Financial,23,15,2,40,0.050000
2025-09-06,Ametek,26,12,2,40,0.050000
2025-09-06,Amgen,15,21,4,40,0.100000
2025-09-06,Amica Mutual Insurance,14,24,2,40,0.050000
2025-09-06,Amkor Technology,14,25,1,40,0.025000
2025-09-06,Amphenol,16,22,2,40,0.050000
2025-09-06,Analog Devices,14,23,3,40,0.075000
2025-09-06,Antero Resources,19,19,2,40,0.050000
2025-09-06,Anywhere Real Estate Inc,18,18,4,40,0.100000
2025-09-06,Apollo Global Management,15,22,3,40,0.075000
2025-09-06,AppLovin,19,17,4,40,0.100000
2025-09-06,Apple,8,25,7,40,0.175000
2025-09-06,Applied Industrial Technologies,14,24,2,40,0.050000
2025-09-06,Applied Materials,7,18,15,40,0.375000
2025-09-06,AptarGroup,13,21,6,40,0.150000
2025-09-06,Aramark,20,16,4,40,0.100000
2025-09-06,ArcBest,12,24,4,40,0.100000
2025-09-06,Arch Resources,30,6,4,40,0.100000
2025-09-06,Archer Daniels Midland,21,13,6,40,0.150000
2025-09-06,Ares Management,19,18,3,40,0.075000
2025-09-06,Arista Networks,23,16,1,40,0.025000
2025-09-06,Arrow Electronics,20,16,4,40,0.100000
2025-09-06,Arthur J Gallagher,7,29,4,40,0.100000
2025-09-06,Asbury Automotive Group,7,31,2,40,0.050000
2025-09-06,Assurant,23,15,2,40,0.050000
2025-09-06,Atkore,18,18,4,40,0.100000
2025-09-06,Atlassian,8,30,2,40,0.050000
2025-09-06,Atmos Energy,37,1,2,40,0.050000
2025-09-06,Auto-Owners Insurance,16,19,5,40,0.125000
2025-09-06,AutoNation,17,20,3,40,0.075000
2025-09-06,AutoZone,12,19,9,40,0.225000
2025-09-06,Autodesk,20,19,1,40,0.025000
2025-09-06,Autoliv,20,20,0,40,0.000000
2025-09-06,Automatic Data Processing,19,18,3,40,0.075000
2025-09-06,AvalonBay Communities,18,20,2,40,0.050000
2025-09-06,Avantor,13,20,7,40,0.175000
2025-09-06,Avery Dennison,14,23,3,40,0.075000
2025-09-06,Avient,17,20,3,40,0.075000
2025-09-06,Avis Budget,9,25,6,40,0.150000
2025-09-06,Avnet,11,24,5,40,0.125000
2025-09-06,BJs Wholesale Club,13,21,6,40,0.150000
2025-09-06,BOK Financial,21,13,6,40,0.150000
2025-09-06,BWX Technologies,25,13,2,40,0.050000
2025-09-06,Baker Hughes,17,17,6,40,0.150000
2025-09-06,Ball,9,14,17,40,0.425000
2025-09-06,Bank of America,13,17,10,40,0.250000
2025-09-06,Bank of New York Mellon,27,11,2,40,0.050000
2025-09-06,Bath & Body Works,7,22,11,40,0.275000
2025-09-06,Baxter International,12,21,7,40,0.175000
2025-09-06,Beacon Roofing Supply,9,22,9,40,0.225000
2025-09-06,Becton Dickinson,16,22,2,40,0.050000
2025-09-06,Belden,10,23,7,40,0.175000
2025-09-06,Benchmark Electronics,24,13,3,40,0.075000
2025-09-06,Berkshire Hathaway,14,17,9,40,0.225000
2025-09-06,Best Buy,37,1,2,40,0.050000
2025-09-06,Big Lots,8,31,1,40,0.025000
2025-09-06,Bio-Rad Laboratories,14,21,5,40,0.125000
2025-09-06,Biogen,21,18,1,40,0.025000
2025-09-06,BlackRock,12,22,6,40,0.150000
2025-09-06,Blackstone,12,24,4,40,0.100000
2025-09-06,Bloomin Brands,7,26,7,40,0.175000
2025-09-06,BlueLinx,21,17,2,40,0.050000
2025-09-06,Boeing,8,18,14,40,0.350000
2025-09-06,Boise Cascade,13,16,11,40,0.275000
2025-09-06,Booking Holdings,15,22,3,40,0.075000
2025-09-06,Booz Allen Hamilton,14,21,5,40,0.125000
2025-09-06,BorgWarner,20,18,2,40,0.050000
2025-09-06,Boston Properties,10,21,9,40,0.225000
2025-09-06,Boston Scientific,15,19,6,40,0.150000
2025-09-06,Boyd Gaming,13,26,1,40,0.025000
2025-09-06,Bread Financial,29,10,1,40,0.025000
2025-09-06,BrightSpring Health Services,17,19,4,40,0.100000
2025-09-06,BrightView Holdings,19,18,3,40,0.075000
2025-09-06,Brighthouse Financial,12,25,3,40,0.075000
2025-09-06,Brinker International,23,16,1,40,0.025000
2025-09-06,Brinks Company,7,3,5,15,0.333333
2025-09-06,Bristol-Myers Squibb,5,30,5,40,0.125000
2025-09-06,Broadcom,14,20,6,40,0.150000
2025-09-06,Broadridge Financial Solutions,33,3,4,40,0.100000
2025-09-06,Brookdale Senior Living,17,15,8,40,0.200000
2025-09-06,Brown & Brown,13,23,4,40,0.100000
2025-09-06,Brown-Forman,9,22,9,40,0.225000
2025-09-06,Bruker,9,18,13,40,0.325000
2025-09-06,Brunswick,12,17,11,40,0.275000
2025-09-06,Builders FirstSource,18,17,5,40,0.125000
2025-09-06,Burlington Stores,19,19,2,40,0.050000
2025-09-06,CACI International,24,15,1,40,0.025000
2025-09-06,CBRE Group,18,22,0,40,0.000000
2025-09-06,CDW,15,21,4,40,0.100000
2025-09-06,CF Industries,21,14,5,40,0.125000
2025-09-06,CH Robinson Worldwide,16,15,9,40,0.225000
2025-09-06,CHS,18,19,3,40,0.075000
2025-09-06,CME Group,14,23,3,40,0.075000
2025-09-06,CMS Energy,37,1,2,40,0.050000
2025-09-06,CNO Financial Group,15,22,3,40,0.075000
2025-09-06,CNX Resources,17,21,2,40,0.050000
2025-09-06,CSX,10,19,11,40,0.275000
2025-09-06,CVS Health,15,18,7,40,0.175000
2025-09-06,Cabot Corporation,18,18,4,40,0.100000
2025-09-06,Cadence,15,23,2,40,0.050000
2025-09-06,Caesars Entertainment,34,6,0,40,0.000000
2025-09-06,Cal-Maine Foods,23,15,2,40,0.050000
2025-09-06,Caleres inc,18,17,5,40,0.125000
2025-09-06,California Resources,23,12,5,40,0.125000
2025-09-06,Calumet,11,15,14,40,0.350000
2025-09-06,Campbell Soup,14,22,4,40,0.100000
2025-09-06,Camping World,9,23,8,40,0.200000
2025-09-06,Capital One,20,18,2,40,0.050000
2025-09-06,CarMax,11,27,2,40,0.050000
2025-09-06,Cardinal Health,22,12,6,40,0.150000
2025-09-06,Carlisle Companies,21,14,5,40,0.125000
2025-09-06,Carlyle Group,10,29,1,40,0.025000
2025-09-06,Carpenter Technology,17,20,3,40,0.075000
2025-09-06,Carrier Global,18,20,2,40,0.050000
2025-09-06,Carters inc,10,23,2,35,0.057143
2025-09-06,Carvana,15,21,4,40,0.100000
2025-09-06,Caseys General Stores,13,22,5,40,0.125000
2025-09-06,Catalent,10,25,5,40,0.125000
2025-09-06,Caterpillar,12,19,9,40,0.225000
2025-09-06,Cboe Global Markets,13,25,2,40,0.050000
2025-09-06,Celanese,15,12,13,40,0.325000
2025-09-06,Cencora,19,19,2,40,0.050000
2025-09-06,Centene,15,8,17,40,0.425000
2025-09-06,CenterPoint Energy,30,5,5,40,0.125000
2025-09-06,Central Garden & Pet,17,18,5,40,0.125000
2025-09-06,Century Communities,15,19,6,40,0.150000
2025-09-06,ChampionX,26,14,0,40,0.000000
2025-09-06,Charles River Laboratories International,14,18,8,40,0.200000
2025-09-06,Charles Schwab,19,17,4,40,0.100000
2025-09-06,Chart Industries,12,26,2,40,0.050000
2025-09-06,Charter Communications,10,20,10,40,0.250000
2025-09-06,Cheesecake Factory,14,15,11,40,0.275000
2025-09-06,Chefs Warehouse,20,15,5,40,0.125000
2025-09-06,Chemours,17,12,11,40,0.275000
2025-09-06,Cheniere Energy,35,4,1,40,0.025000
2025-09-06,Chevron,16,13,11,40,0.275000
2025-09-06,Chewy,21,14,5,40,0.125000
2025-09-06,Chipotle Mexican Grill,12,22,6,40,0.150000
2025-09-06,Chord Energy,34,2,4,40,0.100000
2025-09-06,Church & Dwight,19,18,3,40,0.075000
2025-09-06,Ciena,12,24,4,40,0.100000
2025-09-06,Cigna,18,17,5,40,0.125000
2025-09-06,Cincinnati Financial,19,19,2,40,0.050000
2025-09-06,Cinemark,12,24,4,40,0.100000
2025-09-06,Cintas,19,14,7,40,0.175000
2025-09-06,Cisco Systems,14,23,3,40,0.075000
2025-09-06,Citigroup,21,14,5,40,0.125000
2025-09-06,Citizens Financial Group,11,27,2,40,0.050000
2025-09-06,Civitas Resources,14,15,11,40,0.275000
2025-09-06,Clean Harbors,35,2,3,40,0.075000
2025-09-06,Clear Channel Outdoor Hldgs,8,0,2,10,0.200000
2025-09-06,Cleveland-Cliffs,10,14,16,40,0.400000
2025-09-06,Clorox,20,13,7,40,0.175000
2025-09-06,Cognizant Technology Solutions,32,6,2,40,0.050000
2025-09-06,Coherent,18,14,8,40,0.200000
2025-09-06,Coinbase Global,13,23,4,40,0.100000
2025-09-06,Colgate-Palmolive,15,14,11,40,0.275000
2025-09-06,Columbia Banking System,14,23,3,40,0.075000
2025-09-06,Columbia Sportswear,16,14,10,40,0.250000
2025-09-06,Comcast,20,14,6,40,0.150000
2025-09-06,Comerica,21,15,4,40,0.100000
2025-09-06,Comfort Systems USA,40,0,0,40,0.000000
2025-09-06,CommScope,19,19,2,40,0.050000
2025-09-06,Commercial Metals,13,15,12,40,0.300000
2025-09-06,Community Health Systems,16,18,6,40,0.150000
2025-09-06,Compass,9,24,7,40,0.175000
2025-09-06,Conagra Brands,16,24,0,40,0.000000
2025-09-06,Concentrix,17,17,6,40,0.150000
2025-09-06,Conduent,14,21,5,40,0.125000
2025-09-06,ConocoPhillips,9,17,14,40,0.350000
2025-09-06,Consol Energy,33,6,1,40,0.025000
2025-09-06,Consolidated Edison,14,18,8,40,0.200000
2025-09-06,Constellation Brands,4,15,21,40,0.525000
2025-09-06,Constellation Energy,30,8,2,40,0.050000
2025-09-06,Continental Resources,18,13,9,40,0.225000
2025-09-06,Cooper Cos,8,28,4,40,0.100000
2025-09-06,Cooper-Standard,10,25,5,40,0.125000
2025-09-06,Copart,19,17,4,40,0.100000
2025-09-06,Core & Main,14,24,2,40,0.050000
2025-09-06,Cornerstone Building Brands,16,21,3,40,0.075000
2025-09-06,Corning,10,21,9,40,0.225000
2025-09-06,Corpay,16,23,1,40,0.025000
2025-09-06,Corteva,20,15,5,40,0.125000
2025-09-06,Costco,16,18,6,40,0.150000
2025-09-06,Coterra Energy,36,2,2,40,0.050000
2025-09-06,Coty,14,14,12,40,0.300000
2025-09-06,Country Financial,16,21,3,40,0.075000
2025-09-06,Coupang,18,22,0,40,0.000000
2025-09-06,Cracker Barrel Old Country Store,7,24,9,40,0.225000
2025-09-06,Crocs,9,28,3,40,0.075000
2025-09-06,CrossAmerica Partners,18,15,7,40,0.175000
2025-09-06,CrowdStrike,18,12,10,40,0.250000
2025-09-06,Crown Castle,16,21,3,40,0.075000
2025-09-06,Crown Holdings,17,21,2,40,0.050000
2025-09-06,Cullen Frost Bankers,17,18,5,40,0.125000
2025-09-06,Cummins,13,20,7,40,0.175000
2025-09-06,Curtiss-Wright,17,21,2,40,0.050000
2025-09-06,DR Horton,14,22,4,40,0.100000
2025-09-06,DTE Energy,30,4,6,40,0.150000
2025-09-06,DXC Technology,19,21,0,40,0.000000
2025-09-06,DaVita,13,14,13,40,0.325000
2025-09-06,Dana Incorporated,18,19,3,40,0.075000
2025-09-06,Danaher,14,23,3,40,0.075000
2025-09-06,Darden Restaurants,24,11,5,40,0.125000
2025-09-06,Darling Ingredients,40,0,0,40,0.000000
2025-09-06,Deckers Outdoor,25,14,1,40,0.025000
2025-09-06,Deere,8,21,11,40,0.275000
2025-09-06,Delek US,25,13,2,40,0.050000
2025-09-06,Dell Technologies,18,16,6,40,0.150000
2025-09-06,Delta Air Lines,10,17,13,40,0.325000
2025-09-06,Dentsply Sirona,15,23,2,40,0.050000
2025-09-06,Designer Brands,10,27,3,40,0.075000
2025-09-06,Devon Energy,37,2,1,40,0.025000
2025-09-06,DexCom,11,22,7,40,0.175000
2025-09-06,Diamondback Energy,34,1,5,40,0.125000
2025-09-06,Dicks Sporting Goods,12,25,3,40,0.075000
2025-09-06,Diebold Nixdorf,15,24,1,40,0.025000
2025-09-06,Digital Realty Trust,34,6,0,40,0.000000
2025-09-06,Dillards,12,20,8,40,0.200000
2025-09-06,DocuSign,19,18,3,40,0.075000
2025-09-06,Dollar General,11,17,12,40,0.300000
2025-09-06,Dollar Tree,15,14,11,40,0.275000
2025-09-06,Dominion Energy,29,8,3,40,0.075000
2025-09-06,Dominos Pizza inc,16,18,6,40,0.150000
2025-09-06,Domtar,9,24,7,40,0.175000
2025-09-06,Donaldson Company,24,12,4,40,0.100000
2025-09-06,DoorDash,22,8,10,40,0.250000
2025-09-06,Dover Corporation,20,15,5,40,0.125000
2025-09-06,DraftKings,26,14,0,40,0.000000
2025-09-06,Dream Finders Homes,37,0,3,40,0.075000
2025-09-06,Dropbox,17,20,3,40,0.075000
2025-09-06,DuPont,10,24,6,40,0.150000
2025-09-06,Duke Energy,37,2,1,40,0.025000
2025-09-06,Dycom Industries,19,18,3,40,0.075000
2025-09-06,EMCOR Group,17,20,3,40,0.075000
2025-09-06,EOG Resources,19,18,3,40,0.075000
2025-09-06,EPAM Systems,21,16,3,40,0.075000
2025-09-06,EQT,22,14,4,40,0.100000
2025-09-06,ESAB,14,24,2,40,0.050000
2025-09-06,East West Bancorp,20,17,3,40,0.075000
2025-09-06,Eastman Chemical,8,21,11,40,0.275000
2025-09-06,Ebay,19,17,4,40,0.100000
2025-09-06,EchoStar,12,22,6,40,0.150000
2025-09-06,Ecolab,16,19,5,40,0.125000
2025-09-06,Edison International,8,23,9,40,0.225000
2025-09-06,Edward Jones,13,23,4,40,0.100000
2025-09-06,Edwards Lifesciences,18,13,9,40,0.225000
2025-09-06,Elanco Animal Health,14,24,2,40,0.050000
2025-09-06,Electronic Arts,11,21,8,40,0.200000
2025-09-06,Elevance Health,12,12,16,40,0.400000
2025-09-06,Eli Lilly,13,20,7,40,0.175000
2025-09-06,Emerson Electric,13,25,2,40,0.050000
2025-09-06,EnLink Midstream,16,20,4,40,0.100000
2025-09-06,Encompass Health,13,25,2,40,0.050000
2025-09-06,Endeavor Group,13,22,5,40,0.125000
2025-09-06,EnerSys,22,14,4,40,0.100000
2025-09-06,Energizer,37,2,1,40,0.025000
2025-09-06,Energy Transfer,36,1,3,40,0.075000
2025-09-06,Ensign Group,23,13,4,40,0.100000
2025-09-06,Entegris,22,16,2,40,0.050000
2025-09-06,Entergy,19,17,4,40,0.100000
2025-09-06,Enterprise Products Partners,19,15,6,40,0.150000
2025-09-06,Envista,16,22,2,40,0.050000
2025-09-06,Equifax,19,17,4,40,0.100000
2025-09-06,Equinix,24,16,0,40,0.000000
2025-09-06,Equitable,21,17,2,40,0.050000
2025-09-06,Equity Residential,18,11,11,40,0.275000
2025-09-06,Erie Insurance,18,12,10,40,0.250000
2025-09-06,Estée Lauder,9,23,8,40,0.200000
2025-09-06,Etsy,13,16,11,40,0.275000
2025-09-06,Euronet Worldwide,17,19,4,40,0.100000
2025-09-06,Evergy,24,9,7,40,0.175000
2025-09-06,Eversource Energy,30,7,3,40,0.075000
2025-09-06,Exact Sciences,9,18,13,40,0.325000
2025-09-06,Exelon,21,18,1,40,0.025000
2025-09-06,Expand Energy,39,1,0,40,0.000000
2025-09-06,Expedia,19,20,1,40,0.025000
2025-09-06,Expeditors International of Washington,17,15,8,40,0.200000
2025-09-06,Extra Space Storage,15,20,5,40,0.125000
2025-09-06,Exxon Mobil,12,26,2,40,0.050000
2025-09-06,F5,9,26,5,40,0.125000
2025-09-06,FM Global,15,16,9,40,0.225000
2025-09-06,FMC Corporation,16,21,3,40,0.075000
2025-09-06,FTI Consulting,16,19,5,40,0.125000
2025-09-06,Fannie Mae,5,33,2,40,0.050000
2025-09-06,Farmers Insurance Exchange,9,19,12,40,0.300000
2025-09-06,Fastenal,17,20,3,40,0.075000
2025-09-06,FedEx,11,16,13,40,0.325000
2025-09-06,Federated Mutual Insurance,18,17,2,37,0.054054
2025-09-06,Fidelity National Financial,15,21,4,40,0.100000
2025-09-06,Fidelity National Information Services,24,14,2,40,0.050000
2025-09-06,Fifth Third Bancorp,21,17,2,40,0.050000
2025-09-06,First American Financial,15,21,4,40,0.100000
2025-09-06,First Citizens BancShares,17,22,1,40,0.025000
2025-09-06,First Horizon,19,21,0,40,0.000000
2025-09-06,First National of Nebraska,17,23,0,40,0.000000
2025-09-06,First Solar,24,12,4,40,0.100000
2025-09-06,FirstCash,15,19,6,40,0.150000
2025-09-06,FirstEnergy,20,15,5,40,0.125000
2025-09-06,Fiserv,18,18,4,40,0.100000
2025-09-06,Five Below,15,21,4,40,0.100000
2025-09-06,Flagstar Financial,20,16,4,40,0.100000
2025-09-06,Floor & Decor,21,18,1,40,0.025000
2025-09-06,Flowers Foods,14,20,6,40,0.150000
2025-09-06,Flowserve,17,17,6,40,0.150000
2025-09-06,Fluor,15,15,10,40,0.250000
2025-09-06,Foot Locker,11,22,7,40,0.175000
2025-09-06,Ford Motor,22,16,2,40,0.050000
2025-09-06,Fortinet,16,16,8,40,0.200000
2025-09-06,Fortive,18,14,8,40,0.200000
2025-09-06,Fortune Brands Innovations,15,22,3,40,0.075000
2025-09-06,Franklin Resources,15,20,5,40,0.125000
2025-09-06,Freddie Mac,8,25,7,40,0.175000
2025-09-06,Freeport-McMoRan,22,15,3,40,0.075000
2025-09-06,Frontier Airlines,11,21,8,40,0.200000
2025-09-06,Frontier Communications,19,18,3,40,0.075000
2025-09-06,G-III Apparel Group,14,25,1,40,0.025000
2025-09-06,GE HealthCare Technologies,19,17,4,40,0.100000
2025-09-06,GMS,21,16,3,40,0.075000
2025-09-06,GXO Logistics,11,23,6,40,0.150000
2025-09-06,GameStop,8,24,8,40,0.200000
2025-09-06,Gannett,18,13,9,40,0.225000
2025-09-06,Garrett Motion inc,21,15,4,40,0.100000
2025-09-06,Gartner,11,22,7,40,0.175000
2025-09-06,Gen Digital,19,18,3,40,0.075000
2025-09-06,Generac,16,16,8,40,0.200000
2025-09-06,General Dynamics,40,0,0,40,0.000000
2025-09-06,General Electric,9,28,3,40,0.075000
2025-09-06,General Mills,23,15,2,40,0.050000
2025-09-06,General Motors,8,23,9,40,0.225000
2025-09-06,Genesis Energy,37,2,1,40,0.025000
2025-09-06,Genuine Parts,16,22,2,40,0.050000
2025-09-06,Genworth Financial,28,12,0,40,0.000000
2025-09-06,Gilead Sciences,12,25,3,40,0.075000
2025-09-06,Global Partners,14,19,7,40,0.175000
2025-09-06,Global Payments,17,21,2,40,0.050000
2025-09-06,Globe Life,18,17,5,40,0.125000
2025-09-06,GoDaddy,14,22,4,40,0.100000
2025-09-06,Goldman Sachs,10,22,8,40,0.200000
2025-09-06,Goodyear Tire & Rubber,11,22,7,40,0.175000
2025-09-06,Graham Holdings Company,28,10,2,40,0.050000
2025-09-06,Granite Construction,20,17,3,40,0.075000
2025-09-06,Graphic Packaging,12,24,4,40,0.100000
2025-09-06,Gray Television,13,20,7,40,0.175000
2025-09-06,Graybar Electric,13,20,7,40,0.175000
2025-09-06,Green Plains inc,21,15,4,40,0.100000
2025-09-06,Greenbrier,13,14,13,40,0.325000
2025-09-06,Greif,7,28,5,40,0.125000
2025-09-06,Griffon Corporation,19,18,3,40,0.075000
2025-09-06,Grocery Outlet Holding,14,25,1,40,0.025000
2025-09-06,Group 1 Automotive,15,23,2,40,0.050000
2025-09-06,Guardian Life insurance,19,21,0,40,0.000000
2025-09-06,Guess inc,17,21,2,40,0.050000
2025-09-06,H B Fuller,20,15,5,40,0.125000
2025-09-06,HCA Healthcare,24,10,6,40,0.150000
2025-09-06,HEICO,19,19,2,40,0.050000
2025-09-06,HF Sinclair,21,16,3,40,0.075000
2025-09-06,Halliburton,11,19,10,40,0.250000
2025-09-06,Hanesbrands,12,25,3,40,0.075000
2025-09-06,Hanover Insurance Group,19,20,1,40,0.025000
2025-09-06,Harley-Davidson,9,22,9,40,0.225000
2025-09-06,Hasbro,13,16,11,40,0.275000
2025-09-06,Hawaiian Airlines inc,16,24,0,40,0.000000
2025-09-06,Hawaiian Electric Industries,19,18,3,40,0.075000
2025-09-06,Helmerich & Payne,14,22,4,40,0.100000
2025-09-06,Henry Schein,14,22,4,40,0.100000
2025-09-06,Herc Rentals,19,15,6,40,0.150000
2025-09-06,Hershey,16,21,3,40,0.075000
2025-09-06,Hertz,24,9,7,40,0.175000
2025-09-06,Hewlett Packard,11,29,0,40,0.000000
2025-09-06,Hewlett Packard Enterprise,13,27,0,40,0.000000
2025-09-06,Hillenbrand,17,21,2,40,0.050000
2025-09-06,Hilton Grand Vacations,38,0,2,40,0.050000
2025-09-06,Hilton Worldwide,13,24,3,40,0.075000
2025-09-06,Hologic,12,23,5,40,0.125000
2025-09-06,Home Depot,14,19,7,40,0.175000
2025-09-06,Honeywell,16,21,3,40,0.075000
2025-09-06,Hormel Foods,13,22,5,40,0.125000
2025-09-06,Host Hotels & Resorts,11,28,1,40,0.025000
2025-09-06,Hovnanian Enterprises,19,16,5,40,0.125000
2025-09-06,Howmet Aerospace,15,22,3,40,0.075000
2025-09-06,Hub Group,16,18,6,40,0.150000
2025-09-06,Hubbell,13,23,4,40,0.100000
2025-09-06,Humana,23,12,5,40,0.125000
2025-09-06,Huntington Bancshares,21,16,3,40,0.075000
2025-09-06,Huntington Ingalls Industries,20,16,4,40,0.100000
2025-09-06,Huntsman,7,23,10,40,0.250000
2025-09-06,Hyatt Hotels,25,14,1,40,0.025000
2025-09-06,Hyster-Yale,11,24,5,40,0.125000
2025-09-06,IAC,16,16,8,40,0.200000
2025-09-06,IBM,18,20,2,40,0.050000
2025-09-06,IDEX,18,19,3,40,0.075000
2025-09-06,IDEXX Laboratories,22,17,1,40,0.025000
2025-09-06,IQVIA,25,13,2,40,0.050000
2025-09-06,ITT,17,19,4,40,0.100000
2025-09-06,Icahn Enterprises,13,16,11,40,0.275000
2025-09-06,Illinois Tool Works,19,18,3,40,0.075000
2025-09-06,Illumina inc,10,26,4,40,0.100000
2025-09-06,Incyte,21,15,4,40,0.100000
2025-09-06,Ingersoll Rand,17,16,7,40,0.175000
2025-09-06,Ingles Markets,16,17,7,40,0.175000
2025-09-06,Ingram Micro,10,15,15,40,0.375000
2025-09-06,Ingredion,22,15,3,40,0.075000
2025-09-06,Insight Enterprises,12,23,5,40,0.125000
2025-09-06,Insperity,18,17,5,40,0.125000
2025-09-06,Instacart,18,16,6,40,0.150000
2025-09-06,Installed Building Products,18,17,5,40,0.125000
2025-09-06,Intel,13,17,10,40,0.250000
2025-09-06,Interactive Brokers,11,24,5,40,0.125000
2025-09-06,Intercontinental Exchange,13,26,1,40,0.025000
2025-09-06,International Flavors & Fragrances,14,20,6,40,0.150000
2025-09-06,International Paper,6,31,3,40,0.075000
2025-09-06,Interpublic Group,20,17,3,40,0.075000
2025-09-06,Intuit,17,20,3,40,0.075000
2025-09-06,Intuitive Surgical,11,20,9,40,0.225000
2025-09-06,Iron Mountain,8,28,4,40,0.100000
2025-09-06,JB Hunt Transport Services,9,25,6,40,0.150000
2025-09-06,JELD-WEN Holding,19,16,5,40,0.125000
2025-09-06,JM Smucker,17,16,7,40,0.175000
2025-09-06,JPMorgan Chase,12,25,3,40,0.075000
2025-09-06,Jabil,18,19,3,40,0.075000
2025-09-06,Jackson Financial,17,21,2,40,0.050000
2025-09-06,Jacobs Solutions,37,0,3,40,0.075000
2025-09-06,Jefferies Financial,11,24,5,40,0.125000
2025-09-06,JetBlue Airways,26,10,4,40,0.100000
2025-09-06,Johnson & Johnson,18,21,1,40,0.025000
2025-09-06,Jones Lang LaSalle,20,18,2,40,0.050000
2025-09-06,Juniper Networks,17,20,3,40,0.075000
2025-09-06,KB Home,21,14,5,40,0.125000
2025-09-06,KBR,27,12,1,40,0.025000
2025-09-06,KKR,18,19,3,40,0.075000
2025-09-06,KLA,19,16,5,40,0.125000
2025-09-06,Kaiser Aluminum,24,15,1,40,0.025000
2025-09-06,Kellanova,17,15,8,40,0.200000
2025-09-06,Kelly Services inc,23,13,4,40,0.100000
2025-09-06,Kemper,17,13,10,40,0.250000
2025-09-06,Keurig Dr Pepper,4,32,4,40,0.100000
2025-09-06,KeyCorp,16,16,8,40,0.200000
2025-09-06,Keysight Technologies,18,17,5,40,0.125000
2025-09-06,Kimberly-Clark,16,18,6,40,0.150000
2025-09-06,Kinder Morgan,40,0,0,40,0.000000
2025-09-06,Kirby Corporation,18,17,5,40,0.125000
2025-09-06,Knife River Corporation,17,18,5,40,0.125000
2025-09-06,Knight Swift Transportation,22,10,8,40,0.200000
2025-09-06,Kohls,16,17,7,40,0.175000
2025-09-06,Kontoor Brands,16,23,1,40,0.025000
2025-09-06,Korn Ferry,20,12,8,40,0.200000
2025-09-06,Kraft Heinz,10,21,9,40,0.225000
2025-09-06,Kroger,16,14,10,40,0.250000
2025-09-06,Kyndryl,16,21,3,40,0.075000
2025-09-06,L3Harris Technologies,23,13,4,40,0.100000
2025-09-06,LCI Industries,15,22,3,40,0.075000
2025-09-06,LKQ,15,24,1,40,0.025000
2025-09-06,LPL Financial,28,11,1,40,0.025000
2025-09-06,Labcorp Holdings,13,22,5,40,0.125000
2025-09-06,Lam Research,15,21,4,40,0.100000
2025-09-06,Lamb Weston,17,20,3,40,0.075000
2025-09-06,Land O'Lakes,16,22,2,40,0.050000
2025-09-06,Landstar System,14,15,11,40,0.275000
2025-09-06,Las Vegas Sands,17,19,4,40,0.100000
2025-09-06,Lear Corporation,19,19,2,40,0.050000
2025-09-06,Leggett & Platt,18,18,4,40,0.100000
2025-09-06,Leidos,19,18,3,40,0.075000
2025-09-06,Lennar,14,26,0,40,0.000000
2025-09-06,Lennox International,19,18,3,40,0.075000
2025-09-06,Levi Strauss,14,25,1,40,0.025000
2025-09-06,Liberty Energy,40,0,0,40,0.000000
2025-09-06,Liberty Media,40,0,0,40,0.000000
2025-09-06,Liberty Mutual Insurance,35,1,4,40,0.100000
2025-09-06,Light & Wonder,14,22,4,40,0.100000
2025-09-06,Lincoln Electric,11,27,2,40,0.050000
2025-09-06,Lincoln National,14,19,7,40,0.175000
2025-09-06,Lithia Motors,18,18,4,40,0.100000
2025-09-06,Live Nation Entertainment,31,7,2,40,0.050000
2025-09-06,Lockheed Martin,19,10,11,40,0.275000
2025-09-06,Loews,17,17,6,40,0.150000
2025-09-06,Louisiana-Pacific Corporation,21,13,6,40,0.150000
2025-09-06,Lowes,14,21,5,40,0.125000
2025-09-06,Lululemon athletica,12,12,16,40,0.400000
2025-09-06,Lumen Technologies,8,28,4,40,0.100000
2025-09-06,Lyft,18,19,3,40,0.075000
2025-09-06,M&T Bank,20,18,2,40,0.050000
2025-09-06,M/I Homes,15,20,5,40,0.125000
2025-09-06,MDU Resources Group,21,12,7,40,0.175000
2025-09-06,MGM Resorts International,8,28,4,40,0.100000
2025-09-06,MKS Instruments,21,18,1,40,0.025000
2025-09-06,MRC Global,16,23,1,40,0.025000
2025-09-06,MSC Industrial Direct,12,25,3,40,0.075000
2025-09-06,MSCI,14,23,3,40,0.075000
2025-09-06,MYR Group,16,19,5,40,0.125000
2025-09-06,Macys,22,14,4,40,0.100000
2025-09-06,ManpowerGroup,18,17,5,40,0.125000
2025-09-06,Marathon Oil,13,23,4,40,0.100000
2025-09-06,Marathon Petroleum,21,18,1,40,0.025000
2025-09-06,Markel Group,25,13,2,40,0.050000
2025-09-06,Marriott International,10,22,8,40,0.200000
2025-09-06,Marriott Vacations Worldwide,16,21,3,40,0.075000
2025-09-06,Marsh & McLennan,16,21,3,40,0.075000
2025-09-06,Martin Marietta Materials,22,13,5,40,0.125000
2025-09-06,Marvell Technology,13,18,9,40,0.225000
2025-09-06,MasTec,17,20,3,40,0.075000
2025-09-06,Masco,13,20,7,40,0.175000
2025-09-06,Mass Mutual,12,24,4,40,0.100000
2025-09-06,MasterBrand,14,24,2,40,0.050000
2025-09-06,Mastercard,15,19,6,40,0.150000
2025-09-06,Matador Resources,16,20,4,40,0.100000
2025-09-06,Match Group,13,15,12,40,0.300000
2025-09-06,Mativ,18,19,3,40,0.075000
2025-09-06,Matson inc,20,18,2,40,0.050000
2025-09-06,Mattel,13,19,8,40,0.200000
2025-09-06,Maximus,17,19,4,40,0.100000
2025-09-06,McCormick & Company,20,17,3,40,0.075000
2025-09-06,McDonalds,21,9,10,40,0.250000
2025-09-06,McKesson,17,20,3,40,0.075000
2025-09-06,Medical Mutual of Ohio,15,20,5,40,0.125000
2025-09-06,Merck,21,16,3,40,0.075000
2025-09-06,Mercury General,11,22,7,40,0.175000
2025-09-06,Meritage Homes,25,12,3,40,0.075000
2025-09-06,MetLife,15,19,6,40,0.150000
2025-09-06,Meta,15,20,5,40,0.125000
2025-09-06,Mettler-Toledo International,23,14,3,40,0.075000
2025-09-06,Microchip Technology,13,21,6,40,0.150000
2025-09-06,Micron Technology,16,19,5,40,0.125000
2025-09-06,Microsoft,14,16,10,40,0.250000
2025-09-06,Middleby,12,23,5,40,0.125000
2025-09-06,MillerKnoll,14,25,1,40,0.025000
2025-09-06,Moderna,18,13,9,40,0.225000
2025-09-06,ModivCare,10,21,9,40,0.225000
2025-09-06,Mohawk Industries,25,12,3,40,0.075000
2025-09-06,Molina Healthcare,10,16,14,40,0.350000
2025-09-06,Molson Coors Beverage,14,17,9,40,0.225000
2025-09-06,Mondelez,18,16,6,40,0.150000
2025-09-06,Monster Beverage,22,15,3,40,0.075000
2025-09-06,Moodys Corporation,3,11,2,16,0.125000
2025-09-06,Moog inc,23,16,1,40,0.025000
2025-09-06,Morgan Stanley,8,26,6,40,0.150000
2025-09-06,Mosaic,18,20,2,40,0.050000
2025-09-06,Motorola Solutions,34,3,3,40,0.075000
2025-09-06,Mueller Industries,17,20,3,40,0.075000
2025-09-06,Murphy Oil,18,19,3,40,0.075000
2025-09-06,Murphy USA,20,18,2,40,0.050000
2025-09-06,Mutual of Omaha,18,18,4,40,0.100000
2025-09-06,NCR Atleos,16,22,2,40,0.050000
2025-09-06,NCR Voyix,16,21,3,40,0.075000
2025-09-06,NGL Energy Partners,37,0,3,40,0.075000
2025-09-06,NLV Financial,5,3,2,10,0.200000
2025-09-06,NOV,9,28,3,40,0.075000
2025-09-06,NRG Energy,38,1,1,40,0.025000
2025-09-06,NVR,15,22,3,40,0.075000
2025-09-06,Nasdaq,13,16,11,40,0.275000
2025-09-06,Nationwide,10,5,25,40,0.625000
2025-09-06,Navient,17,18,5,40,0.125000
2025-09-06,NetApp,16,23,1,40,0.025000
2025-09-06,Netflix,13,18,9,40,0.225000
2025-09-06,NeueHealth,22,16,2,40,0.050000
2025-09-06,New York Life Insurance,16,22,2,40,0.050000
2025-09-06,NewMarket Corporation,18,19,3,40,0.075000
2025-09-06,Newell Brands,12,22,6,40,0.150000
2025-09-06,Newmont,19,15,6,40,0.150000
2025-09-06,News Corp,12,18,10,40,0.250000
2025-09-06,Nexstar Media Group,16,22,2,40,0.050000
2025-09-06,NextEra Energy,31,6,3,40,0.075000
2025-09-06,NiSource,14,14,12,40,0.300000
2025-09-06,Nike,9,27,4,40,0.100000
2025-09-06,Nordson,20,19,1,40,0.025000
2025-09-06,Nordstrom,19,21,0,40,0.000000
2025-09-06,Norfolk Southern,15,18,7,40,0.175000
2025-09-06,Northern Trust,40,0,0,40,0.000000
2025-09-06,Northrop Grumman,18,19,3,40,0.075000
2025-09-06,Northwestern Mutual,24,11,5,40,0.125000
2025-09-06,Nucor,13,23,4,40,0.100000
2025-09-06,Nvidia,15,17,8,40,0.200000
2025-09-06,O'Reilly Automotive,22,12,6,40,0.150000
2025-09-06,O-I Glass,15,21,4,40,0.100000
2025-09-06,ODP Business Solutions,22,17,1,40,0.025000
2025-09-06,OGE Energy,35,5,0,40,0.000000
2025-09-06,ON Semiconductor,13,16,11,40,0.275000
2025-09-06,Occidental Petroleum,14,19,7,40,0.175000
2025-09-06,Old Dominion Freight Line,20,14,6,40,0.150000
2025-09-06,Old National Bancorp,13,27,0,40,0.000000
2025-09-06,Old Republic International,17,19,4,40,0.100000
2025-09-06,Olin,12,18,10,40,0.250000
2025-09-06,Omnicom Group,14,17,9,40,0.225000
2025-09-06,OneMain,17,22,1,40,0.025000
2025-09-06,Oneok,23,15,2,40,0.050000
2025-09-06,Opendoor Technologies,7,18,15,40,0.375000
2025-09-06,Option Care Health,40,0,0,40,0.000000
2025-09-06,Oracle,7,23,10,40,0.250000
2025-09-06,Organon,15,20,5,40,0.125000
2025-09-06,Oscar Health,18,17,5,40,0.125000
2025-09-06,Oshkosh,14,15,11,40,0.275000
2025-09-06,Otis Worldwide,15,21,4,40,0.100000
2025-09-06,Ovintiv,23,12,5,40,0.125000
2025-09-06,Owens & Minor,8,25,7,40,0.175000
2025-09-06,Owens Corning,12,25,3,40,0.075000
2025-09-06,PACS Group,25,8,7,40,0.175000
2025-09-06,PBF Energy,36,2,2,40,0.050000
2025-09-06,PC Connection Inc,16,20,4,40,0.100000
2025-09-06,PENN Entertainment,39,1,0,40,0.000000
2025-09-06,PG&E,11,19,10,40,0.250000
2025-09-06,PNC Financial Services,21,18,1,40,0.025000
2025-09-06,PPG Industries,24,13,3,40,0.075000
2025-09-06,PPL,24,16,0,40,0.000000
2025-09-06,PVH,11,22,7,40,0.175000
2025-09-06,Paccar,17,18,5,40,0.125000
2025-09-06,Pacific Life,17,22,1,40,0.025000
2025-09-06,Packaging Corp of America,10,25,5,40,0.125000
2025-09-06,Palo Alto Networks,13,13,14,40,0.350000
2025-09-06,Par Pacific,21,16,3,40,0.075000
2025-09-06,Paramount Global,7,25,8,40,0.200000
2025-09-06,Park Hotels & Resorts,8,29,3,40,0.075000
2025-09-06,Parker-Hannifin,20,19,1,40,0.025000
2025-09-06,Parsons Corporation,25,12,3,40,0.075000
2025-09-06,Patrick Industries,17,19,4,40,0.100000
2025-09-06,Patterson Companies Inc,8,27,5,40,0.125000
2025-09-06,Patterson-UTI Energy,33,3,4,40,0.100000
2025-09-06,PayPal,11,15,14,40,0.350000
2025-09-06,Paychex,21,18,1,40,0.025000
2025-09-06,Peabody Energy,32,4,4,40,0.100000
2025-09-06,Peloton,22,17,1,40,0.025000
2025-09-06,Penn Mutual Life Insurance,20,17,3,40,0.075000
2025-09-06,PennyMac Financial Services,20,19,1,40,0.025000
2025-09-06,Penske Automotive,17,20,3,40,0.075000
2025-09-06,PepsiCo,10,24,6,40,0.150000
2025-09-06,Performance Food,12,21,7,40,0.175000
2025-09-06,Permian Resources,23,12,5,40,0.125000
2025-09-06,Petco Health and Wellness,36,2,2,40,0.050000
2025-09-06,Peter Kiewit Sons',6,21,12,39,0.307692
2025-09-06,Pfizer,20,12,8,40,0.200000
2025-09-06,Philip Morris,24,13,3,40,0.075000
2025-09-06,Phillips 66,17,13,10,40,0.250000
2025-09-06,Pinnacle West Capital,20,12,8,40,0.200000
2025-09-06,Pinterest,18,19,3,40,0.075000
2025-09-06,Pioneer Natural Resources,18,11,11,40,0.275000
2025-09-06,Pitney Bowes,21,17,2,40,0.050000
2025-09-06,Plains GP,14,11,15,40,0.375000
2025-09-06,Playtika Holding,18,17,5,40,0.125000
2025-09-06,Plexus,8,19,13,40,0.325000
2025-09-06,Polaris Inc,22,14,4,40,0.100000
2025-09-06,Pool Corporation,20,20,0,40,0.000000
2025-09-06,Popular inc,39,1,0,40,0.000000
2025-09-06,Portland General Electric,13,25,2,40,0.050000
2025-09-06,Post Holdings,12,27,1,40,0.025000
2025-09-06,PriceSmart,19,17,4,40,0.100000
2025-09-06,Primerica,20,18,2,40,0.050000
2025-09-06,Primoris Services,18,21,1,40,0.025000
2025-09-06,Principal Financial,9,28,3,40,0.075000
2025-09-06,ProFrac Holding,15,20,5,40,0.125000
2025-09-06,Procter & Gamble,19,18,3,40,0.075000
2025-09-06,Progressive Insurance,18,19,3,40,0.075000
2025-09-06,Prologis,20,17,3,40,0.075000
2025-09-06,Prudential Financial,19,18,3,40,0.075000
2025-09-06,Public Service Enterprise Group,19,18,3,40,0.075000
2025-09-06,Public Storage,15,18,7,40,0.175000
2025-09-06,Publix Super Markets,18,17,5,40,0.125000
2025-09-06,Puget Sound Energy,28,10,2,40,0.050000
2025-09-06,PulteGroup,29,9,2,40,0.050000
2025-09-06,Pure Storage,13,23,4,40,0.100000
2025-09-06,QVC,15,22,3,40,0.075000
2025-09-06,Qorvo,15,22,3,40,0.075000
2025-09-06,Quad/Graphics,21,14,5,40,0.125000
2025-09-06,Qualcomm,11,24,5,40,0.125000
2025-09-06,Quanta Services,10,27,3,40,0.075000
2025-09-06,Quest Diagnostics,15,22,3,40,0.075000
2025-09-06,QuidelOrtho,23,15,2,40,0.050000
2025-09-06,REV Group,18,16,6,40,0.150000
2025-09-06,RPM International,20,17,3,40,0.075000
2025-09-06,RTX,19,15,6,40,0.150000
2025-09-06,RXO inc,16,14,10,40,0.250000
2025-09-06,Rackspace Technology,17,20,3,40,0.075000
2025-09-06,Radius Recycling,7,19,14,40,0.350000
2025-09-06,Ralph Lauren,15,18,7,40,0.175000
2025-09-06,Range Resources,17,20,3,40,0.075000
2025-09-06,Raymond James Financial,21,17,2,40,0.050000
2025-09-06,Realty Income,17,15,8,40,0.200000
2025-09-06,Regal Rexnord,14,22,4,40,0.100000
2025-09-06,Regeneron Pharmaceuticals,18,19,3,40,0.075000
2025-09-06,Regions Financial,17,20,3,40,0.075000
2025-09-06,Reinsurance Group of America,20,17,3,40,0.075000
2025-09-06,Reliance Inc,27,10,3,40,0.075000
2025-09-06,Republic Services,14,17,9,40,0.225000
2025-09-06,ResMed,14,23,3,40,0.075000
2025-09-06,Resideo Technologies,24,14,2,40,0.050000
2025-09-06,Restoration Hardware,10,25,5,40,0.125000
2025-09-06,Revvity,16,15,9,40,0.225000
2025-09-06,Rite Aid,8,27,5,40,0.125000
2025-09-06,Rithm Capital,18,22,0,40,0.000000
2025-09-06,Rivian Automotive,10,23,7,40,0.175000
2025-09-06,Robert Half,19,19,2,40,0.050000
2025-09-06,Roblox,15,17,8,40,0.200000
2025-09-06,Rocket Companies,15,23,2,40,0.050000
2025-09-06,Rockwell Automation,21,19,0,40,0.000000
2025-09-06,Roku,18,21,1,40,0.025000
2025-09-06,Rollins inc,18,19,3,40,0.075000
2025-09-06,Roper Technologies,20,18,2,40,0.050000
2025-09-06,Ross Stores,14,22,4,40,0.100000
2025-09-06,Rush Enterprises,17,21,2,40,0.050000
2025-09-06,Ryder System,17,18,5,40,0.125000
2025-09-06,Ryerson Holding,19,12,9,40,0.225000
2025-09-06,S&P Global,16,21,3,40,0.075000
2025-09-06,SBA Communications,22,14,4,40,0.100000
2025-09-06,SS&C Technologies,18,19,3,40,0.075000
2025-09-06,Sabre Corporation,17,17,6,40,0.150000
2025-09-06,Saia inc,13,22,5,40,0.125000
2025-09-06,Salesforce,8,8,24,40,0.600000
2025-09-06,Sallie Mae,16,21,3,40,0.075000
2025-09-06,Sally Beauty,39,1,0,40,0.000000
2025-09-06,Sanmina,14,20,6,40,0.150000
2025-09-06,ScanSource,18,19,3,40,0.075000
2025-09-06,Schneider National,15,21,4,40,0.100000
2025-09-06,Science Applications International,16,21,3,40,0.075000
2025-09-06,Scotts Miracle-Gro,13,20,7,40,0.175000
2025-09-06,Seaboard,16,14,10,40,0.250000
2025-09-06,Sealed Air Corporation,18,21,1,40,0.025000
2025-09-06,Securian Financial,11,25,4,40,0.100000
2025-09-06,Select Medical,20,15,5,40,0.125000
2025-09-06,Selective Insurance Group,20,12,8,40,0.200000
2025-09-06,Sempra,28,12,0,40,0.000000
2025-09-06,Sentry Insurance Group,3,7,0,10,0.000000
2025-09-06,Service Corp International,10,10,8,28,0.285714
2025-09-06,ServiceNow,19,18,3,40,0.075000
2025-09-06,Sherwin-Williams,12,19,9,40,0.225000
2025-09-06,Shift4 Payments,13,20,7,40,0.175000
2025-09-06,Silgan,11,23,6,40,0.150000
2025-09-06,Simon Property Group,17,19,4,40,0.100000
2025-09-06,Sinclair,11,25,4,40,0.100000
2025-09-06,SiteOne Landscape Supply,17,16,7,40,0.175000
2025-09-06,Skechers USA,12,24,4,40,0.100000
2025-09-06,SkyWest,9,14,17,40,0.425000
2025-09-06,Skyline Champion,33,4,3,40,0.075000
2025-09-06,Skyworks Solutions,29,6,5,40,0.125000
2025-09-06,Smurfit Westrock,10,23,7,40,0.175000
2025-09-06,Snap Inc,14,12,14,40,0.350000
2025-09-06,Snap-on,13,23,4,40,0.100000
2025-09-06,Snowflake inc,22,13,5,40,0.125000
2025-09-06,Sonic Automotive,19,19,2,40,0.050000
2025-09-06,Sonoco Products,22,13,5,40,0.125000
2025-09-06,Southern Company,20,17,3,40,0.075000
2025-09-06,Southwest Airlines,18,13,9,40,0.225000
2025-09-06,Southwest Gas,21,17,2,40,0.050000
2025-09-06,Southwestern Energy,35,3,2,40,0.050000
2025-09-06,SpartanNash,15,23,2,40,0.050000
2025-09-06,Spectrum Brands,16,18,6,40,0.150000
2025-09-06,Spire inc,23,14,3,40,0.075000
2025-09-06,Spirit AeroSystems,34,1,5,40,0.125000
2025-09-06,Spirit Airlines,21,4,15,40,0.375000
2025-09-06,Splunk,13,20,7,40,0.175000
2025-09-06,Sprouts Farmers Market,13,25,2,40,0.050000
2025-09-06,Stagwell,14,25,1,40,0.025000
2025-09-06,Stanley Black & Decker,12,22,6,40,0.150000
2025-09-06,Starbucks,15,21,4,40,0.100000
2025-09-06,State Farm Insurance,14,21,5,40,0.125000
2025-09-06,State Street,14,17,9,40,0.225000
2025-09-06,Steel Dynamics,36,3,1,40,0.025000
2025-09-06,Steelcase,15,22,3,40,0.075000
2025-09-06,Stericycle,11,8,21,40,0.525000
2025-09-06,Stifel Financial,24,14,2,40,0.050000
2025-09-06,StoneX,17,20,3,40,0.075000
2025-09-06,Stryker,15,18,7,40,0.175000
2025-09-06,Summit Materials,11,25,4,40,0.100000
2025-09-06,Sun Communities,20,17,3,40,0.075000
2025-09-06,Super Micro Computer,32,6,2,40,0.050000
2025-09-06,Surgery Partners,14,21,5,40,0.125000
2025-09-06,Sylvamo,14,17,9,40,0.225000
2025-09-06,Synchrony Financial,25,12,3,40,0.075000
2025-09-06,Synopsys,14,25,1,40,0.025000
2025-09-06,Synovus Financial,13,24,3,40,0.075000
2025-09-06,Sysco,22,13,5,40,0.125000
2025-09-06,T Rowe Price,17,23,0,40,0.000000
2025-09-06,TD Synnex,23,17,0,40,0.000000
2025-09-06,TEGNA,14,24,2,40,0.050000
2025-09-06,TIAA,12,26,2,40,0.050000
2025-09-06,TJX,19,14,7,40,0.175000
2025-09-06,Take-Two Interactive Software,19,19,2,40,0.050000
2025-09-06,Talen Energy,40,0,0,40,0.000000
2025-09-06,Tapestry,14,18,8,40,0.200000
2025-09-06,Targa Resources,22,11,7,40,0.175000
2025-09-06,Target,13,21,6,40,0.150000
2025-09-06,Taylor Morrison Home,12,24,4,40,0.100000
2025-09-06,Teladoc Health,17,17,6,40,0.150000
2025-09-06,Teledyne Technologies,14,24,2,40,0.050000
2025-09-06,Teleflex,12,25,3,40,0.075000
2025-09-06,Telephone & Data Systems,14,20,6,40,0.150000
2025-09-06,TelevisaUnivision,19,18,3,40,0.075000
2025-09-06,Tempur Sealy International,10,24,6,40,0.150000
2025-09-06,Tenet Healthcare,19,16,5,40,0.125000
2025-09-06,Teradyne,17,21,2,40,0.050000
2025-09-06,Terex,17,19,4,40,0.100000
2025-09-06,Tesla,9,14,17,40,0.425000
2025-09-06,Tetra Tech,19,15,6,40,0.150000
2025-09-06,Texas Instruments,8,17,15,40,0.375000
2025-09-06,Texas Roadhouse,10,22,8,40,0.200000
2025-09-06,Textron,18,18,4,40,0.100000
2025-09-06,The Andersons Inc,13,22,5,40,0.125000
2025-09-06,The Coca-Cola Company,14,22,4,40,0.100000
2025-09-06,The Hartford,17,14,9,40,0.225000
2025-09-06,Thermo Fisher Scientific,15,20,5,40,0.125000
2025-09-06,Thor Industries,14,18,8,40,0.200000
2025-09-06,Thrivent Financial for Lutherans,14,21,5,40,0.125000
2025-09-06,Timken,12,25,3,40,0.075000
2025-09-06,Titan Machinery,11,23,6,40,0.150000
2025-09-06,Toast inc,25,14,1,40,0.025000
2025-09-06,Toll Brothers,10,24,6,40,0.150000
2025-09-06,TopBuild,17,20,3,40,0.075000
2025-09-06,Topgolf Callaway Brands,14,20,6,40,0.150000
2025-09-06,Toro Company,20,17,3,40,0.075000
2025-09-06,Tractor Supply,22,17,1,40,0.025000
2025-09-06,TransDigm,15,19,6,40,0.150000
2025-09-06,TransUnion,14,12,14,40,0.350000
2025-09-06,Travelers Insurance,10,21,9,40,0.225000
2025-09-06,TreeHouse Foods,13,18,9,40,0.225000
2025-09-06,Tri Pointe Homes,13,25,2,40,0.050000
2025-09-06,TriNet Group,24,12,4,40,0.100000
2025-09-06,Trimble,9,26,5,40,0.125000
2025-09-06,Trinity Industries,19,18,3,40,0.075000
2025-09-06,TruStage,27,11,2,40,0.050000
2025-09-06,Truist Financial,23,14,3,40,0.075000
2025-09-06,Tutor Perini Corporation,23,11,6,40,0.150000
2025-09-06,Twilio,16,19,5,40,0.125000
2025-09-06,Tyson Foods,12,16,12,40,0.300000
2025-09-06,U-Haul,3,7,30,40,0.750000
2025-09-06,UFP Industries,16,20,4,40,0.100000
2025-09-06,UGI Utilities Inc,19,15,6,40,0.150000
2025-09-06,UL Solutions,37,2,1,40,0.025000
2025-09-06,UPS,16,17,7,40,0.175000
2025-09-06,US Bancorp,15,23,2,40,0.050000
2025-09-06,US Foods,19,18,3,40,0.075000
2025-09-06,USAA,18,13,9,40,0.225000
2025-09-06,Uber,9,20,11,40,0.275000
2025-09-06,Ulta Beauty,35,4,1,40,0.025000
2025-09-06,Under Armour,10,26,4,40,0.100000
2025-09-06,Union Pacific,22,14,4,40,0.100000
2025-09-06,United Airlines,33,3,4,40,0.100000
2025-09-06,United Natural Foods,40,0,0,40,0.000000
2025-09-06,United Rentals,37,3,0,40,0.000000
2025-09-06,United States Steel,27,8,5,40,0.125000
2025-09-06,UnitedHealth,11,21,8,40,0.200000
2025-09-06,Universal Corporation,19,19,2,40,0.050000
2025-09-06,Universal Health Services,18,17,5,40,0.125000
2025-09-06,Unum Group,17,19,4,40,0.100000
2025-09-06,Upbound Group,24,15,1,40,0.025000
2025-09-06,Urban Outfitters,15,20,5,40,0.125000
2025-09-06,V2X,21,17,2,40,0.050000
2025-09-06,VF Corporation,18,20,2,40,0.050000
2025-09-06,VICI Properties,21,16,3,40,0.075000
2025-09-06,Vail Resorts,12,16,12,40,0.300000
2025-09-06,Valero Energy,37,1,2,40,0.050000
2025-09-06,Valley National Bancorp,11,22,7,40,0.175000
2025-09-06,Valmont Industries,25,10,5,40,0.125000
2025-09-06,Valvoline inc,11,23,6,40,0.150000
2025-09-06,Ventas inc,26,12,2,40,0.050000
2025-09-06,Verisk Analytics,15,16,9,40,0.225000
2025-09-06,Verizon,19,17,4,40,0.100000
2025-09-06,Vertex Pharmaceuticals,15,19,6,40,0.150000
2025-09-06,Vertiv,17,22,1,40,0.025000
2025-09-06,Viasat,21,18,1,40,0.025000
2025-09-06,Viatris,9,20,11,40,0.275000
2025-09-06,Victorias Secret,12,18,10,40,0.250000
2025-09-06,Visa,7,18,15,40,0.375000
2025-09-06,Vishay Intertechnology,15,18,7,40,0.175000
2025-09-06,Vista Outdoor,16,20,4,40,0.100000
2025-09-06,Visteon,21,18,1,40,0.025000
2025-09-06,Vistra,22,16,2,40,0.050000
2025-09-06,Vontier,19,18,3,40,0.075000
2025-09-06,Voya Financial,17,20,3,40,0.075000
2025-09-06,Vulcan Materials,11,22,7,40,0.175000
2025-09-06,WEC Energy,36,0,4,40,0.100000
2025-09-06,WESCO International,17,21,2,40,0.050000
2025-09-06,WEX,15,21,4,40,0.100000
2025-09-06,WR Berkley,9,23,8,40,0.200000
2025-09-06,WW Grainger,16,16,8,40,0.200000
2025-09-06,Wabash National,14,15,11,40,0.275000
2025-09-06,Walgreens,5,27,8,40,0.200000
2025-09-06,Walmart,12,14,14,40,0.350000
2025-09-06,Walt Disney,20,19,1,40,0.025000
2025-09-06,Warner Bros Discovery,6,24,10,40,0.250000
2025-09-06,Warner Music Group,11,27,2,40,0.050000
2025-09-06,Waters Corporation,17,18,5,40,0.125000
2025-09-06,Watsco,17,16,7,40,0.175000
2025-09-06,Wayfair,17,18,5,40,0.125000
2025-09-06,Webster Financial,12,25,3,40,0.075000
2025-09-06,Weis Markets,12,22,6,40,0.150000
2025-09-06,Wells Fargo,37,2,1,40,0.025000
2025-09-06,Welltower,29,11,0,40,0.000000
2025-09-06,Werner Enterprises,18,14,8,40,0.200000
2025-09-06,West Pharmaceutical Services,17,15,8,40,0.200000
2025-09-06,Western & Southern Financial,16,20,4,40,0.100000
2025-09-06,Western Alliance Bancorp,16,15,9,40,0.225000
2025-09-06,Western Digital,20,19,1,40,0.025000
2025-09-06,Western Midstream Partners,19,19,2,40,0.050000
2025-09-06,Western Union,13,24,3,40,0.075000
2025-09-06,Westinghouse Air Brake Technologies,20,15,5,40,0.125000
2025-09-06,Westlake Corporation,16,21,3,40,0.075000
2025-09-06,Weyerhaeuser,7,26,7,40,0.175000
2025-09-06,Whirlpool,16,17,7,40,0.175000
2025-09-06,Williams,6,18,16,40,0.400000
2025-09-06,Williams-Sonoma,20,17,3,40,0.075000
2025-09-06,Winnebago Industries,12,22,6,40,0.150000
2025-09-06,Wintrust Financial,19,17,4,40,0.100000
2025-09-06,Woodward inc,17,23,0,40,0.000000
2025-09-06,Workday,11,18,11,40,0.275000
2025-09-06,World Kinect,23,12,5,40,0.125000
2025-09-06,Worthington Enterprises,19,20,1,40,0.025000
2025-09-06,Wynn Resorts,20,13,7,40,0.175000
2025-09-06,XPO,13,24,3,40,0.075000
2025-09-06,Xcel Energy,37,1,2,40,0.050000
2025-09-06,Xerox,14,20,6,40,0.150000
2025-09-06,Xylem Inc,26,12,2,40,0.050000
2025-09-06,Yum Brands,14,21,5,40,0.125000
2025-09-06,Yum China,18,19,3,40,0.075000
2025-09-06,Zebra Technologies,19,18,3,40,0.075000
2025-09-06,Zimmer Biomet,13,25,2,40,0.050000
2025-09-06,Zions Bancorp,18,15,7,40,0.175000
2025-09-06,Zoetis,22,13,5,40,0.125000
2025-09-06,Zoom Video Communications,11,24,5,40,0.125000
2025-09-06,eXp World,16,22,2,40,0.050000
2025-09-06,iHeartMedia,13,25,2,40,0.050000
2025-09-07,3M,19,17,4,40,0.100000
2025-09-07,A O Smith,14,24,2,40,0.050000
2025-09-07,A-Mark Precious Metals,39,1,0,40,0.000000
2025-09-07,ABM Industries,10,20,10,40,0.250000
2025-09-07,ADT,17,16,7,40,0.175000
2025-09-07,AECOM,21,17,2,40,0.050000
2025-09-07,AES,17,17,6,40,0.150000
2025-09-07,AGCO,21,15,4,40,0.100000
2025-09-07,AGNC Investment,16,18,6,40,0.150000
2025-09-07,AMC Entertainment,33,5,2,40,0.050000
2025-09-07,AMC Networks,15,14,11,40,0.275000
2025-09-07,AMN Healthcare Services,12,22,6,40,0.150000
2025-09-07,APA,18,16,6,40,0.150000
2025-09-07,APi Group,13,23,4,40,0.100000
2025-09-07,ARKO,11,27,2,40,0.050000
2025-09-07,ASGN,11,18,11,40,0.275000
2025-09-07,AT&T,20,17,3,40,0.075000
2025-09-07,ATI inc,19,17,4,40,0.100000
2025-09-07,AbbVie,11,24,5,40,0.125000
2025-09-07,Abbott Laboratories,18,15,7,40,0.175000
2025-09-07,Abercrombie & Fitch,12,25,3,40,0.075000
2025-09-07,Academy Sports and Outdoors,13,22,5,40,0.125000
2025-09-07,Acadia Healthcare,13,18,9,40,0.225000
2025-09-07,Acuity Inc,23,17,0,40,0.000000
2025-09-07,Adams Resources & Energy,19,8,1,28,0.035714
2025-09-07,AdaptHealth,15,22,3,40,0.075000
2025-09-07,Adobe,20,18,2,40,0.050000
2025-09-07,Advance Auto Parts,11,16,13,40,0.325000
2025-09-07,Advanced Drainage Systems,33,7,0,40,0.000000
2025-09-07,Advanced Micro Devices,26,5,9,40,0.225000
2025-09-07,Advantage Solutions,38,0,2,40,0.050000
2025-09-07,Aflac,10,15,15,40,0.375000
2025-09-07,Agilent Technologies,21,17,2,40,0.050000
2025-09-07,Agilon Health,18,16,6,40,0.150000
2025-09-07,Air Lease,11,28,1,40,0.025000
2025-09-07,Air Products & Chemicals,15,19,6,40,0.150000
2025-09-07,Airbnb,14,19,7,40,0.175000
2025-09-07,Akamai Technologies,17,18,5,40,0.125000
2025-09-07,Alaska Air,11,23,6,40,0.150000
2025-09-07,Albemarle Corporation,17,21,2,40,0.050000
2025-09-07,Albertsons,19,17,4,40,0.100000
2025-09-07,Alcoa Corporation,11,23,6,40,0.150000
2025-09-07,Alexandria Real Estate Equities,15,22,3,40,0.075000
2025-09-07,Alight Solutions,14,22,4,40,0.100000
2025-09-07,Align Technology,7,23,10,40,0.250000
2025-09-07,Allegiant Travel Company,16,20,4,40,0.100000
2025-09-07,Alliance Resource Partners,14,14,12,40,0.300000
2025-09-07,Alliant Energy,30,7,3,40,0.075000
2025-09-07,Allison Transmission,17,18,5,40,0.125000
2025-09-07,Allstate,25,13,2,40,0.050000
2025-09-07,Ally Financial,13,25,2,40,0.050000
2025-09-07,Alpha Metallurgical Resources,15,20,5,40,0.125000
2025-09-07,Alphabet,20,10,10,40,0.250000
2025-09-07,Altice,13,20,7,40,0.175000
2025-09-07,Altria,18,16,6,40,0.150000
2025-09-07,Amazon,34,1,5,40,0.125000
2025-09-07,Ameren,19,16,5,40,0.125000
2025-09-07,American Airlines,6,19,15,40,0.375000
2025-09-07,American Axle & Manufacturing,17,21,2,40,0.050000
2025-09-07,American Eagle Outfitters,20,16,4,40,0.100000
2025-09-07,American Electric Power,20,16,4,40,0.100000
2025-09-07,American Express,24,8,8,40,0.200000
2025-09-07,American Family Insurance,21,16,3,40,0.075000
2025-09-07,American Financial,17,20,3,40,0.075000
2025-09-07,American International Group,20,19,1,40,0.025000
2025-09-07,American Tower,20,17,3,40,0.075000
2025-09-07,American Water Works,12,24,4,40,0.100000
2025-09-07,Americold Realty Trust,35,4,1,40,0.025000
2025-09-07,Ameriprise Financial,23,14,3,40,0.075000
2025-09-07,Ametek,26,12,2,40,0.050000
2025-09-07,Amgen,21,18,1,40,0.025000
2025-09-07,Amica Mutual Insurance,14,24,2,40,0.050000
2025-09-07,Amkor Technology,14,26,0,40,0.000000
2025-09-07,Amphenol,19,19,2,40,0.050000
2025-09-07,Analog Devices,17,20,3,40,0.075000
2025-09-07,Antero Resources,18,20,2,40,0.050000
2025-09-07,Anywhere Real Estate Inc,21,17,2,40,0.050000
2025-09-07,Apollo Global Management,12,26,2,40,0.050000
2025-09-07,AppLovin,18,19,3,40,0.075000
2025-09-07,Apple,12,23,5,40,0.125000
2025-09-07,Applied Industrial Technologies,15,23,2,40,0.050000
2025-09-07,Applied Materials,6,18,16,40,0.400000
2025-09-07,AptarGroup,13,23,4,40,0.100000
2025-09-07,Aramark,21,17,2,40,0.050000
2025-09-07,ArcBest,12,26,2,40,0.050000
2025-09-07,Arch Resources,30,6,4,40,0.100000
2025-09-07,Archer Daniels Midland,20,16,4,40,0.100000
2025-09-07,Ares Management,22,15,3,40,0.075000
2025-09-07,Arista Networks,19,19,2,40,0.050000
2025-09-07,Arrow Electronics,19,18,3,40,0.075000
2025-09-07,Arthur J Gallagher,9,27,4,40,0.100000
2025-09-07,Asbury Automotive Group,8,29,3,40,0.075000
2025-09-07,Assurant,21,16,3,40,0.075000
2025-09-07,Atkore,16,20,4,40,0.100000
2025-09-07,Atlassian,9,28,3,40,0.075000
2025-09-07,Atmos Energy,38,1,1,40,0.025000
2025-09-07,Auto-Owners Insurance,16,18,6,40,0.150000
2025-09-07,AutoNation,16,19,5,40,0.125000
2025-09-07,AutoZone,14,19,7,40,0.175000
2025-09-07,Autodesk,19,20,1,40,0.025000
2025-09-07,Autoliv,24,16,0,40,0.000000
2025-09-07,Automatic Data Processing,18,20,2,40,0.050000
2025-09-07,AvalonBay Communities,15,23,2,40,0.050000
2025-09-07,Avantor,10,23,7,40,0.175000
2025-09-07,Avery Dennison,9,29,2,40,0.050000
2025-09-07,Avient,16,20,4,40,0.100000
2025-09-07,Avis Budget,9,24,7,40,0.175000
2025-09-07,Avnet,10,25,5,40,0.125000
2025-09-07,BJs Wholesale Club,11,22,7,40,0.175000
2025-09-07,BOK Financial,23,12,5,40,0.125000
2025-09-07,BWX Technologies,24,15,1,40,0.025000
2025-09-07,Baker Hughes,16,18,6,40,0.150000
2025-09-07,Ball,16,12,12,40,0.300000
2025-09-07,Bank of America,14,19,7,40,0.175000
2025-09-07,Bank of New York Mellon,24,14,2,40,0.050000
2025-09-07,Bath & Body Works,7,20,13,40,0.325000
2025-09-07,Baxter International,13,18,9,40,0.225000
2025-09-07,Beacon Roofing Supply,7,22,11,40,0.275000
2025-09-07,Becton Dickinson,16,20,4,40,0.100000
2025-09-07,Belden,10,24,6,40,0.150000
2025-09-07,Benchmark Electronics,21,13,6,40,0.150000
2025-09-07,Berkshire Hathaway,12,21,7,40,0.175000
2025-09-07,Best Buy,32,5,3,40,0.075000
2025-09-07,Big Lots,6,32,2,40,0.050000
2025-09-07,Bio-Rad Laboratories,14,20,6,40,0.150000
2025-09-07,Biogen,18,21,1,40,0.025000
2025-09-07,BlackRock,14,14,12,40,0.300000
2025-09-07,Blackstone,11,21,8,40,0.200000
2025-09-07,Bloomin Brands,5,27,8,40,0.200000
2025-09-07,BlueLinx,17,20,3,40,0.075000
2025-09-07,Boeing,7,18,15,40,0.375000
2025-09-07,Boise Cascade,13,14,13,40,0.325000
2025-09-07,Booking Holdings,16,21,3,40,0.075000
2025-09-07,Booz Allen Hamilton,18,16,6,40,0.150000
2025-09-07,BorgWarner,24,16,0,40,0.000000
2025-09-07,Boston Properties,12,21,7,40,0.175000
2025-09-07,Boston Scientific,19,15,6,40,0.150000
2025-09-07,Boyd Gaming,14,25,1,40,0.025000
2025-09-07,Bread Financial,26,13,1,40,0.025000
2025-09-07,BrightSpring Health Services,19,17,4,40,0.100000
2025-09-07,BrightView Holdings,23,15,2,40,0.050000
2025-09-07,Brighthouse Financial,15,20,5,40,0.125000
2025-09-07,Brinker International,21,17,2,40,0.050000
2025-09-07,Brinks Company,7,3,5,15,0.333333
2025-09-07,Bristol-Myers Squibb,10,24,6,40,0.150000
2025-09-07,Broadcom,19,17,4,40,0.100000
2025-09-07,Broadridge Financial Solutions,33,3,4,40,0.100000
2025-09-07,Brookdale Senior Living,16,15,9,40,0.225000
2025-09-07,Brown & Brown,13,22,5,40,0.125000
2025-09-07,Brown-Forman,9,23,8,40,0.200000
2025-09-07,Bruker,12,17,11,40,0.275000
2025-09-07,Brunswick,11,14,15,40,0.375000
2025-09-07,Builders FirstSource,20,18,2,40,0.050000
2025-09-07,Burlington Stores,16,21,3,40,0.075000
2025-09-07,CACI International,24,14,2,40,0.050000
2025-09-07,CBRE Group,18,22,0,40,0.000000
2025-09-07,CDW,15,23,2,40,0.050000
2025-09-07,CF Industries,21,16,3,40,0.075000
2025-09-07,CH Robinson Worldwide,17,16,7,40,0.175000
2025-09-07,CHS,20,17,3,40,0.075000
2025-09-07,CME Group,18,20,2,40,0.050000
2025-09-07,CMS Energy,37,1,2,40,0.050000
2025-09-07,CNO Financial Group,17,21,2,40,0.050000
2025-09-07,CNX Resources,18,21,1,40,0.025000
2025-09-07,CSX,14,15,11,40,0.275000
2025-09-07,CVS Health,19,15,6,40,0.150000
2025-09-07,Cabot Corporation,16,21,3,40,0.075000
2025-09-07,Cadence,10,27,3,40,0.075000
2025-09-07,Caesars Entertainment,33,7,0,40,0.000000
2025-09-07,Cal-Maine Foods,20,17,3,40,0.075000
2025-09-07,Caleres inc,20,16,4,40,0.100000
2025-09-07,California Resources,20,16,4,40,0.100000
2025-09-07,Calumet,11,16,13,40,0.325000
2025-09-07,Campbell Soup,18,18,4,40,0.100000
2025-09-07,Camping World,13,21,6,40,0.150000
2025-09-07,Capital One,23,15,2,40,0.050000
2025-09-07,CarMax,10,29,1,40,0.025000
2025-09-07,Cardinal Health,20,16,4,40,0.100000
2025-09-07,Carlisle Companies,19,14,7,40,0.175000
2025-09-07,Carlyle Group,10,29,1,40,0.025000
2025-09-07,Carpenter Technology,18,20,2,40,0.050000
2025-09-07,Carrier Global,15,22,3,40,0.075000
2025-09-07,Carters inc,10,21,2,33,0.060606
2025-09-07,Carvana,19,17,4,40,0.100000
2025-09-07,Caseys General Stores,14,21,5,40,0.125000
2025-09-07,Catalent,10,25,5,40,0.125000
2025-09-07,Caterpillar,15,18,7,40,0.175000
2025-09-07,Cboe Global Markets,17,21,2,40,0.050000
2025-09-07,Celanese,13,12,15,40,0.375000
2025-09-07,Cencora,21,19,0,40,0.000000
2025-09-07,Centene,15,7,18,40,0.450000
2025-09-07,CenterPoint Energy,27,6,7,40,0.175000
2025-09-07,Central Garden & Pet,11,26,3,40,0.075000
2025-09-07,Century Communities,17,18,5,40,0.125000
2025-09-07,ChampionX,23,17,0,40,0.000000
2025-09-07,Charles River Laboratories International,14,21,5,40,0.125000
2025-09-07,Charles Schwab,17,20,3,40,0.075000
2025-09-07,Chart Industries,13,25,2,40,0.050000
2025-09-07,Charter Communications,11,19,10,40,0.250000
2025-09-07,Cheesecake Factory,13,16,11,40,0.275000
2025-09-07,Chefs Warehouse,17,19,4,40,0.100000
2025-09-07,Chemours,14,15,11,40,0.275000
2025-09-07,Cheniere Energy,37,3,0,40,0.000000
2025-09-07,Chevron,15,15,10,40,0.250000
2025-09-07,Chewy,21,14,5,40,0.125000
2025-09-07,Chipotle Mexican Grill,14,21,5,40,0.125000
2025-09-07,Chord Energy,37,1,2,40,0.050000
2025-09-07,Church & Dwight,18,20,2,40,0.050000
2025-09-07,Ciena,13,23,4,40,0.100000
2025-09-07,Cigna,17,21,2,40,0.050000
2025-09-07,Cincinnati Financial,15,22,3,40,0.075000
2025-09-07,Cinemark,8,27,5,40,0.125000
2025-09-07,Cintas,20,15,5,40,0.125000
2025-09-07,Cisco Systems,14,23,3,40,0.075000
2025-09-07,Citigroup,20,16,4,40,0.100000
2025-09-07,Citizens Financial Group,14,22,4,40,0.100000
2025-09-07,Civitas Resources,14,14,12,40,0.300000
2025-09-07,Clean Harbors,31,3,6,40,0.150000
2025-09-07,Clear Channel Outdoor Hldgs,8,0,2,10,0.200000
2025-09-07,Cleveland-Cliffs,10,12,18,40,0.450000
2025-09-07,Clorox,16,14,10,40,0.250000
2025-09-07,Cognizant Technology Solutions,34,6,0,40,0.000000
2025-09-07,Coherent,19,17,4,40,0.100000
2025-09-07,Coinbase Global,13,24,3,40,0.075000
2025-09-07,Colgate-Palmolive,15,14,11,40,0.275000
2025-09-07,Columbia Banking System,15,24,1,40,0.025000
2025-09-07,Columbia Sportswear,10,17,13,40,0.325000
2025-09-07,Comcast,17,18,5,40,0.125000
2025-09-07,Comerica,20,18,2,40,0.050000
2025-09-07,Comfort Systems USA,39,0,1,40,0.025000
2025-09-07,CommScope,18,22,0,40,0.000000
2025-09-07,Commercial Metals,13,17,10,40,0.250000
2025-09-07,Community Health Systems,18,16,6,40,0.150000
2025-09-07,Compass,10,24,6,40,0.150000
2025-09-07,Conagra Brands,15,24,1,40,0.025000
2025-09-07,Concentrix,15,20,5,40,0.125000
2025-09-07,Conduent,15,19,6,40,0.150000
2025-09-07,ConocoPhillips,4,22,14,40,0.350000
2025-09-07,Consol Energy,32,6,2,40,0.050000
2025-09-07,Consolidated Edison,13,20,7,40,0.175000
2025-09-07,Constellation Brands,4,14,22,40,0.550000
2025-09-07,Constellation Energy,29,9,2,40,0.050000
2025-09-07,Continental Resources,19,14,7,40,0.175000
2025-09-07,Cooper Cos,8,28,4,40,0.100000
2025-09-07,Cooper-Standard,13,24,3,40,0.075000
2025-09-07,Copart,21,16,3,40,0.075000
2025-09-07,Core & Main,17,21,2,40,0.050000
2025-09-07,Cornerstone Building Brands,15,21,4,40,0.100000
2025-09-07,Corning,8,26,6,40,0.150000
2025-09-07,Corpay,15,25,0,40,0.000000
2025-09-07,Corteva,20,16,4,40,0.100000
2025-09-07,Costco,16,19,5,40,0.125000
2025-09-07,Coterra Energy,34,3,3,40,0.075000
2025-09-07,Coty,12,17,11,40,0.275000
2025-09-07,Country Financial,16,20,4,40,0.100000
2025-09-07,Coupang,15,23,2,40,0.050000
2025-09-07,Cracker Barrel Old Country Store,6,21,13,40,0.325000
2025-09-07,Crocs,10,29,1,40,0.025000
2025-09-07,CrossAmerica Partners,14,19,7,40,0.175000
2025-09-07,CrowdStrike,12,13,15,40,0.375000
2025-09-07,Crown Castle,20,18,2,40,0.050000
2025-09-07,Crown Holdings,18,19,3,40,0.075000
2025-09-07,Cullen Frost Bankers,20,16,4,40,0.100000
2025-09-07,Cummins,12,21,7,40,0.175000
2025-09-07,Curtiss-Wright,19,19,2,40,0.050000
2025-09-07,DR Horton,14,22,4,40,0.100000
2025-09-07,DTE Energy,31,4,5,40,0.125000
2025-09-07,DXC Technology,19,20,1,40,0.025000
2025-09-07,DaVita,11,14,15,40,0.375000
2025-09-07,Dana Incorporated,19,17,4,40,0.100000
2025-09-07,Danaher,15,23,2,40,0.050000
2025-09-07,Darden Restaurants,20,16,4,40,0.100000
2025-09-07,Darling Ingredients,40,0,0,40,0.000000
2025-09-07,Deckers Outdoor,28,12,0,40,0.000000
2025-09-07,Deere,5,20,15,40,0.375000
2025-09-07,Delek US,27,11,2,40,0.050000
2025-09-07,Dell Technologies,19,16,5,40,0.125000
2025-09-07,Delta Air Lines,10,21,9,40,0.225000
2025-09-07,Dentsply Sirona,13,24,3,40,0.075000
2025-09-07,Designer Brands,8,28,4,40,0.100000
2025-09-07,Devon Energy,38,0,2,40,0.050000
2025-09-07,DexCom,11,23,6,40,0.150000
2025-09-07,Diamondback Energy,37,0,3,40,0.075000
2025-09-07,Dicks Sporting Goods,10,26,4,40,0.100000
2025-09-07,Diebold Nixdorf,15,24,1,40,0.025000
2025-09-07,Digital Realty Trust,33,7,0,40,0.000000
2025-09-07,Dillards,9,22,9,40,0.225000
2025-09-07,DocuSign,17,16,7,40,0.175000
2025-09-07,Dollar General,10,18,12,40,0.300000
2025-09-07,Dollar Tree,17,15,8,40,0.200000
2025-09-07,Dominion Energy,30,5,5,40,0.125000
2025-09-07,Dominos Pizza inc,17,16,6,39,0.153846
2025-09-07,Domtar,9,23,8,40,0.200000
2025-09-07,Donaldson Company,23,15,2,40,0.050000
2025-09-07,DoorDash,21,10,9,40,0.225000
2025-09-07,Dover Corporation,20,14,6,40,0.150000
2025-09-07,DraftKings,27,10,3,40,0.075000
2025-09-07,Dream Finders Homes,36,1,3,40,0.075000
2025-09-07,Dropbox,18,19,3,40,0.075000
2025-09-07,DuPont,10,24,6,40,0.150000
2025-09-07,Duke Energy,36,2,2,40,0.050000
2025-09-07,Dycom Industries,18,17,5,40,0.125000
2025-09-07,EMCOR Group,19,19,2,40,0.050000
2025-09-07,EOG Resources,20,18,2,40,0.050000
2025-09-07,EPAM Systems,21,17,2,40,0.050000
2025-09-07,EQT,23,13,4,40,0.100000
2025-09-07,ESAB,17,21,2,40,0.050000
2025-09-07,East West Bancorp,25,14,1,40,0.025000
2025-09-07,Eastman Chemical,9,18,13,40,0.325000
2025-09-07,Ebay,18,17,5,40,0.125000
2025-09-07,EchoStar,14,22,4,40,0.100000
2025-09-07,Ecolab,19,17,4,40,0.100000
2025-09-07,Edison International,9,21,10,40,0.250000
2025-09-07,Edward Jones,14,20,6,40,0.150000
2025-09-07,Edwards Lifesciences,20,11,9,40,0.225000
2025-09-07,Elanco Animal Health,13,26,1,40,0.025000
2025-09-07,Electronic Arts,10,23,7,40,0.175000
2025-09-07,Elevance Health,14,9,17,40,0.425000
2025-09-07,Eli Lilly,14,18,8,40,0.200000
2025-09-07,Emerson Electric,18,21,1,40,0.025000
2025-09-07,EnLink Midstream,15,20,5,40,0.125000
2025-09-07,Encompass Health,12,27,1,40,0.025000
2025-09-07,Endeavor Group,12,23,5,40,0.125000
2025-09-07,EnerSys,20,16,4,40,0.100000
2025-09-07,Energizer,36,3,1,40,0.025000
2025-09-07,Energy Transfer,35,0,5,40,0.125000
2025-09-07,Ensign Group,21,17,2,40,0.050000
2025-09-07,Entegris,20,19,1,40,0.025000
2025-09-07,Entergy,20,16,4,40,0.100000
2025-09-07,Enterprise Products Partners,26,10,4,40,0.100000
2025-09-07,Envista,16,20,4,40,0.100000
2025-09-07,Equifax,21,14,5,40,0.125000
2025-09-07,Equinix,24,16,0,40,0.000000
2025-09-07,Equitable,21,15,4,40,0.100000
2025-09-07,Equity Residential,13,20,7,40,0.175000
2025-09-07,Erie Insurance,15,12,13,40,0.325000
2025-09-07,Estée Lauder,12,18,10,40,0.250000
2025-09-07,Etsy,13,19,8,40,0.200000
2025-09-07,Euronet Worldwide,17,22,1,40,0.025000
2025-09-07,Evergy,23,11,6,40,0.150000
2025-09-07,Eversource Energy,28,7,5,40,0.125000
2025-09-07,Exact Sciences,9,17,14,40,0.350000
2025-09-07,Exelon,21,18,1,40,0.025000
2025-09-07,Expand Energy,39,1,0,40,0.000000
2025-09-07,Expedia,15,20,5,40,0.125000
2025-09-07,Expeditors International of Washington,16,19,5,40,0.125000
2025-09-07,Extra Space Storage,15,19,6,40,0.150000
2025-09-07,Exxon Mobil,11,25,4,40,0.100000
2025-09-07,F5,8,23,9,40,0.225000
2025-09-07,FM Global,15,17,8,40,0.200000
2025-09-07,FMC Corporation,16,20,4,40,0.100000
2025-09-07,FTI Consulting,13,21,6,40,0.150000
2025-09-07,Fannie Mae,4,34,2,40,0.050000
2025-09-07,Farmers Insurance Exchange,9,19,12,40,0.300000
2025-09-07,Fastenal,18,19,3,40,0.075000
2025-09-07,FedEx,16,15,9,40,0.225000
2025-09-07,Federated Mutual Insurance,19,14,7,40,0.175000
2025-09-07,Fidelity National Financial,16,20,4,40,0.100000
2025-09-07,Fidelity National Information Services,22,16,2,40,0.050000
2025-09-07,Fifth Third Bancorp,26,13,1,40,0.025000
2025-09-07,First American Financial,18,20,2,40,0.050000
2025-09-07,First Citizens BancShares,12,26,2,40,0.050000
2025-09-07,First Horizon,19,21,0,40,0.000000
2025-09-07,First National of Nebraska,18,22,0,40,0.000000
2025-09-07,First Solar,24,10,6,40,0.150000
2025-09-07,FirstCash,11,22,7,40,0.175000
2025-09-07,FirstEnergy,18,16,6,40,0.150000
2025-09-07,Fiserv,16,20,4,40,0.100000
2025-09-07,Five Below,20,17,3,40,0.075000
2025-09-07,Flagstar Financial,15,21,4,40,0.100000
2025-09-07,Floor & Decor,17,22,1,40,0.025000
2025-09-07,Flowers Foods,9,24,7,40,0.175000
2025-09-07,Flowserve,14,22,4,40,0.100000
2025-09-07,Fluor,16,15,9,40,0.225000
2025-09-07,Foot Locker,8,24,8,40,0.200000
2025-09-07,Ford Motor,16,19,5,40,0.125000
2025-09-07,Fortinet,9,17,14,40,0.350000
2025-09-07,Fortive,16,13,11,40,0.275000
2025-09-07,Fortune Brands Innovations,17,18,5,40,0.125000
2025-09-07,Franklin Resources,13,25,2,40,0.050000
2025-09-07,Freddie Mac,7,25,8,40,0.200000
2025-09-07,Freeport-McMoRan,24,11,5,40,0.125000
2025-09-07,Frontier Airlines,9,22,9,40,0.225000
2025-09-07,Frontier Communications,16,23,1,40,0.025000
2025-09-07,G-III Apparel Group,13,26,1,40,0.025000
2025-09-07,GE HealthCare Technologies,19,17,4,40,0.100000
2025-09-07,GMS,18,20,2,40,0.050000
2025-09-07,GXO Logistics,11,23,6,40,0.150000
2025-09-07,GameStop,9,22,9,40,0.225000
2025-09-07,Gannett,19,12,9,40,0.225000
2025-09-07,Garrett Motion inc,15,19,6,40,0.150000
2025-09-07,Gartner,13,21,6,40,0.150000
2025-09-07,Gen Digital,21,16,3,40,0.075000
2025-09-07,Generac,21,14,5,40,0.125000
2025-09-07,General Dynamics,40,0,0,40,0.000000
2025-09-07,General Electric,10,28,2,40,0.050000
2025-09-07,General Mills,20,16,4,40,0.100000
2025-09-07,General Motors,9,22,9,40,0.225000
2025-09-07,Genesis Energy,37,2,1,40,0.025000
2025-09-07,Genuine Parts,15,23,2,40,0.050000
2025-09-07,Genworth Financial,27,13,0,40,0.000000
2025-09-07,Gilead Sciences,16,21,3,40,0.075000
2025-09-07,Global Partners,16,18,6,40,0.150000
2025-09-07,Global Payments,13,26,1,40,0.025000
2025-09-07,Globe Life,20,17,3,40,0.075000
2025-09-07,GoDaddy,15,22,3,40,0.075000
2025-09-07,Goldman Sachs,9,24,7,40,0.175000
2025-09-07,Goodyear Tire & Rubber,13,21,6,40,0.150000
2025-09-07,Graham Holdings Company,27,11,2,40,0.050000
2025-09-07,Granite Construction,20,18,2,40,0.050000
2025-09-07,Graphic Packaging,12,24,4,40,0.100000
2025-09-07,Graybar Electric,13,20,7,40,0.175000
2025-09-07,Green Plains inc,15,18,7,40,0.175000
2025-09-07,Greenbrier,9,13,18,40,0.450000
2025-09-07,Greif,11,23,6,40,0.150000
2025-09-07,Griffon Corporation,20,18,2,40,0.050000
2025-09-07,Grocery Outlet Holding,15,23,2,40,0.050000
2025-09-07,Group 1 Automotive,15,23,2,40,0.050000
2025-09-07,Guardian Life insurance,18,22,0,40,0.000000
2025-09-07,Guess inc,17,21,2,40,0.050000
2025-09-07,H B Fuller,16,19,5,40,0.125000
2025-09-07,HCA Healthcare,23,11,6,40,0.150000
2025-09-07,HEICO,17,20,3,40,0.075000
2025-09-07,HF Sinclair,20,16,4,40,0.100000
2025-09-07,Halliburton,11,18,11,40,0.275000
2025-09-07,Hanesbrands,11,26,3,40,0.075000
2025-09-07,Hanover Insurance Group,17,21,2,40,0.050000
2025-09-07,Harley-Davidson,13,20,7,40,0.175000
2025-09-07,Hasbro,12,19,9,40,0.225000
2025-09-07,Hawaiian Airlines inc,16,24,0,40,0.000000
2025-09-07,Hawaiian Electric Industries,19,18,3,40,0.075000
2025-09-07,Helmerich & Payne,11,25,4,40,0.100000
2025-09-07,Henry Schein,16,22,2,40,0.050000
2025-09-07,Herc Rentals,19,15,6,40,0.150000
2025-09-07,Hershey,14,22,4,40,0.100000
2025-09-07,Hertz,26,8,6,40,0.150000
2025-09-07,Hewlett Packard,13,26,1,40,0.025000
2025-09-07,Hewlett Packard Enterprise,17,23,0,40,0.000000
2025-09-07,Hillenbrand,12,26,2,40,0.050000
2025-09-07,Hilton Grand Vacations,37,2,1,40,0.025000
2025-09-07,Hilton Worldwide,18,21,1,40,0.025000
2025-09-07,Hologic,9,25,6,40,0.150000
2025-09-07,Home Depot,19,16,5,40,0.125000
2025-09-07,Honeywell,16,21,3,40,0.075000
2025-09-07,Hormel Foods,10,25,5,40,0.125000
2025-09-07,Host Hotels & Resorts,9,30,1,40,0.025000
2025-09-07,Hovnanian Enterprises,16,19,5,40,0.125000
2025-09-07,Howmet Aerospace,19,17,4,40,0.100000
2025-09-07,Hub Group,17,16,7,40,0.175000
2025-09-07,Hubbell,10,26,4,40,0.100000
2025-09-07,Humana,22,11,7,40,0.175000
2025-09-07,Huntington Bancshares,18,21,1,40,0.025000
2025-09-07,Huntington Ingalls Industries,21,15,4,40,0.100000
2025-09-07,Huntsman,7,24,9,40,0.225000
2025-09-07,Hyatt Hotels,24,16,0,40,0.000000
2025-09-07,Hyster-Yale,12,23,5,40,0.125000
2025-09-07,IAC,14,17,9,40,0.225000
2025-09-07,IBM,15,24,1,40,0.025000
2025-09-07,IDEX,20,14,6,40,0.150000
2025-09-07,IDEXX Laboratories,18,20,2,40,0.050000
2025-09-07,IQVIA,26,12,2,40,0.050000
2025-09-07,ITT,14,22,4,40,0.100000
2025-09-07,Icahn Enterprises,12,18,10,40,0.250000
2025-09-07,Illinois Tool Works,17,17,6,40,0.150000
2025-09-07,Illumina inc,12,25,3,40,0.075000
2025-09-07,Incyte,19,17,4,40,0.100000
2025-09-07,Ingersoll Rand,21,16,3,40,0.075000
2025-09-07,Ingles Markets,12,19,9,40,0.225000
2025-09-07,Ingram Micro,13,12,15,40,0.375000
2025-09-07,Ingredion,21,17,2,40,0.050000
2025-09-07,Insight Enterprises,10,25,5,40,0.125000
2025-09-07,Insperity,19,16,5,40,0.125000
2025-09-07,Instacart,18,16,6,40,0.150000
2025-09-07,Installed Building Products,17,19,4,40,0.100000
2025-09-07,Intel,17,15,8,40,0.200000
2025-09-07,Interactive Brokers,15,19,6,40,0.150000
2025-09-07,Intercontinental Exchange,11,27,2,40,0.050000
2025-09-07,International Flavors & Fragrances,16,19,5,40,0.125000
2025-09-07,International Paper,7,30,3,40,0.075000
2025-09-07,Interpublic Group,19,19,2,40,0.050000
2025-09-07,Intuit,18,20,2,40,0.050000
2025-09-07,Intuitive Surgical,11,20,9,40,0.225000
2025-09-07,Iron Mountain,10,25,5,40,0.125000
2025-09-07,JB Hunt Transport Services,6,28,6,40,0.150000
2025-09-07,JELD-WEN Holding,13,22,5,40,0.125000
2025-09-07,JM Smucker,17,15,8,40,0.200000
2025-09-07,JPMorgan Chase,12,23,5,40,0.125000
2025-09-07,Jabil,17,21,2,40,0.050000
2025-09-07,Jackson Financial,18,19,3,40,0.075000
2025-09-07,Jacobs Solutions,37,1,2,40,0.050000
2025-09-07,Jefferies Financial,12,21,7,40,0.175000
2025-09-07,JetBlue Airways,20,14,6,40,0.150000
2025-09-07,Johnson & Johnson,19,18,3,40,0.075000
2025-09-07,Jones Lang LaSalle,19,20,1,40,0.025000
2025-09-07,Juniper Networks,16,22,2,40,0.050000
2025-09-07,KB Home,17,17,6,40,0.150000
2025-09-07,KBR,27,12,1,40,0.025000
2025-09-07,KKR,12,26,2,40,0.050000
2025-09-07,KLA,19,16,5,40,0.125000
2025-09-07,Kaiser Aluminum,19,20,1,40,0.025000
2025-09-07,Kellanova,19,17,4,40,0.100000
2025-09-07,Kelly Services inc,21,15,4,40,0.100000
2025-09-07,Kemper,17,13,10,40,0.250000
2025-09-07,Keurig Dr Pepper,8,27,5,40,0.125000
2025-09-07,KeyCorp,13,20,7,40,0.175000
2025-09-07,Keysight Technologies,21,15,4,40,0.100000
2025-09-07,Kimberly-Clark,15,18,7,40,0.175000
2025-09-07,Kinder Morgan,40,0,0,40,0.000000
2025-09-07,Kirby Corporation,18,18,4,40,0.100000
2025-09-07,Knife River Corporation,15,20,5,40,0.125000
2025-09-07,Knight Swift Transportation,18,16,6,40,0.150000
2025-09-07,Kohls,14,18,8,40,0.200000
2025-09-07,Kontoor Brands,17,20,3,40,0.075000
2025-09-07,Korn Ferry,19,17,4,40,0.100000
2025-09-07,Kraft Heinz,10,24,6,40,0.150000
2025-09-07,Kroger,15,15,10,40,0.250000
2025-09-07,Kyndryl,14,23,3,40,0.075000
2025-09-07,L3Harris Technologies,21,15,4,40,0.100000
2025-09-07,LCI Industries,17,20,3,40,0.075000
2025-09-07,LKQ,13,27,0,40,0.000000
2025-09-07,LPL Financial,29,9,2,40,0.050000
2025-09-07,Labcorp Holdings,13,23,4,40,0.100000
2025-09-07,Lam Research,13,22,5,40,0.125000
2025-09-07,Lamb Weston,17,20,3,40,0.075000
2025-09-07,Land O'Lakes,14,24,2,40,0.050000
2025-09-07,Landstar System,12,19,9,40,0.225000
2025-09-07,Las Vegas Sands,13,23,4,40,0.100000
2025-09-07,Lear Corporation,23,15,2,40,0.050000
2025-09-07,Leggett & Platt,12,24,4,40,0.100000
2025-09-07,Leidos,21,16,3,40,0.075000
2025-09-07,Lennar,12,27,1,40,0.025000
2025-09-07,Lennox International,18,20,2,40,0.050000
2025-09-07,Levi Strauss,15,23,2,40,0.050000
2025-09-07,Liberty Energy,40,0,0,40,0.000000
2025-09-07,Liberty Media,40,0,0,40,0.000000
2025-09-07,Liberty Mutual Insurance,35,1,4,40,0.100000
2025-09-07,Light & Wonder,11,24,5,40,0.125000
2025-09-07,Lincoln Electric,9,29,2,40,0.050000
2025-09-07,Lincoln National,13,17,10,40,0.250000
2025-09-07,Lithia Motors,16,20,4,40,0.100000
2025-09-07,Live Nation Entertainment,32,6,2,40,0.050000
2025-09-07,Lockheed Martin,23,6,11,40,0.275000
2025-09-07,Loews,19,16,5,40,0.125000
2025-09-07,Louisiana-Pacific Corporation,23,13,4,40,0.100000
2025-09-07,Lowes,15,18,7,40,0.175000
2025-09-07,Lululemon athletica,10,15,15,40,0.375000
2025-09-07,Lumen Technologies,7,28,5,40,0.125000
2025-09-07,Lyft,15,21,4,40,0.100000
2025-09-07,M&T Bank,21,17,2,40,0.050000
2025-09-07,M/I Homes,12,23,5,40,0.125000
2025-09-07,MDU Resources Group,18,16,6,40,0.150000
2025-09-07,MGM Resorts International,11,28,1,40,0.025000
2025-09-07,MKS Instruments,18,21,1,40,0.025000
2025-09-07,MRC Global,16,24,0,40,0.000000
2025-09-07,MSC Industrial Direct,13,22,5,40,0.125000
2025-09-07,MSCI,12,26,2,40,0.050000
2025-09-07,MYR Group,20,17,3,40,0.075000
2025-09-07,Macys,21,14,5,40,0.125000
2025-09-07,ManpowerGroup,18,18,4,40,0.100000
2025-09-07,Marathon Oil,13,23,4,40,0.100000
2025-09-07,Marathon Petroleum,20,17,3,40,0.075000
2025-09-07,Markel Group,17,18,5,40,0.125000
2025-09-07,Marriott International,15,21,4,40,0.100000
2025-09-07,Marriott Vacations Worldwide,13,24,3,40,0.075000
2025-09-07,Marsh & McLennan,21,19,0,40,0.000000
2025-09-07,Martin Marietta Materials,22,13,5,40,0.125000
2025-09-07,Marvell Technology,12,19,9,40,0.225000
2025-09-07,MasTec,15,22,3,40,0.075000
2025-09-07,Masco,14,21,5,40,0.125000
2025-09-07,Mass Mutual,12,25,3,40,0.075000
2025-09-07,MasterBrand,11,27,2,40,0.050000
2025-09-07,Mastercard,16,20,4,40,0.100000
2025-09-07,Matador Resources,14,19,7,40,0.175000
2025-09-07,Match Group,12,16,12,40,0.300000
2025-09-07,Mativ,15,22,3,40,0.075000
2025-09-07,Matson inc,23,15,2,40,0.050000
2025-09-07,Mattel,12,20,8,40,0.200000
2025-09-07,Maximus,17,21,2,40,0.050000
2025-09-07,McCormick & Company,18,17,5,40,0.125000
2025-09-07,McDonalds,9,11,20,40,0.500000
2025-09-07,McKesson,17,20,3,40,0.075000
2025-09-07,Medical Mutual of Ohio,14,20,6,40,0.150000
2025-09-07,Merck,17,16,7,40,0.175000
2025-09-07,Mercury General,12,20,8,40,0.200000
2025-09-07,Meritage Homes,22,15,3,40,0.075000
2025-09-07,MetLife,12,18,10,40,0.250000
2025-09-07,Meta,13,23,4,40,0.100000
2025-09-07,Mettler-Toledo International,28,10,2,40,0.050000
2025-09-07,Microchip Technology,19,19,2,40,0.050000
2025-09-07,Micron Technology,18,17,5,40,0.125000
2025-09-07,Microsoft,10,14,16,40,0.400000
2025-09-07,Middleby,13,22,5,40,0.125000
2025-09-07,MillerKnoll,15,24,1,40,0.025000
2025-09-07,Moderna,13,15,12,40,0.300000
2025-09-07,ModivCare,12,16,12,40,0.300000
2025-09-07,Mohawk Industries,23,13,4,40,0.100000
2025-09-07,Molina Healthcare,9,15,16,40,0.400000
2025-09-07,Molson Coors Beverage,15,17,8,40,0.200000
2025-09-07,Mondelez,14,16,10,40,0.250000
2025-09-07,Monster Beverage,24,13,3,40,0.075000
2025-09-07,Moodys Corporation,3,11,2,16,0.125000
2025-09-07,Moog inc,22,17,1,40,0.025000
2025-09-07,Morgan Stanley,11,23,6,40,0.150000
2025-09-07,Mosaic,13,22,5,40,0.125000
2025-09-07,Motorola Solutions,37,2,1,40,0.025000
2025-09-07,Mueller Industries,21,17,2,40,0.050000
2025-09-07,Murphy Oil,18,20,2,40,0.050000
2025-09-07,Murphy USA,17,20,3,40,0.075000
2025-09-07,Mutual of Omaha,18,18,4,40,0.100000
2025-09-07,NCR Atleos,13,24,3,40,0.075000
2025-09-07,NCR Voyix,15,19,6,40,0.150000
2025-09-07,NGL Energy Partners,35,0,5,40,0.125000
2025-09-07,NLV Financial,5,3,2,10,0.200000
2025-09-07,NOV,6,33,1,40,0.025000
2025-09-07,NRG Energy,38,1,1,40,0.025000
2025-09-07,NVR,19,18,3,40,0.075000
2025-09-07,Nasdaq,12,20,8,40,0.200000
2025-09-07,Nationwide Insurance,9,19,12,40,0.300000
2025-09-07,Navient,21,11,8,40,0.200000
2025-09-07,NetApp,14,25,1,40,0.025000
2025-09-07,Netflix,19,12,9,40,0.225000
2025-09-07,NeueHealth,20,18,2,40,0.050000
2025-09-07,New York Life Insurance,16,22,2,40,0.050000
2025-09-07,NewMarket Corporation,17,20,3,40,0.075000
2025-09-07,Newell Brands,14,21,5,40,0.125000
2025-09-07,Newmont,17,18,5,40,0.125000
2025-09-07,News Corp,13,19,8,40,0.200000
2025-09-07,Nexstar Media Group,14,25,1,40,0.025000
2025-09-07,NextEra Energy,32,6,2,40,0.050000
2025-09-07,NiSource,16,12,12,40,0.300000
2025-09-07,Nike,12,24,4,40,0.100000
2025-09-07,Nordson,15,24,1,40,0.025000
2025-09-07,Nordstrom,19,21,0,40,0.000000
2025-09-07,Norfolk Southern,13,18,9,40,0.225000
2025-09-07,Northern Trust,37,2,1,40,0.025000
2025-09-07,Northrop Grumman,20,17,3,40,0.075000
2025-09-07,Northwestern Mutual,21,12,7,40,0.175000
2025-09-07,Nucor,14,23,3,40,0.075000
2025-09-07,Nvidia,12,21,7,40,0.175000
2025-09-07,O'Reilly Automotive,16,17,7,40,0.175000
2025-09-07,O-I Glass,13,24,3,40,0.075000
2025-09-07,ODP Business Solutions,20,19,1,40,0.025000
2025-09-07,OGE Energy,33,6,1,40,0.025000
2025-09-07,ON Semiconductor,11,16,13,40,0.325000
2025-09-07,Occidental Petroleum,12,22,6,40,0.150000
2025-09-07,Old Dominion Freight Line,21,13,6,40,0.150000
2025-09-07,Old National Bancorp,14,26,0,40,0.000000
2025-09-07,Old Republic International,21,16,3,40,0.075000
2025-09-07,Olin,12,17,11,40,0.275000
2025-09-07,Omnicom Group,15,18,7,40,0.175000
2025-09-07,OneMain,19,21,0,40,0.000000
2025-09-07,Oneok,22,16,2,40,0.050000
2025-09-07,Opendoor Technologies,8,21,11,40,0.275000
2025-09-07,Option Care Health,40,0,0,40,0.000000
2025-09-07,Oracle,5,25,10,40,0.250000
2025-09-07,Organon,16,16,8,40,0.200000
2025-09-07,Oscar Health,12,19,9,40,0.225000
2025-09-07,Oshkosh,9,17,14,40,0.350000
2025-09-07,Otis Worldwide,16,20,4,40,0.100000
2025-09-07,Ovintiv,16,16,8,40,0.200000
2025-09-07,Owens & Minor,8,25,7,40,0.175000
2025-09-07,Owens Corning,12,27,1,40,0.025000
2025-09-07,PACS Group,24,8,8,40,0.200000
2025-09-07,PBF Energy,34,3,3,40,0.075000
2025-09-07,PC Connection Inc,16,20,4,40,0.100000
2025-09-07,PENN Entertainment,37,3,0,40,0.000000
2025-09-07,PG&E,16,13,11,40,0.275000
2025-09-07,PNC Financial Services,20,17,3,40,0.075000
2025-09-07,PPG Industries,25,11,4,40,0.100000
2025-09-07,PPL,27,12,1,40,0.025000
2025-09-07,PVH,11,24,5,40,0.125000
2025-09-07,Paccar,18,18,4,40,0.100000
2025-09-07,Pacific Life,17,22,1,40,0.025000
2025-09-07,Packaging Corp of America,9,26,5,40,0.125000
2025-09-07,Palo Alto Networks,14,11,15,40,0.375000
2025-09-07,Par Pacific,22,16,2,40,0.050000
2025-09-07,Paramount Global,7,23,10,40,0.250000
2025-09-07,Park Hotels & Resorts,9,27,4,40,0.100000
2025-09-07,Parker-Hannifin,24,16,0,40,0.000000
2025-09-07,Parsons Corporation,25,11,4,40,0.100000
2025-09-07,Patrick Industries,14,24,2,40,0.050000
2025-09-07,Patterson Companies Inc,11,24,5,40,0.125000
2025-09-07,Patterson-UTI Energy,33,5,2,40,0.050000
2025-09-07,PayPal,13,16,11,40,0.275000
2025-09-07,Paychex,15,21,4,40,0.100000
2025-09-07,Peabody Energy,31,6,3,40,0.075000
2025-09-07,Peloton,20,17,3,40,0.075000
2025-09-07,Penn Mutual Life Insurance,20,17,3,40,0.075000
2025-09-07,PennyMac Financial Services,19,19,2,40,0.050000
2025-09-07,Penske Automotive,15,22,3,40,0.075000
2025-09-07,PepsiCo,14,21,5,40,0.125000
2025-09-07,Performance Food,10,23,7,40,0.175000
2025-09-07,Permian Resources,22,15,3,40,0.075000
2025-09-07,Petco Health and Wellness,35,3,2,40,0.050000
2025-09-07,Peter Kiewit Sons',7,20,13,40,0.325000
2025-09-07,Pfizer,20,11,9,40,0.225000
2025-09-07,Philip Morris,18,16,6,40,0.150000
2025-09-07,Phillips 66,19,12,9,40,0.225000
2025-09-07,Pinnacle West Capital,20,13,7,40,0.175000
2025-09-07,Pinterest,14,23,3,40,0.075000
2025-09-07,Pioneer Natural Resources,19,11,10,40,0.250000
2025-09-07,Pitney Bowes,21,14,5,40,0.125000
2025-09-07,Plains GP,16,11,13,40,0.325000
2025-09-07,Playtika Holding,17,18,5,40,0.125000
2025-09-07,Plexus,7,20,13,40,0.325000
2025-09-07,Polaris Inc,21,14,5,40,0.125000
2025-09-07,Pool Corporation,22,16,2,40,0.050000
2025-09-07,Popular inc,39,1,0,40,0.000000
2025-09-07,Portland General Electric,14,24,2,40,0.050000
2025-09-07,Post Holdings,9,29,2,40,0.050000
2025-09-07,PriceSmart,17,20,3,40,0.075000
2025-09-07,Primerica,21,16,3,40,0.075000
2025-09-07,Primoris Services,21,19,0,40,0.000000
2025-09-07,Principal Financial,15,22,3,40,0.075000
2025-09-07,ProFrac Holding,13,21,6,40,0.150000
2025-09-07,Procter & Gamble,22,15,3,40,0.075000
2025-09-07,Progressive Insurance,15,20,5,40,0.125000
2025-09-07,Prologis,21,17,2,40,0.050000
2025-09-07,Prudential Financial,17,20,3,40,0.075000
2025-09-07,Public Service Enterprise Group,18,19,3,40,0.075000
2025-09-07,Public Storage,17,15,8,40,0.200000
2025-09-07,Publix Super Markets,20,15,5,40,0.125000
2025-09-07,Puget Sound Energy,28,10,2,40,0.050000
2025-09-07,PulteGroup,19,16,5,40,0.125000
2025-09-07,Pure Storage,15,20,5,40,0.125000
2025-09-07,QVC,15,21,4,40,0.100000
2025-09-07,Qorvo,17,18,5,40,0.125000
2025-09-07,Quad/Graphics,19,18,3,40,0.075000
2025-09-07,Qualcomm,11,26,3,40,0.075000
2025-09-07,Quanta Services,15,21,4,40,0.100000
2025-09-07,Quest Diagnostics,11,28,1,40,0.025000
2025-09-07,QuidelOrtho,18,19,3,40,0.075000
2025-09-07,REV Group,16,20,4,40,0.100000
2025-09-07,RPM International,22,16,2,40,0.050000
2025-09-07,RTX,18,15,7,40,0.175000
2025-09-07,RXO inc,18,13,9,40,0.225000
2025-09-07,Radius Recycling,7,19,14,40,0.350000
2025-09-07,Ralph Lauren,17,20,3,40,0.075000
2025-09-07,Range Resources,23,14,3,40,0.075000
2025-09-07,Raymond James Financial,19,20,1,40,0.025000
2025-09-07,Realty Income,18,13,9,40,0.225000
2025-09-07,Regal Rexnord,16,22,2,40,0.050000
2025-09-07,Regeneron Pharmaceuticals,21,15,4,40,0.100000
2025-09-07,Regions Financial,18,19,3,40,0.075000
2025-09-07,Reinsurance Group of America,20,17,3,40,0.075000
2025-09-07,Reliance Inc,24,13,3,40,0.075000
2025-09-07,Republic Services,11,19,10,40,0.250000
2025-09-07,ResMed,16,22,2,40,0.050000
2025-09-07,Resideo Technologies,22,16,2,40,0.050000
2025-09-07,Restoration Hardware,10,26,4,40,0.100000
2025-09-07,Revvity,16,15,9,40,0.225000
2025-09-07,Rite Aid,8,27,5,40,0.125000
2025-09-07,Rithm Capital,17,22,1,40,0.025000
2025-09-07,Rivian Automotive,8,23,9,40,0.225000
2025-09-07,Robert Half,17,22,1,40,0.025000
2025-09-07,Roblox,16,14,10,40,0.250000
2025-09-07,Rocket Companies,15,24,1,40,0.025000
2025-09-07,Rockwell Automation,21,19,0,40,0.000000
2025-09-07,Roku,22,18,0,40,0.000000
2025-09-07,Rollins inc,12,26,2,40,0.050000
2025-09-07,Roper Technologies,22,17,1,40,0.025000
2025-09-07,Ross Stores,15,20,5,40,0.125000
2025-09-07,Rush Enterprises,20,19,1,40,0.025000
2025-09-07,Ryder System,19,18,3,40,0.075000
2025-09-07,Ryerson Holding,14,15,11,40,0.275000
2025-09-07,S&P Global,15,22,3,40,0.075000
2025-09-07,SBA Communications,26,10,4,40,0.100000
2025-09-07,SS&C Technologies,16,21,3,40,0.075000
2025-09-07,Sabre Corporation,13,20,7,40,0.175000
2025-09-07,Saia inc,16,19,5,40,0.125000
2025-09-07,Salesforce,10,14,16,40,0.400000
2025-09-07,Sallie Mae,14,23,3,40,0.075000
2025-09-07,Sally Beauty,39,0,1,40,0.025000
2025-09-07,Sanmina,13,26,1,40,0.025000
2025-09-07,ScanSource,17,19,4,40,0.100000
2025-09-07,Schneider National,13,23,4,40,0.100000
2025-09-07,Science Applications International,13,22,5,40,0.125000
2025-09-07,Scotts Miracle-Gro,13,21,6,40,0.150000
2025-09-07,Seaboard,14,15,11,40,0.275000
2025-09-07,Sealed Air Corporation,16,24,0,40,0.000000
2025-09-07,Securian Financial,12,24,4,40,0.100000
2025-09-07,Select Medical,15,20,5,40,0.125000
2025-09-07,Selective Insurance Group,21,9,10,40,0.250000
2025-09-07,Sempra,28,12,0,40,0.000000
2025-09-07,Sentry Insurance Group,3,7,0,10,0.000000
2025-09-07,Service Corp International,9,10,8,27,0.296296
2025-09-07,ServiceNow,13,21,6,40,0.150000
2025-09-07,Sherwin-Williams,10,21,9,40,0.225000
2025-09-07,Shift4 Payments,12,22,6,40,0.150000
2025-09-07,Silgan,5,28,7,40,0.175000
2025-09-07,Simon Property Group,15,21,4,40,0.100000
2025-09-07,Sinclair,11,21,8,40,0.200000
2025-09-07,SiteOne Landscape Supply,17,16,7,40,0.175000
2025-09-07,Skechers USA,13,24,3,40,0.075000
2025-09-07,SkyWest,10,17,13,40,0.325000
2025-09-07,Skyline Champion,33,4,3,40,0.075000
2025-09-07,Skyworks Solutions,31,5,4,40,0.100000
2025-09-07,Smurfit Westrock,9,26,5,40,0.125000
2025-09-07,Snap Inc,16,11,13,40,0.325000
2025-09-07,Snap-on,7,25,8,40,0.200000
2025-09-07,Snowflake inc,24,14,2,40,0.050000
2025-09-07,Sonic Automotive,12,26,2,40,0.050000
2025-09-07,Sonoco Products,23,13,4,40,0.100000
2025-09-07,Southern Company,21,18,1,40,0.025000
2025-09-07,Southwest Airlines,23,9,8,40,0.200000
2025-09-07,Southwest Gas,22,16,2,40,0.050000
2025-09-07,Southwestern Energy,34,4,2,40,0.050000
2025-09-07,SpartanNash,15,23,2,40,0.050000
2025-09-07,Spectrum Brands,15,19,6,40,0.150000
2025-09-07,Spire inc,19,18,3,40,0.075000
2025-09-07,Spirit AeroSystems,33,1,6,40,0.150000
2025-09-07,Spirit Airlines,20,4,16,40,0.400000
2025-09-07,Splunk,13,18,9,40,0.225000
2025-09-07,Sprouts Farmers Market,12,26,2,40,0.050000
2025-09-07,Stagwell,11,29,0,40,0.000000
2025-09-07,Stanley Black & Decker,11,22,7,40,0.175000
2025-09-07,Starbucks,11,24,5,40,0.125000
2025-09-07,State Farm Insurance,12,22,6,40,0.150000
2025-09-07,State Street,15,18,7,40,0.175000
2025-09-07,Steel Dynamics,36,4,0,40,0.000000
2025-09-07,Steelcase,15,23,2,40,0.050000
2025-09-07,Stericycle,11,9,20,40,0.500000
2025-09-07,Stifel Financial,20,18,2,40,0.050000
2025-09-07,StoneX,18,19,3,40,0.075000
2025-09-07,Stryker,11,21,8,40,0.200000
2025-09-07,Summit Materials,11,25,4,40,0.100000
2025-09-07,Sun Communities,22,15,3,40,0.075000
2025-09-07,Super Micro Computer,33,5,2,40,0.050000
2025-09-07,Surgery Partners,10,22,8,40,0.200000
2025-09-07,Sylvamo,14,17,9,40,0.225000
2025-09-07,Synchrony Financial,23,13,4,40,0.100000
2025-09-07,Synopsys,13,25,2,40,0.050000
2025-09-07,Synovus Financial,14,23,3,40,0.075000
2025-09-07,Sysco,19,18,3,40,0.075000
2025-09-07,T Rowe Price,20,20,0,40,0.000000
2025-09-07,TD Synnex,21,19,0,40,0.000000
2025-09-07,TEGNA,9,28,3,40,0.075000
2025-09-07,TIAA,13,24,3,40,0.075000
2025-09-07,TJX,20,16,4,40,0.100000
2025-09-07,Take-Two Interactive Software,16,21,3,40,0.075000
2025-09-07,Talen Energy,39,0,1,40,0.025000
2025-09-07,Tapestry,17,16,7,40,0.175000
2025-09-07,Targa Resources,20,13,7,40,0.175000
2025-09-07,Target,22,14,4,40,0.100000
2025-09-07,Taylor Morrison Home,15,23,2,40,0.050000
2025-09-07,Teladoc Health,16,18,6,40,0.150000
2025-09-07,Teledyne Technologies,16,22,2,40,0.050000
2025-09-07,Teleflex,12,25,3,40,0.075000
2025-09-07,Telephone & Data Systems,13,20,7,40,0.175000
2025-09-07,TelevisaUnivision,16,20,4,40,0.100000
2025-09-07,Tempur Sealy International,10,24,6,40,0.150000
2025-09-07,Tenet Healthcare,16,16,8,40,0.200000
2025-09-07,Teradyne,12,26,2,40,0.050000
2025-09-07,Terex,13,22,5,40,0.125000
2025-09-07,Tesla,10,15,15,40,0.375000
2025-09-07,Tetra Tech,18,18,4,40,0.100000
2025-09-07,Texas Instruments,7,17,16,40,0.400000
2025-09-07,Texas Roadhouse,11,21,8,40,0.200000
2025-09-07,Textron,15,21,4,40,0.100000
2025-09-07,The Andersons Inc,11,27,2,40,0.050000
2025-09-07,The Coca-Cola Company,12,27,1,40,0.025000
2025-09-07,The Hartford,14,16,10,40,0.250000
2025-09-07,Thermo Fisher Scientific,21,16,3,40,0.075000
2025-09-07,Thor Industries,12,19,9,40,0.225000
2025-09-07,Thrivent Financial for Lutherans,13,22,5,40,0.125000
2025-09-07,Timken,12,23,5,40,0.125000
2025-09-07,Titan Machinery,13,23,4,40,0.100000
2025-09-07,Toast inc,22,17,1,40,0.025000
2025-09-07,Toll Brothers,8,25,7,40,0.175000
2025-09-07,TopBuild,13,24,3,40,0.075000
2025-09-07,Topgolf Callaway Brands,10,20,10,40,0.250000
2025-09-07,Toro Company,17,22,1,40,0.025000
2025-09-07,Tractor Supply,20,17,3,40,0.075000
2025-09-07,TransDigm,18,17,5,40,0.125000
2025-09-07,TransUnion,16,10,14,40,0.350000
2025-09-07,Travelers Insurance,11,19,10,40,0.250000
2025-09-07,TreeHouse Foods,12,19,9,40,0.225000
2025-09-07,Tri Pointe Homes,13,25,2,40,0.050000
2025-09-07,TriNet Group,21,16,3,40,0.075000
2025-09-07,Trimble,9,20,11,40,0.275000
2025-09-07,Trinity Industries,20,15,5,40,0.125000
2025-09-07,TruStage,26,13,1,40,0.025000
2025-09-07,Truist Financial,14,23,3,40,0.075000
2025-09-07,Tutor Perini Corporation,21,15,4,40,0.100000
2025-09-07,Twilio,18,17,5,40,0.125000
2025-09-07,Tyson Foods,11,20,9,40,0.225000
2025-09-07,U-Haul,2,6,32,40,0.800000
2025-09-07,UFP Industries,12,25,3,40,0.075000
2025-09-07,UGI Utilities Inc,19,15,6,40,0.150000
2025-09-07,UL Solutions,37,1,2,40,0.050000
2025-09-07,UPS,12,13,15,40,0.375000
2025-09-07,US Bancorp,14,23,3,40,0.075000
2025-09-07,US Foods,17,21,2,40,0.050000
2025-09-07,USAA,16,15,9,40,0.225000
2025-09-07,Uber,11,16,13,40,0.325000
2025-09-07,Ulta Beauty,35,3,2,40,0.050000
2025-09-07,Under Armour,12,25,3,40,0.075000
2025-09-07,Union Pacific,18,17,5,40,0.125000
2025-09-07,United Airlines,37,1,2,40,0.050000
2025-09-07,United Natural Foods,40,0,0,40,0.000000
2025-09-07,United Rentals,39,1,0,40,0.000000
2025-09-07,United States Steel,24,9,7,40,0.175000
2025-09-07,UnitedHealth,11,22,7,40,0.175000
2025-09-07,Universal Corporation,17,22,1,40,0.025000
2025-09-07,Universal Health Services,16,15,9,40,0.225000
2025-09-07,Unum Group,14,20,6,40,0.150000
2025-09-07,Upbound Group,28,11,1,40,0.025000
2025-09-07,Urban Outfitters,11,24,5,40,0.125000
2025-09-07,V2X,20,19,1,40,0.025000
2025-09-07,VF Corporation,15,21,4,40,0.100000
2025-09-07,VICI Properties,21,17,2,40,0.050000
2025-09-07,Vail Resorts,17,10,13,40,0.325000
2025-09-07,Valero Energy,37,2,1,40,0.025000
2025-09-07,Valley National Bancorp,13,21,6,40,0.150000
2025-09-07,Valmont Industries,29,8,3,40,0.075000
2025-09-07,Valvoline inc,14,22,4,40,0.100000
2025-09-07,Ventas inc,21,18,1,40,0.025000
2025-09-07,Verisk Analytics,16,15,9,40,0.225000
2025-09-07,Verizon,17,19,4,40,0.100000
2025-09-07,Vertex Pharmaceuticals,15,18,7,40,0.175000
2025-09-07,Vertiv,15,24,1,40,0.025000
2025-09-07,Viasat,25,14,1,40,0.025000
2025-09-07,Viatris,10,22,8,40,0.200000
2025-09-07,Victorias Secret,14,16,10,40,0.250000
2025-09-07,Visa,7,20,13,40,0.325000
2025-09-07,Vishay Intertechnology,14,18,8,40,0.200000
2025-09-07,Vista Outdoor,15,21,4,40,0.100000
2025-09-07,Visteon,20,19,1,40,0.025000
2025-09-07,Vistra,24,11,5,40,0.125000
2025-09-07,Vontier,18,20,2,40,0.050000
2025-09-07,Voya Financial,14,23,3,40,0.075000
2025-09-07,Vulcan Materials,12,20,8,40,0.200000
2025-09-07,WEC Energy,34,2,4,40,0.100000
2025-09-07,WESCO International,19,19,2,40,0.050000
2025-09-07,WEX,14,21,5,40,0.125000
2025-09-07,WR Berkley,12,21,7,40,0.175000
2025-09-07,WW Grainger,19,14,7,40,0.175000
2025-09-07,Wabash National,14,15,11,40,0.275000
2025-09-07,Walgreens,4,25,11,40,0.275000
2025-09-07,Walmart,9,19,12,40,0.300000
2025-09-07,Walt Disney,13,19,8,40,0.200000
2025-09-07,Warner Bros Discovery,8,20,12,40,0.300000
2025-09-07,Warner Music Group,12,26,2,40,0.050000
2025-09-07,Waters Corporation,19,18,3,40,0.075000
2025-09-07,Watsco,14,18,8,40,0.200000
2025-09-07,Wayfair,19,16,5,40,0.125000
2025-09-07,Webster Financial,11,24,5,40,0.125000
2025-09-07,Weis Markets,12,21,7,40,0.175000
2025-09-07,Wells Fargo,36,1,3,40,0.075000
2025-09-07,Welltower,29,10,1,40,0.025000
2025-09-07,Werner Enterprises,18,15,7,40,0.175000
2025-09-07,West Pharmaceutical Services,13,20,7,40,0.175000
2025-09-07,Western & Southern Financial,14,21,5,40,0.125000
2025-09-07,Western Alliance Bancorp,16,15,9,40,0.225000
2025-09-07,Western Digital,19,19,2,40,0.050000
2025-09-07,Western Midstream Partners,21,18,1,40,0.025000
2025-09-07,Western Union,14,22,4,40,0.100000
2025-09-07,Westinghouse Air Brake Technologies,18,16,6,40,0.150000
2025-09-07,Westlake Corporation,14,21,5,40,0.125000
2025-09-07,Weyerhaeuser,7,27,6,40,0.150000
2025-09-07,Whirlpool,12,20,8,40,0.200000
2025-09-07,Williams,21,16,3,40,0.075000
2025-09-07,Williams-Sonoma,19,16,5,40,0.125000
2025-09-07,Winnebago Industries,12,23,5,40,0.125000
2025-09-07,Wintrust Financial,20,16,4,40,0.100000
2025-09-07,Woodward inc,14,25,1,40,0.025000
2025-09-07,Workday,13,18,9,40,0.225000
2025-09-07,World Kinect,22,14,4,40,0.100000
2025-09-07,Worthington Enterprises,15,25,0,40,0.000000
2025-09-07,Wynn Resorts,15,17,8,40,0.200000
2025-09-07,XPO,13,20,7,40,0.175000
2025-09-07,Xcel Energy,34,6,0,40,0.000000
2025-09-07,Xerox,14,22,4,40,0.100000
2025-09-07,Xylem Inc,25,14,1,40,0.025000
2025-09-07,Yum Brands,9,27,4,40,0.100000
2025-09-07,Yum China,17,20,3,40,0.075000
2025-09-07,Zebra Technologies,16,20,4,40,0.100000
2025-09-07,Zimmer Biomet,16,20,4,40,0.100000
2025-09-07,Zions Bancorp,18,16,6,40,0.150000
2025-09-07,Zoetis,24,12,4,40,0.100000
2025-09-07,Zoom Video Communications,12,22,6,40,0.150000
2025-09-07,eXp World,18,19,3,40,0.075000
2025-09-07,iHeartMedia,13,26,1,40,0.025000
2025-09-09,3M,18,20,2,40,0.050000
2025-09-09,A O Smith,15,23,2,40,0.050000
2025-09-09,A-Mark Precious Metals,39,1,0,40,0.000000
2025-09-09,ABM Industries,9,22,9,40,0.225000
2025-09-09,ADT,16,16,8,40,0.200000
2025-09-09,AECOM,23,14,3,40,0.075000
2025-09-09,AES,17,14,9,40,0.225000
2025-09-09,AGCO,22,14,4,40,0.100000
2025-09-09,AGNC Investment,17,18,5,40,0.125000
2025-09-09,AMC Entertainment,35,4,1,40,0.025000
2025-09-09,AMC Networks,14,14,12,40,0.300000
2025-09-09,AMN Healthcare Services,14,20,6,40,0.150000
2025-09-09,APA,18,17,5,40,0.125000
2025-09-09,APi Group,14,23,3,40,0.075000
2025-09-09,ARKO,9,28,3,40,0.075000
2025-09-09,ASGN,10,20,10,40,0.250000
2025-09-09,AT&T,17,21,2,40,0.050000
2025-09-09,ATI inc,20,18,2,40,0.050000
2025-09-09,AbbVie,16,21,3,40,0.075000
2025-09-09,Abbott Laboratories,18,16,6,40,0.150000
2025-09-09,Abercrombie & Fitch,13,26,1,40,0.025000
2025-09-09,Academy Sports and Outdoors,15,22,3,40,0.075000
2025-09-09,Acadia Healthcare,12,19,9,40,0.225000
2025-09-09,Acuity Inc,23,17,0,40,0.000000
2025-09-09,Adams Resources & Energy,16,6,0,22,0.000000
2025-09-09,AdaptHealth,15,19,6,40,0.150000
2025-09-09,Adobe,12,21,7,40,0.175000
2025-09-09,Advance Auto Parts,10,19,11,40,0.275000
2025-09-09,Advanced Drainage Systems,32,7,1,40,0.025000
2025-09-09,Advanced Micro Devices,30,3,7,40,0.175000
2025-09-09,Advantage Solutions,37,0,3,40,0.075000
2025-09-09,Aflac,9,15,16,40,0.400000
2025-09-09,Agilent Technologies,22,18,0,40,0.000000
2025-09-09,Agilon Health,16,17,7,40,0.175000
2025-09-09,Air Lease,13,26,1,40,0.025000
2025-09-09,Air Products & Chemicals,16,18,6,40,0.150000
2025-09-09,Airbnb,12,22,6,40,0.150000
2025-09-09,Akamai Technologies,18,19,3,40,0.075000
2025-09-09,Alaska Air,14,18,8,40,0.200000
2025-09-09,Albemarle Corporation,14,25,1,40,0.025000
2025-09-09,Albertsons,19,19,2,40,0.050000
2025-09-09,Alcoa Corporation,10,24,6,40,0.150000
2025-09-09,Alexandria Real Estate Equities,17,21,2,40,0.050000
2025-09-09,Alight Solutions,13,22,5,40,0.125000
2025-09-09,Align Technology,9,20,11,40,0.275000
2025-09-09,Allegiant Travel Company,14,23,3,40,0.075000
2025-09-09,Alliance Resource Partners,12,17,11,40,0.275000
2025-09-09,Alliant Energy,30,5,5,40,0.125000
2025-09-09,Allison Transmission,13,22,5,40,0.125000
2025-09-09,Allstate,25,11,4,40,0.100000
2025-09-09,Ally Financial,14,26,0,40,0.000000
2025-09-09,Alpha Metallurgical Resources,17,17,6,40,0.150000
2025-09-09,Alphabet,19,14,7,40,0.175000
2025-09-09,Altice,15,20,5,40,0.125000
2025-09-09,Altria Group,16,18,6,40,0.150000
2025-09-09,Amazon,32,1,7,40,0.175000
2025-09-09,Ameren,18,17,5,40,0.125000
2025-09-09,American Airlines,10,19,11,40,0.275000
2025-09-09,American Axle & Manufacturing,13,25,2,40,0.050000
2025-09-09,American Eagle Outfitters,19,17,4,40,0.100000
2025-09-09,American Electric Power,15,21,4,40,0.100000
2025-09-09,American Express,21,16,3,40,0.075000
2025-09-09,American Family Insurance,21,15,4,40,0.100000
2025-09-09,American Financial,17,17,6,40,0.150000
2025-09-09,American International Group,17,22,1,40,0.025000
2025-09-09,American Tower,23,15,2,40,0.050000
2025-09-09,American Water Works,12,25,3,40,0.075000
2025-09-09,Americold Realty Trust,33,3,4,40,0.100000
2025-09-09,Ameriprise Financial,22,14,4,40,0.100000
2025-09-09,Ametek,24,14,2,40,0.050000
2025-09-09,Amgen,17,20,3,40,0.075000
2025-09-09,Amica Mutual Insurance,14,24,2,40,0.050000
2025-09-09,Amkor Technology,13,25,2,40,0.050000
2025-09-09,Amphenol,17,20,3,40,0.075000
2025-09-09,Analog Devices,16,22,2,40,0.050000
2025-09-09,Antero Resources,16,22,2,40,0.050000
2025-09-09,Anywhere Real Estate Inc,16,21,3,40,0.075000
2025-09-09,Apollo Global Management,15,24,1,40,0.025000
2025-09-09,AppLovin,14,23,3,40,0.075000
2025-09-09,Apple,7,29,4,40,0.100000
2025-09-09,Applied Industrial Technologies,12,28,0,40,0.000000
2025-09-09,Applied Materials,6,19,15,40,0.375000
2025-09-09,AptarGroup,17,22,1,40,0.025000
2025-09-09,Aramark,20,18,2,40,0.050000
2025-09-09,ArcBest,11,25,4,40,0.100000
2025-09-09,Arch Resources,30,6,4,40,0.100000
2025-09-09,Archer Daniels Midland,22,15,3,40,0.075000
2025-09-09,Ares Management,20,18,2,40,0.050000
2025-09-09,Arista Networks,20,20,0,40,0.000000
2025-09-09,Arrow Electronics,20,17,3,40,0.075000
2025-09-09,Arthur J Gallagher,6,31,3,40,0.075000
2025-09-09,Asbury Automotive Group,8,28,4,40,0.100000
2025-09-09,Assurant,24,13,3,40,0.075000
2025-09-09,Atkore,20,17,3,40,0.075000
2025-09-09,Atlassian,9,22,9,40,0.225000
2025-09-09,Atmos Energy,38,1,1,40,0.025000
2025-09-09,Auto-Owners Insurance,16,19,5,40,0.125000
2025-09-09,AutoNation,14,19,7,40,0.175000
2025-09-09,AutoZone,10,21,9,40,0.225000
2025-09-09,Autodesk,19,19,2,40,0.050000
2025-09-09,Autoliv,26,13,1,40,0.025000
2025-09-09,Automatic Data Processing,21,17,2,40,0.050000
2025-09-09,AvalonBay Communities,19,18,3,40,0.075000
2025-09-09,Avantor,13,22,5,40,0.125000
2025-09-09,Avery Dennison,10,28,2,40,0.050000
2025-09-09,Avient,12,24,4,40,0.100000
2025-09-09,Avis Budget,10,23,7,40,0.175000
2025-09-09,Avnet,14,22,4,40,0.100000
2025-09-09,BJs Wholesale Club,11,23,6,40,0.150000
2025-09-09,BOK Financial,25,11,4,40,0.100000
2025-09-09,BWX Technologies,25,15,0,40,0.000000
2025-09-09,Baker Hughes,8,27,5,40,0.125000
2025-09-09,Ball,15,18,7,40,0.175000
2025-09-09,Bank of America,19,15,6,40,0.150000
2025-09-09,Bank of New York Mellon,21,13,6,40,0.150000
2025-09-09,Bath & Body Works,11,15,14,40,0.350000
2025-09-09,Baxter International,10,22,8,40,0.200000
2025-09-09,Beacon Roofing Supply,9,22,9,40,0.225000
2025-09-09,Becton Dickinson,18,18,4,40,0.100000
2025-09-09,Belden,9,25,6,40,0.150000
2025-09-09,Benchmark Electronics,18,18,4,40,0.100000
2025-09-09,Berkshire Hathaway,12,18,10,40,0.250000
2025-09-09,Best Buy,28,2,10,40,0.250000
2025-09-09,Big Lots,6,33,1,40,0.025000
2025-09-09,Bio-Rad Laboratories,14,21,5,40,0.125000
2025-09-09,Biogen,18,21,1,40,0.025000
2025-09-09,BlackRock,18,16,6,40,0.150000
2025-09-09,Blackstone,10,26,4,40,0.100000
2025-09-09,Bloomin Brands,6,26,8,40,0.200000
2025-09-09,BlueLinx,15,20,5,40,0.125000
2025-09-09,Boeing,12,22,6,40,0.150000
2025-09-09,Boise Cascade,12,15,13,40,0.325000
2025-09-09,Booking Holdings,14,21,5,40,0.125000
2025-09-09,Booz Allen Hamilton,20,16,4,40,0.100000
2025-09-09,BorgWarner,24,16,0,40,0.000000
2025-09-09,Boston Properties,10,23,7,40,0.175000
2025-09-09,Boston Scientific,10,26,4,40,0.100000
2025-09-09,Boyd Gaming,12,27,1,40,0.025000
2025-09-09,Bread Financial,24,13,3,40,0.075000
2025-09-09,BrightSpring Health Services,14,22,4,40,0.100000
2025-09-09,BrightView Holdings,21,17,2,40,0.050000
2025-09-09,Brighthouse Financial,13,24,3,40,0.075000
2025-09-09,Brinker International,21,18,1,40,0.025000
2025-09-09,Brinks Company,7,3,5,15,0.333333
2025-09-09,Bristol-Myers Squibb,10,22,8,40,0.200000
2025-09-09,Broadcom,15,19,6,40,0.150000
2025-09-09,Broadridge Financial Solutions,29,10,1,40,0.025000
2025-09-09,Brookdale Senior Living,14,15,11,40,0.275000
2025-09-09,Brown & Brown,15,20,5,40,0.125000
2025-09-09,Brown-Forman,10,23,7,40,0.175000
2025-09-09,Bruker,12,18,10,40,0.250000
2025-09-09,Brunswick,6,18,16,40,0.400000
2025-09-09,Builders FirstSource,23,15,2,40,0.050000
2025-09-09,Burlington Stores,14,23,3,40,0.075000
2025-09-09,CACI International,22,16,2,40,0.050000
2025-09-09,CBRE Group,20,20,0,40,0.000000
2025-09-09,CDW,17,20,3,40,0.075000
2025-09-09,CF Industries,18,20,2,40,0.050000
2025-09-09,CH Robinson Worldwide,16,16,8,40,0.200000
2025-09-09,CHS,16,19,5,40,0.125000
2025-09-09,CME Group,21,18,1,40,0.025000
2025-09-09,CMS Energy,38,2,0,40,0.000000
2025-09-09,CNO Financial Group,17,21,2,40,0.050000
2025-09-09,CNX Resources,18,20,2,40,0.050000
2025-09-09,CSX,13,18,9,40,0.225000
2025-09-09,CVS Health,12,18,10,40,0.250000
2025-09-09,Cabot Corporation,14,25,1,40,0.025000
2025-09-09,Cadence,12,25,3,40,0.075000
2025-09-09,Caesars Entertainment,34,6,0,40,0.000000
2025-09-09,Cal-Maine Foods,22,15,3,40,0.075000
2025-09-09,Caleres inc,18,18,4,40,0.100000
2025-09-09,California Resources,20,17,3,40,0.075000
2025-09-09,Calumet,9,19,12,40,0.300000
2025-09-09,Campbell Soup,17,20,3,40,0.075000
2025-09-09,Camping World,11,23,6,40,0.150000
2025-09-09,Capital One,21,16,3,40,0.075000
2025-09-09,CarMax,10,27,3,40,0.075000
2025-09-09,Cardinal Health,20,14,6,40,0.150000
2025-09-09,Carlisle Companies,18,17,5,40,0.125000
2025-09-09,Carlyle Group,7,32,1,40,0.025000
2025-09-09,Carpenter Technology,17,21,2,40,0.050000
2025-09-09,Carrier Global,15,22,3,40,0.075000
2025-09-09,Carters inc,10,22,2,34,0.058824
2025-09-09,Carvana,21,16,3,40,0.075000
2025-09-09,Caseys General Stores,14,21,5,40,0.125000
2025-09-09,Catalent,9,26,5,40,0.125000
2025-09-09,Caterpillar,14,18,8,40,0.200000
2025-09-09,Cboe Global Markets,11,27,2,40,0.050000
2025-09-09,Celanese,6,17,17,40,0.425000
2025-09-09,Cencora,17,20,3,40,0.075000
2025-09-09,Centene,18,10,12,40,0.300000
2025-09-09,CenterPoint Energy,29,5,6,40,0.150000
2025-09-09,Central Garden & Pet,1,39,0,40,0.000000
2025-09-09,Century Communities,13,22,5,40,0.125000
2025-09-09,ChampionX,23,17,0,40,0.000000
2025-09-09,Charles River Laboratories International,10,22,8,40,0.200000
2025-09-09,Charles Schwab,15,20,5,40,0.125000
2025-09-09,Chart Industries,13,24,3,40,0.075000
2025-09-09,Charter Communications,13,22,5,40,0.125000
2025-09-09,Cheesecake Factory,13,19,8,40,0.200000
2025-09-09,Chefs Warehouse,19,17,4,40,0.100000
2025-09-09,Chemours,21,10,9,40,0.225000
2025-09-09,Cheniere Energy,38,2,0,40,0.000000
2025-09-09,Chevron,19,15,6,40,0.150000
2025-09-09,Chewy,16,17,7,40,0.175000
2025-09-09,Chipotle Mexican Grill,15,21,4,40,0.100000
2025-09-09,Chord Energy,35,2,3,40,0.075000
2025-09-09,Church & Dwight,20,19,1,40,0.025000
2025-09-09,Ciena,15,22,3,40,0.075000
2025-09-09,Cigna,19,18,3,40,0.075000
2025-09-09,Cincinnati Financial,14,21,5,40,0.125000
2025-09-09,Cinemark,8,21,11,40,0.275000
2025-09-09,Cintas,19,18,3,40,0.075000
2025-09-09,Cisco Systems,14,23,3,40,0.075000
2025-09-09,Citigroup,16,22,2,40,0.050000
2025-09-09,Citizens Financial Group,10,27,3,40,0.075000
2025-09-09,Civitas Resources,15,14,11,40,0.275000
2025-09-09,Clean Harbors,30,3,7,40,0.175000
2025-09-09,Clear Channel Outdoor Hldgs,11,0,1,12,0.083333
2025-09-09,Cleveland-Cliffs,11,15,14,40,0.350000
2025-09-09,Clorox,14,18,8,40,0.200000
2025-09-09,Cognizant Technology Solutions,33,5,2,40,0.050000
2025-09-09,Coherent,21,17,2,40,0.050000
2025-09-09,Coinbase Global,16,21,3,40,0.075000
2025-09-09,Colgate-Palmolive,14,16,10,40,0.250000
2025-09-09,Columbia Banking System,14,25,1,40,0.025000
2025-09-09,Columbia Sportswear,9,17,14,40,0.350000
2025-09-09,Comcast,20,15,5,40,0.125000
2025-09-09,Comerica,23,13,4,40,0.100000
2025-09-09,Comfort Systems USA,39,0,1,40,0.025000
2025-09-09,CommScope,12,28,0,40,0.000000
2025-09-09,Commercial Metals,11,20,9,40,0.225000
2025-09-09,Community Health Systems,17,16,7,40,0.175000
2025-09-09,Compass,14,22,4,40,0.100000
2025-09-09,Conagra Brands,15,25,0,40,0.000000
2025-09-09,Concentrix,19,15,6,40,0.150000
2025-09-09,Conduent,15,17,8,40,0.200000
2025-09-09,ConocoPhillips,11,20,9,40,0.225000
2025-09-09,Consol Energy,32,6,2,40,0.050000
2025-09-09,Consolidated Edison,11,22,7,40,0.175000
2025-09-09,Constellation Brands,7,17,16,40,0.400000
2025-09-09,Constellation Energy,29,6,5,40,0.125000
2025-09-09,Continental Resources,19,12,9,40,0.225000
2025-09-09,Cooper Cos,8,28,4,40,0.100000
2025-09-09,Cooper-Standard,13,27,0,40,0.000000
2025-09-09,Copart,17,18,5,40,0.125000
2025-09-09,Core & Main,7,25,8,40,0.200000
2025-09-09,Cornerstone Building Brands,15,20,5,40,0.125000
2025-09-09,Corning,8,26,6,40,0.150000
2025-09-09,Corpay,16,24,0,40,0.000000
2025-09-09,Corteva,14,22,4,40,0.100000
2025-09-09,Costco,17,16,7,40,0.175000
2025-09-09,Coterra Energy,34,3,3,40,0.075000
2025-09-09,Coty,11,17,12,40,0.300000
2025-09-09,Country Financial,16,21,3,40,0.075000
2025-09-09,Coupang,12,25,3,40,0.075000
2025-09-09,Cracker Barrel Old Country Store,5,30,5,40,0.125000
2025-09-09,Crocs,12,27,1,40,0.025000
2025-09-09,CrossAmerica Partners,14,22,4,40,0.100000
2025-09-09,CrowdStrike,17,7,16,40,0.400000
2025-09-09,Crown Castle,15,25,0,40,0.000000
2025-09-09,Crown Holdings,19,18,3,40,0.075000
2025-09-09,Cullen Frost Bankers,17,18,5,40,0.125000
2025-09-09,Cummins,11,22,7,40,0.175000
2025-09-09,Curtiss-Wright,19,17,4,40,0.100000
2025-09-09,DR Horton,13,20,7,40,0.175000
2025-09-09,DTE Energy,31,3,6,40,0.150000
2025-09-09,DXC Technology,25,14,1,40,0.025000
2025-09-09,DaVita,15,13,12,40,0.300000
2025-09-09,Dana Incorporated,19,15,6,40,0.150000
2025-09-09,Danaher,14,24,2,40,0.050000
2025-09-09,Darden Restaurants,25,14,1,40,0.025000
2025-09-09,Darling Ingredients,40,0,0,40,0.000000
2025-09-09,Deckers Outdoor,22,17,1,40,0.025000
2025-09-09,Deere,9,19,12,40,0.300000
2025-09-09,Delek US,25,14,1,40,0.025000
2025-09-09,Dell Technologies,14,14,12,40,0.300000
2025-09-09,Delta Air Lines,5,22,13,40,0.325000
2025-09-09,Dentsply Sirona,9,28,3,40,0.075000
2025-09-09,Designer Brands,9,27,4,40,0.100000
2025-09-09,Devon Energy,38,0,2,40,0.050000
2025-09-09,DexCom,10,24,6,40,0.150000
2025-09-09,Diamondback Energy,34,3,3,40,0.075000
2025-09-09,Dicks Sporting Goods,9,28,3,40,0.075000
2025-09-09,Diebold Nixdorf,16,24,0,40,0.000000
2025-09-09,Digital Realty Trust,34,6,0,40,0.000000
2025-09-09,Dillards,14,18,8,40,0.200000
2025-09-09,DocuSign,20,16,4,40,0.100000
2025-09-09,Dollar General,9,18,13,40,0.325000
2025-09-09,Dollar Tree,18,18,4,40,0.100000
2025-09-09,Dominion Energy,29,5,6,40,0.150000
2025-09-09,Dominos Pizza inc,14,20,6,40,0.150000
2025-09-09,Domtar,10,23,7,40,0.175000
2025-09-09,Donaldson Company,26,13,1,40,0.025000
2025-09-09,DoorDash,24,12,4,40,0.100000
2025-09-09,Dover Corporation,25,14,1,40,0.025000
2025-09-09,DraftKings,30,9,1,40,0.025000
2025-09-09,Dream Finders Homes,36,1,3,40,0.075000
2025-09-09,Dropbox,20,18,2,40,0.050000
2025-09-09,DuPont,12,19,9,40,0.225000
2025-09-09,Duke Energy,37,2,1,40,0.025000
2025-09-09,Dycom Industries,19,16,5,40,0.125000
2025-09-09,EMCOR Group,13,26,1,40,0.025000
2025-09-09,EOG Resources,14,24,2,40,0.050000
2025-09-09,EPAM Systems,19,19,2,40,0.050000
2025-09-09,EQT,16,21,3,40,0.075000
2025-09-09,ESAB,14,24,2,40,0.050000
2025-09-09,East West Bancorp,21,19,0,40,0.000000
2025-09-09,Eastman Chemical,7,19,14,40,0.350000
2025-09-09,Ebay,15,19,6,40,0.150000
2025-09-09,EchoStar,14,20,6,40,0.150000
2025-09-09,Ecolab,18,19,3,40,0.075000
2025-09-09,Edison International,10,23,7,40,0.175000
2025-09-09,Edward Jones,13,23,4,40,0.100000
2025-09-09,Edwards Lifesciences,21,11,8,40,0.200000
2025-09-09,Elanco Animal Health,13,24,3,40,0.075000
2025-09-09,Electronic Arts,14,20,6,40,0.150000
2025-09-09,Elevance Health,14,12,14,40,0.350000
2025-09-09,Eli Lilly,17,19,4,40,0.100000
2025-09-09,Emerson Electric,20,20,0,40,0.000000
2025-09-09,EnLink Midstream,15,20,5,40,0.125000
2025-09-09,Encompass Health,14,23,3,40,0.075000
2025-09-09,Endeavor Group,12,24,4,40,0.100000
2025-09-09,EnerSys,20,18,2,40,0.050000
2025-09-09,Energizer,36,3,1,40,0.025000
2025-09-09,Energy Transfer,32,0,8,40,0.200000
2025-09-09,Ensign Group,22,16,2,40,0.050000
2025-09-09,Entegris,18,21,1,40,0.025000
2025-09-09,Entergy,21,17,2,40,0.050000
2025-09-09,Enterprise Products Partners,23,11,6,40,0.150000
2025-09-09,Envista,15,23,2,40,0.050000
2025-09-09,Equifax,22,15,3,40,0.075000
2025-09-09,Equinix,20,19,1,40,0.025000
2025-09-09,Equitable,23,14,3,40,0.075000
2025-09-09,Equity Residential,12,23,5,40,0.125000
2025-09-09,Erie Insurance,17,13,10,40,0.250000
2025-09-09,Estée Lauder,12,18,10,40,0.250000
2025-09-09,Etsy,11,17,12,40,0.300000
2025-09-09,Euronet Worldwide,19,19,2,40,0.050000
2025-09-09,Evergy,22,13,5,40,0.125000
2025-09-09,Eversource Energy,30,5,5,40,0.125000
2025-09-09,Exact Sciences,9,18,13,40,0.325000
2025-09-09,Exelon,22,16,2,40,0.050000
2025-09-09,Expand Energy,39,1,0,40,0.000000
2025-09-09,Expedia,20,20,0,40,0.000000
2025-09-09,Expeditors International of Washington,12,27,1,40,0.025000
2025-09-09,Extra Space Storage,16,20,4,40,0.100000
2025-09-09,Exxon Mobil,24,14,2,40,0.050000
2025-09-09,F5,9,25,6,40,0.150000
2025-09-09,FM Global,18,14,8,40,0.200000
2025-09-09,FMC Corporation,15,21,4,40,0.100000
2025-09-09,FTI Consulting,12,21,7,40,0.175000
2025-09-09,Fannie Mae,4,33,3,40,0.075000
2025-09-09,Farmers Insurance Exchange,10,17,13,40,0.325000
2025-09-09,Fastenal,17,19,4,40,0.100000
2025-09-09,FedEx,13,20,7,40,0.175000
2025-09-09,Federated Mutual Insurance,18,16,6,40,0.150000
2025-09-09,Fidelity National Financial,14,21,5,40,0.125000
2025-09-09,Fidelity National Information Services,20,18,2,40,0.050000
2025-09-09,Fifth Third Bancorp,20,18,2,40,0.050000
2025-09-09,First American Financial,15,19,6,40,0.150000
2025-09-09,First Citizens BancShares,11,27,2,40,0.050000
2025-09-09,First Horizon,18,21,1,40,0.025000
2025-09-09,First National of Nebraska,18,22,0,40,0.000000
2025-09-09,First Solar,26,11,3,40,0.075000
2025-09-09,FirstCash,10,22,8,40,0.200000
2025-09-09,FirstEnergy,20,15,5,40,0.125000
2025-09-09,Fiserv,17,19,4,40,0.100000
2025-09-09,Five Below,15,23,2,40,0.050000
2025-09-09,Flagstar Financial,12,22,6,40,0.150000
2025-09-09,Floor & Decor,19,20,1,40,0.025000
2025-09-09,Flowers Foods,10,24,6,40,0.150000
2025-09-09,Flowserve,14,21,5,40,0.125000
2025-09-09,Fluor,19,12,9,40,0.225000
2025-09-09,Foot Locker,4,33,3,40,0.075000
2025-09-09,Ford Motor,6,19,15,40,0.375000
2025-09-09,Fortinet,20,10,10,40,0.250000
2025-09-09,Fortive,17,16,7,40,0.175000
2025-09-09,Fortune Brands Innovations,16,20,4,40,0.100000
2025-09-09,Franklin Resources,14,23,3,40,0.075000
2025-09-09,Freddie Mac,11,24,5,40,0.125000
2025-09-09,Freeport-McMoRan,15,17,8,40,0.200000
2025-09-09,Frontier Airlines,10,22,8,40,0.200000
2025-09-09,Frontier Communications,19,20,1,40,0.025000
2025-09-09,G-III Apparel Group,13,25,2,40,0.050000
2025-09-09,GE HealthCare Technologies,18,19,3,40,0.075000
2025-09-09,GMS,15,24,1,40,0.025000
2025-09-09,GXO Logistics,12,22,6,40,0.150000
2025-09-09,GameStop,8,27,5,40,0.125000
2025-09-09,Gannett,22,10,8,40,0.200000
2025-09-09,Garrett Motion inc,17,20,3,40,0.075000
2025-09-09,Gartner,15,21,4,40,0.100000
2025-09-09,Gen Digital,24,15,1,40,0.025000
2025-09-09,Generac,20,16,4,40,0.100000
2025-09-09,General Dynamics,40,0,0,40,0.000000
2025-09-09,General Electric,15,24,1,40,0.025000
2025-09-09,General Mills,19,19,2,40,0.050000
2025-09-09,General Motors,12,21,7,40,0.175000
2025-09-09,Genesis Energy,37,2,1,40,0.025000
2025-09-09,Genuine Parts,18,21,1,40,0.025000
2025-09-09,Genworth Financial,23,16,1,40,0.025000
2025-09-09,Gilead Sciences,17,21,2,40,0.050000
2025-09-09,Global Partners,16,20,4,40,0.100000
2025-09-09,Global Payments,13,25,2,40,0.050000
2025-09-09,Globe Life,16,20,4,40,0.100000
2025-09-09,GoDaddy,17,21,2,40,0.050000
2025-09-09,Goldman Sachs,18,17,5,40,0.125000
2025-09-09,Goodyear Tire & Rubber,12,24,4,40,0.100000
2025-09-09,Graham Holdings Company,24,13,3,40,0.075000
2025-09-09,Granite Construction,20,18,2,40,0.050000
2025-09-09,Graphic Packaging,13,22,5,40,0.125000
2025-09-09,Gray Television,13,22,5,40,0.125000
2025-09-09,Graybar Electric,13,21,6,40,0.150000
2025-09-09,Green Plains inc,14,19,7,40,0.175000
2025-09-09,Greenbrier,6,17,17,40,0.425000
2025-09-09,Greif,9,27,4,40,0.100000
2025-09-09,Griffon Corporation,19,21,0,40,0.000000
2025-09-09,Grocery Outlet Holding,16,23,1,40,0.025000
2025-09-09,Group 1 Automotive,16,21,3,40,0.075000
2025-09-09,Guardian Life insurance,18,22,0,40,0.000000
2025-09-09,Guess inc,16,23,1,40,0.025000
2025-09-09,H B Fuller,14,21,5,40,0.125000
2025-09-09,HCA Healthcare,23,13,4,40,0.100000
2025-09-09,HEICO,18,20,2,40,0.050000
2025-09-09,HF Sinclair,18,19,3,40,0.075000
2025-09-09,Halliburton,11,15,14,40,0.350000
2025-09-09,Hanesbrands,14,23,3,40,0.075000
2025-09-09,Hanover Insurance Group,17,21,2,40,0.050000
2025-09-09,Harley-Davidson,11,27,2,40,0.050000
2025-09-09,Hasbro,7,30,3,40,0.075000
2025-09-09,Hawaiian Airlines inc,15,25,0,40,0.000000
2025-09-09,Hawaiian Electric Industries,17,18,5,40,0.125000
2025-09-09,Helmerich & Payne,10,25,5,40,0.125000
2025-09-09,Henry Schein,18,19,3,40,0.075000
2025-09-09,Herc Rentals,18,16,6,40,0.150000
2025-09-09,Hershey,18,21,1,40,0.025000
2025-09-09,Hertz,28,7,5,40,0.125000
2025-09-09,Hewlett Packard,9,29,2,40,0.050000
2025-09-09,Hewlett Packard Enterprise,8,31,1,40,0.025000
2025-09-09,Hillenbrand,14,24,2,40,0.050000
2025-09-09,Hilton Grand Vacations,39,1,0,40,0.000000
2025-09-09,Hilton Worldwide,19,18,3,40,0.075000
2025-09-09,Hologic,10,25,5,40,0.125000
2025-09-09,Home Depot,12,18,10,40,0.250000
2025-09-09,Honeywell,16,21,3,40,0.075000
2025-09-09,Hormel Foods,10,25,5,40,0.125000
2025-09-09,Host Hotels & Resorts,11,27,2,40,0.050000
2025-09-09,Hovnanian Enterprises,13,19,8,40,0.200000
2025-09-09,Howmet Aerospace,19,16,5,40,0.125000
2025-09-09,Hub Group,16,15,9,40,0.225000
2025-09-09,Hubbell,10,25,5,40,0.125000
2025-09-09,Humana,23,13,4,40,0.100000
2025-09-09,Huntington Bancshares,15,24,1,40,0.025000
2025-09-09,Huntington Ingalls Industries,23,11,6,40,0.150000
2025-09-09,Huntsman,8,23,9,40,0.225000
2025-09-09,Hyatt Hotels,22,18,0,40,0.000000
2025-09-09,Hyster-Yale,15,20,5,40,0.125000
2025-09-09,IAC,15,19,6,40,0.150000
2025-09-09,IBM,14,22,4,40,0.100000
2025-09-09,IDEX,14,23,3,40,0.075000
2025-09-09,IDEXX Laboratories,17,19,4,40,0.100000
2025-09-09,IQVIA,24,13,3,40,0.075000
2025-09-09,ITT,17,18,5,40,0.125000
2025-09-09,Icahn Enterprises,11,16,13,40,0.325000
2025-09-09,Illinois Tool Works,18,18,4,40,0.100000
2025-09-09,Illumina inc,10,27,3,40,0.075000
2025-09-09,Incyte,19,18,3,40,0.075000
2025-09-09,Ingersoll Rand,21,16,3,40,0.075000
2025-09-09,Ingles Markets,13,18,9,40,0.225000
2025-09-09,Ingram Micro,13,12,15,40,0.375000
2025-09-09,Ingredion,23,15,2,40,0.050000
2025-09-09,Insight Enterprises,11,24,5,40,0.125000
2025-09-09,Insperity,20,15,5,40,0.125000
2025-09-09,Instacart,19,13,8,40,0.200000
2025-09-09,Installed Building Products,10,27,3,40,0.075000
2025-09-09,Intel,12,20,8,40,0.200000
2025-09-09,Interactive Brokers,15,21,4,40,0.100000
2025-09-09,Intercontinental Exchange,16,23,1,40,0.025000
2025-09-09,International Flavors & Fragrances,19,18,3,40,0.075000
2025-09-09,International Paper,7,31,2,40,0.050000
2025-09-09,Interpublic Group,23,17,0,40,0.000000
2025-09-09,Intuit,17,19,4,40,0.100000
2025-09-09,Intuitive Surgical,9,21,10,40,0.250000
2025-09-09,Iron Mountain,12,22,6,40,0.150000
2025-09-09,JB Hunt Transport Services,7,27,6,40,0.150000
2025-09-09,JELD-WEN Holding,13,22,5,40,0.125000
2025-09-09,JM Smucker,21,13,6,40,0.150000
2025-09-09,JPMorgan Chase,11,22,7,40,0.175000
2025-09-09,Jabil,14,25,1,40,0.025000
2025-09-09,Jackson Financial,17,21,2,40,0.050000
2025-09-09,Jacobs Solutions,36,1,3,40,0.075000
2025-09-09,Jefferies Financial,15,19,6,40,0.150000
2025-09-09,JetBlue Airways,20,14,6,40,0.150000
2025-09-09,Johnson & Johnson,11,26,3,40,0.075000
2025-09-09,Jones Lang LaSalle,17,20,3,40,0.075000
2025-09-09,Juniper Networks,14,23,3,40,0.075000
2025-09-09,KB Home,17,18,5,40,0.125000
2025-09-09,KBR,26,13,1,40,0.025000
2025-09-09,KKR & Co,23,16,1,40,0.025000
2025-09-09,KLA,19,16,5,40,0.125000
2025-09-09,Kaiser Aluminum,18,19,3,40,0.075000
2025-09-09,Kellanova,19,14,7,40,0.175000
2025-09-09,Kelly Services inc,16,18,6,40,0.150000
2025-09-09,Kemper,17,13,10,40,0.250000
2025-09-09,Keurig Dr Pepper,3,32,5,40,0.125000
2025-09-09,KeyCorp,16,17,7,40,0.175000
2025-09-09,Keysight Technologies,23,14,3,40,0.075000
2025-09-09,Kimberly-Clark,12,20,8,40,0.200000
2025-09-09,Kinder Morgan,40,0,0,40,0.000000
2025-09-09,Kirby Corporation,22,15,3,40,0.075000
2025-09-09,Knife River Corporation,19,16,5,40,0.125000
2025-09-09,Knight Swift Transportation,15,20,5,40,0.125000
2025-09-09,Kohls,17,16,7,40,0.175000
2025-09-09,Kontoor Brands,19,18,3,40,0.075000
2025-09-09,Korn Ferry,17,20,3,40,0.075000
2025-09-09,Kraft Heinz,13,19,8,40,0.200000
2025-09-09,Kroger,16,12,12,40,0.300000
2025-09-09,Kyndryl,16,21,3,40,0.075000
2025-09-09,L3Harris Technologies,20,15,5,40,0.125000
2025-09-09,LCI Industries,16,20,4,40,0.100000
2025-09-09,LKQ,13,25,2,40,0.050000
2025-09-09,LPL Financial,30,9,1,40,0.025000
2025-09-09,Labcorp Holdings,17,21,2,40,0.050000
2025-09-09,Lam Research,19,15,6,40,0.150000
2025-09-09,Lamb Weston,15,23,2,40,0.050000
2025-09-09,Land OLakes,7,18,7,32,0.218750
2025-09-09,Landstar System,13,15,12,40,0.300000
2025-09-09,Las Vegas Sands,10,27,3,40,0.075000
2025-09-09,Lear Corporation,25,13,2,40,0.050000
2025-09-09,Leggett & Platt,13,23,4,40,0.100000
2025-09-09,Leidos,21,14,5,40,0.125000
2025-09-09,Lennar,11,28,1,40,0.025000
2025-09-09,Lennox International,18,21,1,40,0.025000
2025-09-09,Levi Strauss,14,25,1,40,0.025000
2025-09-09,Liberty Energy,40,0,0,40,0.000000
2025-09-09,Liberty Media,40,0,0,40,0.000000
2025-09-09,Liberty Mutual Insurance,35,1,4,40,0.100000
2025-09-09,Light & Wonder,11,24,5,40,0.125000
2025-09-09,Lincoln Electric,12,26,2,40,0.050000
2025-09-09,Lincoln National,11,18,11,40,0.275000
2025-09-09,Lithia Motors,12,25,3,40,0.075000
2025-09-09,Live Nation Entertainment,38,1,1,40,0.025000
2025-09-09,Lockheed Martin,16,18,6,40,0.150000
2025-09-09,Loews,17,19,4,40,0.100000
2025-09-09,Louisiana-Pacific Corporation,24,13,3,40,0.075000
2025-09-09,Lowes,15,19,6,40,0.150000
2025-09-09,Lululemon athletica,8,19,13,40,0.325000
2025-09-09,Lumen Technologies,4,29,7,40,0.175000
2025-09-09,Lyft,15,19,6,40,0.150000
2025-09-09,M&T Bank,21,19,0,40,0.000000
2025-09-09,M/I Homes,14,21,5,40,0.125000
2025-09-09,MDU Resources Group,21,15,4,40,0.100000
2025-09-09,MGM Resorts International,10,26,4,40,0.100000
2025-09-09,MKS Instruments,19,20,1,40,0.025000
2025-09-09,MRC Global,14,25,1,40,0.025000
2025-09-09,MSC Industrial Direct,10,24,6,40,0.150000
2025-09-09,MSCI,17,22,1,40,0.025000
2025-09-09,MYR Group,17,21,2,40,0.050000
2025-09-09,Macys,15,20,5,40,0.125000
2025-09-09,ManpowerGroup,15,19,6,40,0.150000
2025-09-09,Marathon Oil,12,26,2,40,0.050000
2025-09-09,Marathon Petroleum,19,18,3,40,0.075000
2025-09-09,Markel Group,17,18,5,40,0.125000
2025-09-09,Marriott International,14,22,4,40,0.100000
2025-09-09,Marriott Vacations Worldwide,16,22,2,40,0.050000
2025-09-09,Marsh & McLennan,22,17,1,40,0.025000
2025-09-09,Martin Marietta Materials,18,16,6,40,0.150000
2025-09-09,Marvell Technology,15,18,7,40,0.175000
2025-09-09,MasTec,13,26,1,40,0.025000
2025-09-09,Masco,15,20,5,40,0.125000
2025-09-09,Mass Mutual,12,24,4,40,0.100000
2025-09-09,MasterBrand,10,29,1,40,0.025000
2025-09-09,Mastercard,16,20,4,40,0.100000
2025-09-09,Matador Resources,15,20,5,40,0.125000
2025-09-09,Match Group,10,18,12,40,0.300000
2025-09-09,Mativ,16,19,5,40,0.125000
2025-09-09,Matson inc,25,13,2,40,0.050000
2025-09-09,Mattel,15,18,7,40,0.175000
2025-09-09,Maximus,17,21,2,40,0.050000
2025-09-09,McCormick & Company,22,14,4,40,0.100000
2025-09-09,McDonalds,12,11,17,40,0.425000
2025-09-09,McKesson,17,21,2,40,0.050000
2025-09-09,Medical Mutual of Ohio,14,19,7,40,0.175000
2025-09-09,Merck,12,12,16,40,0.400000
2025-09-09,Mercury General,13,18,9,40,0.225000
2025-09-09,Meritage Homes,21,15,4,40,0.100000
2025-09-09,MetLife,16,17,7,40,0.175000
2025-09-09,Meta,15,13,12,40,0.300000
2025-09-09,Mettler-Toledo International,26,11,3,40,0.075000
2025-09-09,Microchip Technology,19,20,1,40,0.025000
2025-09-09,Micron Technology,20,17,3,40,0.075000
2025-09-09,Microsoft,7,27,6,40,0.150000
2025-09-09,Middleby,8,27,5,40,0.125000
2025-09-09,MillerKnoll,15,24,1,40,0.025000
2025-09-09,Moderna,15,13,12,40,0.300000
2025-09-09,ModivCare,10,21,9,40,0.225000
2025-09-09,Mohawk Industries,24,14,2,40,0.050000
2025-09-09,Molina Healthcare,11,15,14,40,0.350000
2025-09-09,Molson Coors Beverage,18,15,7,40,0.175000
2025-09-09,Mondelez,15,21,4,40,0.100000
2025-09-09,Monster Beverage,23,13,4,40,0.100000
2025-09-09,Moodys Corporation,3,8,2,13,0.153846
2025-09-09,Moog inc,22,17,1,40,0.025000
2025-09-09,Morgan Stanley,14,24,2,40,0.050000
2025-09-09,Mosaic,8,29,3,40,0.075000
2025-09-09,Motorola Solutions,38,0,2,40,0.050000
2025-09-09,Mueller Industries,21,18,1,40,0.025000
2025-09-09,Murphy Oil,18,19,3,40,0.075000
2025-09-09,Murphy USA,16,23,1,40,0.025000
2025-09-09,Mutual of Omaha,18,18,4,40,0.100000
2025-09-09,NCR Atleos,13,26,1,40,0.025000
2025-09-09,NCR Voyix,15,20,5,40,0.125000
2025-09-09,NGL Energy Partners,37,0,3,40,0.075000
2025-09-09,NLV Financial,5,3,2,10,0.200000
2025-09-09,NOV,13,22,5,40,0.125000
2025-09-09,NRG Energy,37,2,1,40,0.025000
2025-09-09,NVR,15,21,4,40,0.100000
2025-09-09,Nasdaq,13,21,6,40,0.150000
2025-09-09,Nationwide Insurance,10,17,13,40,0.325000
2025-09-09,Navient,16,13,11,40,0.275000
2025-09-09,NetApp,14,25,1,40,0.025000
2025-09-09,Netflix,16,16,8,40,0.200000
2025-09-09,NeueHealth,17,21,2,40,0.050000
2025-09-09,New York Life Insurance,17,21,2,40,0.050000
2025-09-09,NewMarket Corporation,17,20,3,40,0.075000
2025-09-09,Newell Brands,16,20,4,40,0.100000
2025-09-09,Newmont,18,18,4,40,0.100000
2025-09-09,News Corp,19,13,8,40,0.200000
2025-09-09,Nexstar Media Group,15,23,2,40,0.050000
2025-09-09,NextEra Energy,34,5,1,40,0.025000
2025-09-09,NiSource,16,12,12,40,0.300000
2025-09-09,Nike,12,22,6,40,0.150000
2025-09-09,Nordson,18,21,1,40,0.025000
2025-09-09,Nordstrom,16,22,2,40,0.050000
2025-09-09,Norfolk Southern,14,17,9,40,0.225000
2025-09-09,Northern Trust,36,3,1,40,0.025000
2025-09-09,Northrop Grumman,14,22,4,40,0.100000
2025-09-09,Northwestern Mutual,17,15,8,40,0.200000
2025-09-09,Nucor,12,24,4,40,0.100000
2025-09-09,Nvidia,11,25,4,40,0.100000
2025-09-09,O-I Glass,13,23,4,40,0.100000
2025-09-09,ODP Business Solutions,20,19,1,40,0.025000
2025-09-09,OGE Energy,34,5,1,40,0.025000
2025-09-09,ON Semiconductor,11,16,13,40,0.325000
2025-09-09,OReilly Automotive,8,14,7,29,0.241379
2025-09-09,Occidental Petroleum,14,19,7,40,0.175000
2025-09-09,Old Dominion Freight Line,21,15,4,40,0.100000
2025-09-09,Old National Bancorp,14,26,0,40,0.000000
2025-09-09,Old Republic International,20,17,3,40,0.075000
2025-09-09,Olin,11,17,12,40,0.300000
2025-09-09,Omnicom Group,14,19,7,40,0.175000
2025-09-09,OneMain,17,23,0,40,0.000000
2025-09-09,Oneok,24,14,2,40,0.050000
2025-09-09,Opendoor Technologies,9,18,13,40,0.325000
2025-09-09,Option Care Health,40,0,0,40,0.000000
2025-09-09,Oracle,14,23,3,40,0.075000
2025-09-09,Organon,14,20,6,40,0.150000
2025-09-09,Oscar Health,13,17,10,40,0.250000
2025-09-09,Oshkosh Corporation,17,17,6,40,0.150000
2025-09-09,Otis Worldwide,14,22,4,40,0.100000
2025-09-09,Ovintiv,14,18,8,40,0.200000
2025-09-09,Owens & Minor,9,24,7,40,0.175000
2025-09-09,Owens Corning,14,25,1,40,0.025000
2025-09-09,PACS Group,20,7,13,40,0.325000
2025-09-09,PBF Energy,35,1,4,40,0.100000
2025-09-09,PC Connection Inc,20,18,2,40,0.050000
2025-09-09,PENN Entertainment,39,1,0,40,0.000000
2025-09-09,PG&E,12,17,11,40,0.275000
2025-09-09,PNC Financial Services,16,22,2,40,0.050000
2025-09-09,PPG Industries,22,13,5,40,0.125000
2025-09-09,PPL,20,16,4,40,0.100000
2025-09-09,PVH,13,20,7,40,0.175000
2025-09-09,Paccar,16,20,4,40,0.100000
2025-09-09,Pacific Life,16,23,1,40,0.025000
2025-09-09,Packaging Corp of America,10,26,4,40,0.100000
2025-09-09,Palo Alto Networks,16,15,9,40,0.225000
2025-09-09,Par Pacific,20,18,2,40,0.050000
2025-09-09,Paramount Global,7,29,4,40,0.100000
2025-09-09,Park Hotels & Resorts,9,27,4,40,0.100000
2025-09-09,Parker-Hannifin,27,12,1,40,0.025000
2025-09-09,Parsons Corporation,22,15,3,40,0.075000
2025-09-09,Patrick Industries,11,28,1,40,0.025000
2025-09-09,Patterson Companies Inc,10,25,5,40,0.125000
2025-09-09,Patterson-UTI Energy,33,6,1,40,0.025000
2025-09-09,PayPal,18,10,12,40,0.300000
2025-09-09,Paychex,16,21,3,40,0.075000
2025-09-09,Peabody Energy,32,4,4,40,0.100000
2025-09-09,Peloton,20,17,3,40,0.075000
2025-09-09,Penn Mutual Life Insurance,21,16,3,40,0.075000
2025-09-09,PennyMac Financial Services,19,19,2,40,0.050000
2025-09-09,Penske Automotive,19,20,1,40,0.025000
2025-09-09,PepsiCo,16,19,5,40,0.125000
2025-09-09,Performance Food,9,24,7,40,0.175000
2025-09-09,Permian Resources,20,18,2,40,0.050000
2025-09-09,Petco Health and Wellness,35,3,2,40,0.050000
2025-09-09,Peter Kiewit Sons,6,19,15,40,0.375000
2025-09-09,Pfizer,22,12,6,40,0.150000
2025-09-09,Philip Morris,20,18,2,40,0.050000
2025-09-09,Phillips 66,19,16,5,40,0.125000
2025-09-09,Pinnacle West Capital,13,16,11,40,0.275000
2025-09-09,Pinterest,19,20,1,40,0.025000
2025-09-09,Pioneer Natural Resources,19,11,10,40,0.250000
2025-09-09,Pitney Bowes,20,18,2,40,0.050000
2025-09-09,Plains GP,16,12,12,40,0.300000
2025-09-09,Playtika Holding,19,14,7,40,0.175000
2025-09-09,Plexus,6,20,14,40,0.350000
2025-09-09,Polaris Inc,22,15,3,40,0.075000
2025-09-09,Pool Corporation,20,17,3,40,0.075000
2025-09-09,Popular inc,38,1,1,40,0.025000
2025-09-09,Portland General Electric,13,24,3,40,0.075000
2025-09-09,Post Holdings,13,27,0,40,0.000000
2025-09-09,PriceSmart,18,20,2,40,0.050000
2025-09-09,Primerica,15,20,5,40,0.125000
2025-09-09,Primoris Services,22,18,0,40,0.000000
2025-09-09,Principal Financial,19,17,4,40,0.100000
2025-09-09,ProFrac Holding,12,23,5,40,0.125000
2025-09-09,Procter & Gamble,22,12,6,40,0.150000
2025-09-09,Progressive Insurance,13,21,6,40,0.150000
2025-09-09,Prologis,17,21,2,40,0.050000
2025-09-09,Prudential Financial,19,18,3,40,0.075000
2025-09-09,Public Service Enterprise Group,22,15,3,40,0.075000
2025-09-09,Public Storage,16,15,9,40,0.225000
2025-09-09,Publix Super Markets,18,18,4,40,0.100000
2025-09-09,Puget Sound Energy,29,9,2,40,0.050000
2025-09-09,PulteGroup,21,14,5,40,0.125000
2025-09-09,Pure Storage,14,24,2,40,0.050000
2025-09-09,QVC,12,23,5,40,0.125000
2025-09-09,Qorvo,18,18,4,40,0.100000
2025-09-09,Quad/Graphics,14,23,3,40,0.075000
2025-09-09,Qualcomm,18,21,1,40,0.025000
2025-09-09,Quanta Services,14,24,2,40,0.050000
2025-09-09,Quest Diagnostics,13,24,3,40,0.075000
2025-09-09,QuidelOrtho,19,19,2,40,0.050000
2025-09-09,REV Group,16,20,4,40,0.100000
2025-09-09,RPM International,18,20,2,40,0.050000
2025-09-09,RTX,22,15,3,40,0.075000
2025-09-09,RXO inc,17,17,6,40,0.150000
2025-09-09,Rackspace Technology,13,23,4,40,0.100000
2025-09-09,Radius Recycling,7,21,12,40,0.300000
2025-09-09,Ralph Lauren,14,23,3,40,0.075000
2025-09-09,Range Resources,23,15,2,40,0.050000
2025-09-09,Raymond James Financial,27,11,2,40,0.050000
2025-09-09,Realty Income,20,12,8,40,0.200000
2025-09-09,Regal Rexnord,14,25,1,40,0.025000
2025-09-09,Regeneron Pharmaceuticals,17,18,5,40,0.125000
2025-09-09,Regions Financial,16,22,2,40,0.050000
2025-09-09,Reinsurance Group of America,19,19,2,40,0.050000
2025-09-09,Reliance Inc,22,13,5,40,0.125000
2025-09-09,Republic Services,8,15,17,40,0.425000
2025-09-09,ResMed,17,23,0,40,0.000000
2025-09-09,Resideo Technologies,17,20,3,40,0.075000
2025-09-09,Restoration Hardware,12,24,4,40,0.100000
2025-09-09,Revvity,17,14,9,40,0.225000
2025-09-09,Rite Aid,7,28,5,40,0.125000
2025-09-09,Rithm Capital,16,24,0,40,0.000000
2025-09-09,Rivian Automotive,7,28,5,40,0.125000
2025-09-09,Robert Half,16,22,2,40,0.050000
2025-09-09,Roblox,14,17,9,40,0.225000
2025-09-09,Rocket Companies,16,22,2,40,0.050000
2025-09-09,Rockwell Automation,22,18,0,40,0.000000
2025-09-09,Roku,18,21,1,40,0.025000
2025-09-09,Rollins inc,16,24,0,40,0.000000
2025-09-09,Roper Technologies,20,19,1,40,0.025000
2025-09-09,Ross Stores,19,16,5,40,0.125000
2025-09-09,Rush Enterprises,17,20,3,40,0.075000
2025-09-09,Ryder System,16,21,3,40,0.075000
2025-09-09,Ryerson Holding,15,16,9,40,0.225000
2025-09-09,S&P Global,14,21,5,40,0.125000
2025-09-09,SBA Communications,27,9,4,40,0.100000
2025-09-09,SS&C Technologies,18,21,1,40,0.025000
2025-09-09,Sabre Corporation,14,19,7,40,0.175000
2025-09-09,Saia inc,16,19,5,40,0.125000
2025-09-09,Salesforce,9,19,12,40,0.300000
2025-09-09,Sallie Mae,14,23,3,40,0.075000
2025-09-09,Sally Beauty,39,1,0,40,0.000000
2025-09-09,Sanmina,16,23,1,40,0.025000
2025-09-09,ScanSource,21,16,3,40,0.075000
2025-09-09,Schneider National,14,23,3,40,0.075000
2025-09-09,Science Applications International,12,23,5,40,0.125000
2025-09-09,Scotts Miracle-Gro,13,21,6,40,0.150000
2025-09-09,Seaboard,13,15,12,40,0.300000
2025-09-09,Sealed Air Corporation,16,22,2,40,0.050000
2025-09-09,Securian Financial,12,24,4,40,0.100000
2025-09-09,Select Medical,13,19,8,40,0.200000
2025-09-09,Selective Insurance Group,15,13,12,40,0.300000
2025-09-09,Sempra,20,19,1,40,0.025000
2025-09-09,Sentry Insurance Group,3,7,0,10,0.000000
2025-09-09,Service Corp International,8,10,8,26,0.307692
2025-09-09,ServiceNow,19,14,7,40,0.175000
2025-09-09,Sherwin-Williams,10,25,5,40,0.125000
2025-09-09,Shift4 Payments,15,20,5,40,0.125000
2025-09-09,Silgan,7,25,8,40,0.200000
2025-09-09,Simon Property Group,14,23,3,40,0.075000
2025-09-09,Sinclair,11,23,6,40,0.150000
2025-09-09,SiteOne Landscape Supply,16,17,7,40,0.175000
2025-09-09,Skechers USA,12,25,3,40,0.075000
2025-09-09,SkyWest,12,17,11,40,0.275000
2025-09-09,Skyline Champion,34,4,2,40,0.050000
2025-09-09,Skyworks Solutions,30,5,5,40,0.125000
2025-09-09,Smurfit Westrock,8,27,5,40,0.125000
2025-09-09,Snap Inc,16,10,14,40,0.350000
2025-09-09,Snap-on,6,26,8,40,0.200000
2025-09-09,Snowflake inc,19,18,3,40,0.075000
2025-09-09,Sonic Automotive,16,22,2,40,0.050000
2025-09-09,Sonoco Products,17,19,4,40,0.100000
2025-09-09,Southern Company,19,20,1,40,0.025000
2025-09-09,Southwest Airlines,24,11,5,40,0.125000
2025-09-09,Southwest Gas,20,18,2,40,0.050000
2025-09-09,Southwestern Energy,35,3,2,40,0.050000
2025-09-09,SpartanNash,15,24,1,40,0.025000
2025-09-09,Spectrum Brands,15,17,8,40,0.200000
2025-09-09,Spire inc,18,20,2,40,0.050000
2025-09-09,Spirit AeroSystems,32,0,8,40,0.200000
2025-09-09,Spirit Airlines,23,4,13,40,0.325000
2025-09-09,Splunk,11,25,4,40,0.100000
2025-09-09,Sprouts Farmers Market,9,29,2,40,0.050000
2025-09-09,Stagwell,12,26,2,40,0.050000
2025-09-09,Stanley Black & Decker,16,18,6,40,0.150000
2025-09-09,Starbucks,14,21,5,40,0.125000
2025-09-09,State Farm Insurance,11,22,7,40,0.175000
2025-09-09,State Street,10,17,13,40,0.325000
2025-09-09,Steel Dynamics,36,3,1,40,0.025000
2025-09-09,Steelcase,12,26,2,40,0.050000
2025-09-09,Stericycle,10,9,21,40,0.525000
2025-09-09,Stifel Financial,20,17,3,40,0.075000
2025-09-09,StoneX,12,26,2,40,0.050000
2025-09-09,Stryker,9,26,5,40,0.125000
2025-09-09,Summit Materials,11,25,4,40,0.100000
2025-09-09,Sun Communities,22,15,3,40,0.075000
2025-09-09,Super Micro Computer,33,4,3,40,0.075000
2025-09-09,Surgery Partners,9,25,6,40,0.150000
2025-09-09,Sylvamo,13,16,11,40,0.275000
2025-09-09,Synchrony Financial,26,13,1,40,0.025000
2025-09-09,Synopsys,13,26,1,40,0.025000
2025-09-09,Synovus Financial,13,22,5,40,0.125000
2025-09-09,Sysco,21,16,3,40,0.075000
2025-09-09,T Rowe Price,16,24,0,40,0.000000
2025-09-09,TD Synnex,22,17,1,40,0.025000
2025-09-09,TEGNA,10,27,3,40,0.075000
2025-09-09,TIAA,14,23,3,40,0.075000
2025-09-09,TJX,19,16,5,40,0.125000
2025-09-09,Take-Two Interactive Software,15,22,3,40,0.075000
2025-09-09,Talen Energy,39,1,0,40,0.000000
2025-09-09,Tapestry,11,16,13,40,0.325000
2025-09-09,Targa Resources,17,17,6,40,0.150000
2025-09-09,Target,11,18,11,40,0.275000
2025-09-09,Taylor Morrison Home,16,22,2,40,0.050000
2025-09-09,Teledyne Technologies,17,21,2,40,0.050000
2025-09-09,Teleflex,11,26,3,40,0.075000
2025-09-09,Telephone & Data Systems,15,20,5,40,0.125000
2025-09-09,TelevisaUnivision,14,19,7,40,0.175000
2025-09-09,Tempur Sealy International,11,23,6,40,0.150000
2025-09-09,Tenet Healthcare,17,18,5,40,0.125000
2025-09-09,Teradyne,12,25,3,40,0.075000
2025-09-09,Terex,12,25,3,40,0.075000
2025-09-09,Tesla,5,24,11,40,0.275000
2025-09-09,Tetra Tech,28,9,3,40,0.075000
2025-09-09,Texas Instruments,7,18,15,40,0.375000
2025-09-09,Texas Roadhouse,10,23,7,40,0.175000
2025-09-09,Textron,22,16,2,40,0.050000
2025-09-09,The Andersons Inc,11,28,1,40,0.025000
2025-09-09,The Coca-Cola Company,15,22,3,40,0.075000
2025-09-09,The Hartford,11,18,11,40,0.275000
2025-09-09,Thermo Fisher Scientific,22,16,2,40,0.050000
2025-09-09,Thor Industries,14,18,8,40,0.200000
2025-09-09,Thrivent Financial for Lutherans,15,19,6,40,0.150000
2025-09-09,Timken,12,24,4,40,0.100000
2025-09-09,Titan Machinery,13,21,6,40,0.150000
2025-09-09,Toast inc,23,14,3,40,0.075000
2025-09-09,Toll Brothers,10,25,5,40,0.125000
2025-09-09,TopBuild,15,22,3,40,0.075000
2025-09-09,Topgolf Callaway Brands,11,21,8,40,0.200000
2025-09-09,Toro Company,14,26,0,40,0.000000
2025-09-09,Tractor Supply,18,15,7,40,0.175000
2025-09-09,TransDigm,16,17,7,40,0.175000
2025-09-09,TransUnion,15,14,11,40,0.275000
2025-09-09,Travelers Insurance,12,17,11,40,0.275000
2025-09-09,TreeHouse Foods,7,25,8,40,0.200000
2025-09-09,Tri Pointe Homes,14,23,3,40,0.075000
2025-09-09,TriNet Group,23,14,3,40,0.075000
2025-09-09,Trimble,9,25,6,40,0.150000
2025-09-09,Trinity Industries,16,16,8,40,0.200000
2025-09-09,TruStage,26,13,1,40,0.025000
2025-09-09,Truist Financial,24,14,2,40,0.050000
2025-09-09,Tutor Perini Corporation,23,14,3,40,0.075000
2025-09-09,Twilio,14,20,6,40,0.150000
2025-09-09,Tyson Foods,14,16,10,40,0.250000
2025-09-09,U-Haul,4,6,30,40,0.750000
2025-09-09,UFP Industries,14,23,3,40,0.075000
2025-09-09,UGI Utilities Inc,19,14,7,40,0.175000
2025-09-09,UL Solutions,36,1,3,40,0.075000
2025-09-09,UPS,13,16,11,40,0.275000
2025-09-09,US Bancorp,15,24,1,40,0.025000
2025-09-09,US Foods,19,18,3,40,0.075000
2025-09-09,USAA,18,14,8,40,0.200000
2025-09-09,Uber,10,18,12,40,0.300000
2025-09-09,Ulta Beauty,34,2,4,40,0.100000
2025-09-09,Under Armour,14,24,2,40,0.050000
2025-09-09,Union Pacific,17,14,9,40,0.225000
2025-09-09,United Airlines,36,0,4,40,0.100000
2025-09-09,United Natural Foods,39,0,1,40,0.025000
2025-09-09,United Rentals,39,1,0,40,0.000000
2025-09-09,United States Steel,19,10,11,40,0.275000
2025-09-09,UnitedHealth,15,20,5,40,0.125000
2025-09-09,Universal Corporation,16,23,1,40,0.025000
2025-09-09,Universal Health Services,18,15,7,40,0.175000
2025-09-09,Unum Group,14,22,4,40,0.100000
2025-09-09,Upbound Group,25,13,2,40,0.050000
2025-09-09,Urban Outfitters,15,22,3,40,0.075000
2025-09-09,V2X,22,16,2,40,0.050000
2025-09-09,VF Corporation,11,23,6,40,0.150000
2025-09-09,VICI Properties,14,25,1,40,0.025000
2025-09-09,Vail Resorts,14,12,14,40,0.350000
2025-09-09,Valero Energy,35,3,2,40,0.050000
2025-09-09,Valley National Bancorp,10,22,8,40,0.200000
2025-09-09,Valmont Industries,23,13,4,40,0.100000
2025-09-09,Valvoline inc,13,24,3,40,0.075000
2025-09-09,Ventas inc,26,13,1,40,0.025000
2025-09-09,Verisk Analytics,16,18,6,40,0.150000
2025-09-09,Verizon,19,19,2,40,0.050000
2025-09-09,Vertex Pharmaceuticals,13,20,7,40,0.175000
2025-09-09,Vertiv,20,19,1,40,0.025000
2025-09-09,Viasat,22,16,2,40,0.050000
2025-09-09,Viatris,11,21,8,40,0.200000
2025-09-09,Victorias Secret,14,16,10,40,0.250000
2025-09-09,Visa,14,12,14,40,0.350000
2025-09-09,Vishay Intertechnology,13,20,7,40,0.175000
2025-09-09,Vista Outdoor,14,21,5,40,0.125000
2025-09-09,Visteon,21,19,0,40,0.000000
2025-09-09,Vistra,21,14,5,40,0.125000
2025-09-09,Vontier,15,22,3,40,0.075000
2025-09-09,Voya Financial,16,20,4,40,0.100000
2025-09-09,Vulcan Materials,11,21,8,40,0.200000
2025-09-09,WEC Energy,35,1,4,40,0.100000
2025-09-09,WESCO International,19,20,1,40,0.025000
2025-09-09,WEX,15,22,3,40,0.075000
2025-09-09,WR Berkley,10,22,8,40,0.200000
2025-09-09,WW Grainger,22,13,5,40,0.125000
2025-09-09,Wabash National,17,14,9,40,0.225000
2025-09-09,Walgreens,6,23,11,40,0.275000
2025-09-09,Walmart,11,21,8,40,0.200000
2025-09-09,Walt Disney,14,19,7,40,0.175000
2025-09-09,Warner Bros Discovery,7,24,9,40,0.225000
2025-09-09,Warner Music Group,8,30,2,40,0.050000
2025-09-09,Waters Corporation,17,21,2,40,0.050000
2025-09-09,Watsco,13,19,8,40,0.200000
2025-09-09,Wayfair,20,17,3,40,0.075000
2025-09-09,Webster Financial,13,24,3,40,0.075000
2025-09-09,Weis Markets,12,21,7,40,0.175000
2025-09-09,Wells Fargo,34,2,4,40,0.100000
2025-09-09,Welltower,31,9,0,40,0.000000
2025-09-09,Werner Enterprises,20,13,7,40,0.175000
2025-09-09,West Pharmaceutical Services,16,18,6,40,0.150000
2025-09-09,Western & Southern Financial,15,22,3,40,0.075000
2025-09-09,Western Alliance Bancorp,14,17,9,40,0.225000
2025-09-09,Western Digital,18,21,1,40,0.025000
2025-09-09,Western Midstream Partners,22,16,2,40,0.050000
2025-09-09,Western Union,11,27,2,40,0.050000
2025-09-09,Westinghouse Air Brake Technologies,17,17,6,40,0.150000
2025-09-09,Westlake Corporation,11,22,7,40,0.175000
2025-09-09,Weyerhaeuser,10,25,5,40,0.125000
2025-09-09,Whirlpool,10,22,8,40,0.200000
2025-09-09,Williams,16,12,12,40,0.300000
2025-09-09,Williams-Sonoma,14,22,4,40,0.100000
2025-09-09,Wintrust Financial,18,20,2,40,0.050000
2025-09-09,Woodward inc,14,25,1,40,0.025000
2025-09-09,Workday,16,16,8,40,0.200000
2025-09-09,World Kinect,19,17,4,40,0.100000
2025-09-09,Worthington Enterprises,18,22,0,40,0.000000
2025-09-09,Wynn Resorts,13,20,7,40,0.175000
2025-09-09,XPO,14,23,3,40,0.075000
2025-09-09,Xcel Energy,35,5,0,40,0.000000
2025-09-09,Xerox,13,22,5,40,0.125000
2025-09-09,Xylem Inc,24,16,0,40,0.000000
2025-09-09,Yum Brands,8,28,4,40,0.100000
2025-09-09,Yum China,13,23,4,40,0.100000
2025-09-09,Zebra Technologies,16,20,4,40,0.100000
2025-09-09,Zimmer Biomet,18,19,3,40,0.075000
2025-09-09,Zions Bancorp,18,16,6,40,0.150000
2025-09-09,Zoetis,21,17,2,40,0.050000
2025-09-09,Zoom Video Communications,13,22,5,40,0.125000
2025-09-09,eXp World,18,18,4,40,0.100000
2025-09-09,iHeartMedia,11,27,2,40,0.050000
2025-09-10,3M,16,21,3,40,0.075000
2025-09-10,A O Smith,14,24,2,40,0.050000
2025-09-10,A-Mark Precious Metals,37,3,0,40,0.000000
2025-09-10,ABM Industries,8,22,10,40,0.250000
2025-09-10,ADT,15,19,6,40,0.150000
2025-09-10,AECOM,26,13,1,40,0.025000
2025-09-10,AES,18,14,8,40,0.200000
2025-09-10,AGCO,19,18,3,40,0.075000
2025-09-10,AGNC Investment,14,21,5,40,0.125000
2025-09-10,AMC Entertainment,36,1,3,40,0.075000
2025-09-10,AMC Networks,14,18,8,40,0.200000
2025-09-10,AMN Healthcare Services,14,20,6,40,0.150000
2025-09-10,APA,19,15,6,40,0.150000
2025-09-10,APi Group,22,16,2,40,0.050000
2025-09-10,ARKO,10,28,2,40,0.050000
2025-09-10,ASGN,10,21,9,40,0.225000
2025-09-10,AT&T,11,26,3,40,0.075000
2025-09-10,ATI inc,19,20,1,40,0.025000
2025-09-10,AbbVie,24,13,3,40,0.075000
2025-09-10,Abbott Laboratories,17,17,6,40,0.150000
2025-09-10,Abercrombie & Fitch,12,26,2,40,0.050000
2025-09-10,Academy Sports and Outdoors,13,24,3,40,0.075000
2025-09-10,Acadia Healthcare,10,21,9,40,0.225000
2025-09-10,Acuity Inc,22,17,1,40,0.025000
2025-09-10,Adams Resources & Energy,16,7,1,24,0.041667
2025-09-10,AdaptHealth,18,18,4,40,0.100000
2025-09-10,Adobe,10,26,4,40,0.100000
2025-09-10,Advance Auto Parts,12,18,10,40,0.250000
2025-09-10,Advanced Drainage Systems,34,5,1,40,0.025000
2025-09-10,Advanced Micro Devices,29,5,6,40,0.150000
2025-09-10,Advantage Solutions,37,0,3,40,0.075000
2025-09-10,Aflac,9,16,15,40,0.375000
2025-09-10,Agilent Technologies,20,19,1,40,0.025000
2025-09-10,Agilon Health,13,20,7,40,0.175000
2025-09-10,Air Lease,13,26,1,40,0.025000
2025-09-10,Air Products & Chemicals,14,20,6,40,0.150000
2025-09-10,Airbnb,12,19,9,40,0.225000
2025-09-10,Akamai Technologies,14,21,5,40,0.125000
2025-09-10,Alaska Air,9,24,7,40,0.175000
2025-09-10,Albemarle Corporation,13,25,2,40,0.050000
2025-09-10,Albertsons,14,24,2,40,0.050000
2025-09-10,Alcoa Corporation,9,24,7,40,0.175000
2025-09-10,Alexandria Real Estate Equities,15,22,3,40,0.075000
2025-09-10,Alight Solutions,13,23,4,40,0.100000
2025-09-10,Align Technology,8,21,11,40,0.275000
2025-09-10,Allegiant Travel Company,14,23,3,40,0.075000
2025-09-10,Alliance Resource Partners,11,19,10,40,0.250000
2025-09-10,Alliant Energy,35,3,2,40,0.050000
2025-09-10,Allison Transmission,15,19,6,40,0.150000
2025-09-10,Allstate,23,12,5,40,0.125000
2025-09-10,Ally Financial,15,24,1,40,0.025000
2025-09-10,Alpha Metallurgical Resources,17,16,7,40,0.175000
2025-09-10,Alphabet,20,12,8,40,0.200000
2025-09-10,Altice,16,19,5,40,0.125000
2025-09-10,Altria Group,15,21,4,40,0.100000
2025-09-10,Amazon,34,2,4,40,0.100000
2025-09-10,Ameren,19,18,3,40,0.075000
2025-09-10,American Airlines,12,20,8,40,0.200000
2025-09-10,American Axle & Manufacturing,11,27,2,40,0.050000
2025-09-10,American Eagle Outfitters,14,20,6,40,0.150000
2025-09-10,American Electric Power,21,16,3,40,0.075000
2025-09-10,American Express,20,18,2,40,0.050000
2025-09-10,American Family Insurance,21,15,4,40,0.100000
2025-09-10,American Financial,24,12,4,40,0.100000
2025-09-10,American International Group,17,20,3,40,0.075000
2025-09-10,American Tower,22,14,4,40,0.100000
2025-09-10,American Water Works,16,20,4,40,0.100000
2025-09-10,Americold Realty Trust,34,2,4,40,0.100000
2025-09-10,Ameriprise Financial,20,15,5,40,0.125000
2025-09-10,Ametek,22,16,2,40,0.050000
2025-09-10,Amgen,15,23,2,40,0.050000
2025-09-10,Amica Mutual Insurance,12,26,2,40,0.050000
2025-09-10,Amkor Technology,12,27,1,40,0.025000
2025-09-10,Amphenol,23,17,0,40,0.000000
2025-09-10,Analog Devices,21,18,1,40,0.025000
2025-09-10,Antero Resources,14,25,1,40,0.025000
2025-09-10,Anywhere Real Estate Inc,19,18,3,40,0.075000
2025-09-10,Apollo Global Management,16,22,2,40,0.050000
2025-09-10,AppLovin,11,26,3,40,0.075000
2025-09-10,Apple,13,22,5,40,0.125000
2025-09-10,Applied Industrial Technologies,14,25,1,40,0.025000
2025-09-10,Applied Materials,6,17,17,40,0.425000
2025-09-10,AptarGroup,18,20,2,40,0.050000
2025-09-10,Aramark,20,18,2,40,0.050000
2025-09-10,ArcBest,13,21,6,40,0.150000
2025-09-10,Arch Resources,31,5,4,40,0.100000
2025-09-10,Archer Daniels Midland,25,12,3,40,0.075000
2025-09-10,Ares Management,21,17,2,40,0.050000
2025-09-10,Arista Networks,18,22,0,40,0.000000
2025-09-10,Arrow Electronics,21,13,6,40,0.150000
2025-09-10,Arthur J Gallagher,16,24,0,40,0.000000
2025-09-10,Asbury Automotive Group,14,22,4,40,0.100000
2025-09-10,Assurant,24,12,4,40,0.100000
2025-09-10,Atkore,19,18,3,40,0.075000
2025-09-10,Atlassian,14,19,7,40,0.175000
2025-09-10,Atmos Energy,37,2,1,40,0.025000
2025-09-10,Auto-Owners Insurance,15,20,5,40,0.125000
2025-09-10,AutoNation,19,18,3,40,0.075000
2025-09-10,AutoZone,8,21,11,40,0.275000
2025-09-10,Autodesk,19,21,0,40,0.000000
2025-09-10,Autoliv,25,13,2,40,0.050000
2025-09-10,Automatic Data Processing,23,17,0,40,0.000000
2025-09-10,AvalonBay Communities,16,21,3,40,0.075000
2025-09-10,Avantor,11,20,9,40,0.225000
2025-09-10,Avery Dennison,11,28,1,40,0.025000
2025-09-10,Avient,13,23,4,40,0.100000
2025-09-10,Avis Budget,10,23,7,40,0.175000
2025-09-10,Avnet,13,25,2,40,0.050000
2025-09-10,BJs Wholesale Club,10,24,6,40,0.150000
2025-09-10,BOK Financial,23,12,5,40,0.125000
2025-09-10,BWX Technologies,20,19,1,40,0.025000
2025-09-10,Baker Hughes,13,23,4,40,0.100000
2025-09-10,Ball,14,19,7,40,0.175000
2025-09-10,Bank of America,16,19,5,40,0.125000
2025-09-10,Bank of New York Mellon,22,16,2,40,0.050000
2025-09-10,Bath & Body Works,12,14,14,40,0.350000
2025-09-10,Baxter International,11,21,8,40,0.200000
2025-09-10,Beacon Roofing Supply,7,23,10,40,0.250000
2025-09-10,Becton Dickinson,20,16,4,40,0.100000
2025-09-10,Belden,11,23,6,40,0.150000
2025-09-10,Benchmark Electronics,18,18,4,40,0.100000
2025-09-10,Berkshire Hathaway,15,16,9,40,0.225000
2025-09-10,Best Buy,27,4,9,40,0.225000
2025-09-10,Big Lots,6,31,3,40,0.075000
2025-09-10,Bio-Rad Laboratories,17,19,4,40,0.100000
2025-09-10,Biogen,14,26,0,40,0.000000
2025-09-10,BlackRock,15,21,4,40,0.100000
2025-09-10,Blackstone,13,27,0,40,0.000000
2025-09-10,Bloomin Brands,8,26,6,40,0.150000
2025-09-10,BlueLinx,16,19,5,40,0.125000
2025-09-10,Boeing,12,23,5,40,0.125000
2025-09-10,Boise Cascade,8,18,14,40,0.350000
2025-09-10,Booking Holdings,25,15,0,40,0.000000
2025-09-10,Booz Allen Hamilton,21,15,4,40,0.100000
2025-09-10,BorgWarner,19,19,2,40,0.050000
2025-09-10,Boston Properties,12,21,7,40,0.175000
2025-09-10,Boston Scientific,9,27,4,40,0.100000
2025-09-10,Boyd Gaming,15,24,1,40,0.025000
2025-09-10,Bread Financial,19,18,3,40,0.075000
2025-09-10,BrightSpring Health Services,17,20,3,40,0.075000
2025-09-10,BrightView Holdings,19,16,5,40,0.125000
2025-09-10,Brighthouse Financial,15,22,3,40,0.075000
2025-09-10,Brinker International,17,23,0,40,0.000000
2025-09-10,Brinks Company,9,3,5,17,0.294118
2025-09-10,Bristol-Myers Squibb,13,23,4,40,0.100000
2025-09-10,Broadcom,19,16,5,40,0.125000
2025-09-10,Broadridge Financial Solutions,30,9,1,40,0.025000
2025-09-10,Brookdale Senior Living,12,19,9,40,0.225000
2025-09-10,Brown & Brown,15,17,8,40,0.200000
2025-09-10,Brown-Forman,8,21,11,40,0.275000
2025-09-10,Bruker,18,17,5,40,0.125000
2025-09-10,Brunswick,6,23,11,40,0.275000
2025-09-10,Builders FirstSource,26,13,1,40,0.025000
2025-09-10,Burlington Stores,15,22,3,40,0.075000
2025-09-10,CACI International,22,15,3,40,0.075000
2025-09-10,CBRE Group,21,19,0,40,0.000000
2025-09-10,CDW,19,20,1,40,0.025000
2025-09-10,CF Industries,26,14,0,40,0.000000
2025-09-10,CH Robinson Worldwide,18,18,4,40,0.100000
2025-09-10,CHS,16,21,3,40,0.075000
2025-09-10,CME Group,19,19,2,40,0.050000
2025-09-10,CMS Energy,39,1,0,40,0.000000
2025-09-10,CNO Financial Group,17,21,2,40,0.050000
2025-09-10,CNX Resources,17,21,2,40,0.050000
2025-09-10,CSX,15,19,6,40,0.150000
2025-09-10,CVS Health,14,18,8,40,0.200000
2025-09-10,Cabot Corporation,17,22,1,40,0.025000
2025-09-10,Cadence,10,26,4,40,0.100000
2025-09-10,Caesars Entertainment,35,5,0,40,0.000000
2025-09-10,Cal-Maine Foods,28,11,1,40,0.025000
2025-09-10,Caleres inc,20,15,5,40,0.125000
2025-09-10,California Resources,17,20,3,40,0.075000
2025-09-10,Calumet,4,15,21,40,0.525000
2025-09-10,Campbell Soup,13,23,4,40,0.100000
2025-09-10,Camping World,12,22,6,40,0.150000
2025-09-10,Capital One,20,16,4,40,0.100000
2025-09-10,CarMax,9,27,4,40,0.100000
2025-09-10,Cardinal Health,16,17,7,40,0.175000
2025-09-10,Carlisle Companies,18,18,4,40,0.100000
2025-09-10,Carlyle Group,11,27,2,40,0.050000
2025-09-10,Carpenter Technology,16,21,3,40,0.075000
2025-09-10,Carrier Global,20,19,1,40,0.025000
2025-09-10,Carters inc,11,21,2,34,0.058824
2025-09-10,Carvana,24,12,4,40,0.100000
2025-09-10,Caseys General Stores,14,21,5,40,0.125000
2025-09-10,Catalent,10,26,4,40,0.100000
2025-09-10,Caterpillar,19,15,6,40,0.150000
2025-09-10,Cboe Global Markets,13,26,1,40,0.025000
2025-09-10,Celanese,12,20,8,40,0.200000
2025-09-10,Cencora,20,15,5,40,0.125000
2025-09-10,Centene,17,9,14,40,0.350000
2025-09-10,CenterPoint Energy,26,6,8,40,0.200000
2025-09-10,Central Garden & Pet,3,37,0,40,0.000000
2025-09-10,Century Communities,12,24,4,40,0.100000
2025-09-10,ChampionX,21,19,0,40,0.000000
2025-09-10,Charles River Laboratories International,14,19,7,40,0.175000
2025-09-10,Charles Schwab,13,21,6,40,0.150000
2025-09-10,Chart Industries,11,26,3,40,0.075000
2025-09-10,Charter Communications,10,22,8,40,0.200000
2025-09-10,Cheesecake Factory,16,17,7,40,0.175000
2025-09-10,Chefs Warehouse,18,18,4,40,0.100000
2025-09-10,Chemours,18,12,10,40,0.250000
2025-09-10,Cheniere Energy,37,3,0,40,0.000000
2025-09-10,Chevron,19,18,3,40,0.075000
2025-09-10,Chewy,11,22,7,40,0.175000
2025-09-10,Chipotle Mexican Grill,16,23,1,40,0.025000
2025-09-10,Chord Energy,36,2,2,40,0.050000
2025-09-10,Church & Dwight,16,24,0,40,0.000000
2025-09-10,Ciena,18,21,1,40,0.025000
2025-09-10,Cigna,17,19,4,40,0.100000
2025-09-10,Cincinnati Financial,17,18,5,40,0.125000
2025-09-10,Cinemark,9,25,6,40,0.150000
2025-09-10,Cintas,20,17,3,40,0.075000
2025-09-10,Cisco Systems,12,24,4,40,0.100000
2025-09-10,Citigroup,14,22,4,40,0.100000
2025-09-10,Citizens Financial Group,11,28,1,40,0.025000
2025-09-10,Civitas Resources,13,18,9,40,0.225000
2025-09-10,Clean Harbors,32,2,6,40,0.150000
2025-09-10,Clear Channel Outdoor Hldgs,11,0,1,12,0.083333
2025-09-10,Cleveland-Cliffs,15,12,13,40,0.325000
2025-09-10,Clorox,13,19,8,40,0.200000
2025-09-10,Cognizant Technology Solutions,36,2,2,40,0.050000
2025-09-10,Coherent,20,17,3,40,0.075000
2025-09-10,Coinbase Global,13,22,5,40,0.125000
2025-09-10,Colgate-Palmolive,12,18,10,40,0.250000
2025-09-10,Columbia Banking System,13,27,0,40,0.000000
2025-09-10,Columbia Sportswear,10,19,11,40,0.275000
2025-09-10,Comcast,22,12,6,40,0.150000
2025-09-10,Comerica,20,16,4,40,0.100000
2025-09-10,Comfort Systems USA,39,1,0,40,0.000000
2025-09-10,CommScope,17,23,0,40,0.000000
2025-09-10,Commercial Metals,10,21,9,40,0.225000
2025-09-10,Community Health Systems,17,17,6,40,0.150000
2025-09-10,Compass,17,18,5,40,0.125000
2025-09-10,Conagra Brands,17,23,0,40,0.000000
2025-09-10,Concentrix,19,17,4,40,0.100000
2025-09-10,Conduent,15,17,8,40,0.200000
2025-09-10,ConocoPhillips,12,15,13,40,0.325000
2025-09-10,Consol Energy,31,6,3,40,0.075000
2025-09-10,Consolidated Edison,11,24,5,40,0.125000
2025-09-10,Constellation Brands,10,16,14,40,0.350000
2025-09-10,Constellation Energy,32,3,5,40,0.125000
2025-09-10,Continental Resources,19,13,8,40,0.200000
2025-09-10,Cooper Cos,6,30,4,40,0.100000
2025-09-10,Cooper-Standard,9,28,3,40,0.075000
2025-09-10,Copart,18,19,3,40,0.075000
2025-09-10,Core & Main,10,18,12,40,0.300000
2025-09-10,Cornerstone Building Brands,15,20,5,40,0.125000
2025-09-10,Corning,15,20,5,40,0.125000
2025-09-10,Corpay,15,25,0,40,0.000000
2025-09-10,Corteva,16,21,3,40,0.075000
2025-09-10,Costco,19,12,9,40,0.225000
2025-09-10,Coterra Energy,36,2,2,40,0.050000
2025-09-10,Coty,10,22,8,40,0.200000
2025-09-10,Country Financial,18,20,2,40,0.050000
2025-09-10,Coupang,15,15,10,40,0.250000
2025-09-10,Cracker Barrel Old Country Store,4,28,8,40,0.200000
2025-09-10,Crocs,11,26,3,40,0.075000
2025-09-10,CrossAmerica Partners,14,24,2,40,0.050000
2025-09-10,CrowdStrike,21,7,12,40,0.300000
2025-09-10,Crown Castle,17,23,0,40,0.000000
2025-09-10,Crown Holdings,21,15,4,40,0.100000
2025-09-10,Cullen Frost Bankers,15,21,4,40,0.100000
2025-09-10,Cummins,11,20,9,40,0.225000
2025-09-10,Curtiss-Wright,22,16,2,40,0.050000
2025-09-10,DR Horton,14,19,7,40,0.175000
2025-09-10,DTE Energy,33,4,3,40,0.075000
2025-09-10,DXC Technology,22,17,1,40,0.025000
2025-09-10,DaVita,17,13,10,40,0.250000
2025-09-10,Dana Incorporated,20,16,4,40,0.100000
2025-09-10,Danaher,15,23,2,40,0.050000
2025-09-10,Darden Restaurants,22,15,3,40,0.075000
2025-09-10,Darling Ingredients,39,0,1,40,0.025000
2025-09-10,Deckers Outdoor,27,13,0,40,0.000000
2025-09-10,Deere,9,18,13,40,0.325000
2025-09-10,Delek US,25,13,2,40,0.050000
2025-09-10,Dell Technologies,13,16,11,40,0.275000
2025-09-10,Delta Air Lines,6,20,14,40,0.350000
2025-09-10,Dentsply Sirona,14,26,0,40,0.000000
2025-09-10,Designer Brands,10,26,4,40,0.100000
2025-09-10,Devon Energy,38,1,1,40,0.025000
2025-09-10,DexCom,12,23,5,40,0.125000
2025-09-10,Diamondback Energy,36,1,3,40,0.075000
2025-09-10,Dicks Sporting Goods,12,26,2,40,0.050000
2025-09-10,Diebold Nixdorf,16,24,0,40,0.000000
2025-09-10,Digital Realty Trust,33,7,0,40,0.000000
2025-09-10,Dillards,14,16,10,40,0.250000
2025-09-10,DocuSign,19,17,4,40,0.100000
2025-09-10,Dollar General,7,18,15,40,0.375000
2025-09-10,Dollar Tree,20,14,6,40,0.150000
2025-09-10,Dominion Energy,27,8,5,40,0.125000
2025-09-10,Dominos Pizza inc,14,18,6,38,0.157895
2025-09-10,Domtar,9,24,7,40,0.175000
2025-09-10,Donaldson Company,27,13,0,40,0.000000
2025-09-10,DoorDash,20,15,5,40,0.125000
2025-09-10,Dover Corporation,24,12,4,40,0.100000
2025-09-10,DraftKings,32,7,1,40,0.025000
2025-09-10,Dream Finders Homes,37,1,2,40,0.050000
2025-09-10,Dropbox,22,16,2,40,0.050000
2025-09-10,DuPont,13,19,8,40,0.200000
2025-09-10,Duke Energy,33,4,3,40,0.075000
2025-09-10,Dycom Industries,19,16,5,40,0.125000
2025-09-10,EMCOR Group,13,25,2,40,0.050000
2025-09-10,EOG Resources,21,18,1,40,0.025000
2025-09-10,EPAM Systems,21,16,3,40,0.075000
2025-09-10,EQT,21,18,1,40,0.025000
2025-09-10,ESAB,13,25,2,40,0.050000
2025-09-10,East West Bancorp,18,22,0,40,0.000000
2025-09-10,Eastman Chemical,13,16,11,40,0.275000
2025-09-10,Ebay,15,21,4,40,0.100000
2025-09-10,EchoStar,11,20,9,40,0.225000
2025-09-10,Ecolab,20,17,3,40,0.075000
2025-09-10,Edison International,10,23,7,40,0.175000
2025-09-10,Edward Jones,16,18,6,40,0.150000
2025-09-10,Edwards Lifesciences,18,15,7,40,0.175000
2025-09-10,Elanco Animal Health,15,24,1,40,0.025000
2025-09-10,Electronic Arts,14,19,7,40,0.175000
2025-09-10,Elevance Health,18,10,12,40,0.300000
2025-09-10,Eli Lilly,10,22,8,40,0.200000
2025-09-10,Emerson Electric,21,19,0,40,0.000000
2025-09-10,EnLink Midstream,17,18,5,40,0.125000
2025-09-10,Encompass Health,12,23,5,40,0.125000
2025-09-10,Endeavor Group,13,23,4,40,0.100000
2025-09-10,EnerSys,21,19,0,40,0.000000
2025-09-10,Energizer,37,2,1,40,0.025000
2025-09-10,Energy Transfer,32,1,7,40,0.175000
2025-09-10,Ensign Group,23,17,0,40,0.000000
2025-09-10,Entegris,23,15,2,40,0.050000
2025-09-10,Entergy,22,16,2,40,0.050000
2025-09-10,Enterprise Products Partners,18,15,7,40,0.175000
2025-09-10,Envista,15,24,1,40,0.025000
2025-09-10,Equifax,23,14,3,40,0.075000
2025-09-10,Equinix,19,20,1,40,0.025000
2025-09-10,Equitable,24,11,5,40,0.125000
2025-09-10,Equity Residential,16,20,4,40,0.100000
2025-09-10,Erie Insurance,17,12,11,40,0.275000
2025-09-10,Estée Lauder,15,18,7,40,0.175000
2025-09-10,Etsy,12,15,13,40,0.325000
2025-09-10,Euronet Worldwide,17,19,4,40,0.100000
2025-09-10,Evergy,24,11,5,40,0.125000
2025-09-10,Eversource Energy,31,5,4,40,0.100000
2025-09-10,Exact Sciences,10,19,11,40,0.275000
2025-09-10,Exelon,14,23,3,40,0.075000
2025-09-10,Expand Energy,38,2,0,40,0.000000
2025-09-10,Expedia,19,17,4,40,0.100000
2025-09-10,Expeditors International of Washington,17,21,2,40,0.050000
2025-09-10,Extra Space Storage,15,22,3,40,0.075000
2025-09-10,Exxon Mobil,16,21,3,40,0.075000
2025-09-10,F5,9,26,5,40,0.125000
2025-09-10,FM Global,17,15,8,40,0.200000
2025-09-10,FMC Corporation,18,21,1,40,0.025000
2025-09-10,FTI Consulting,13,19,8,40,0.200000
2025-09-10,Fannie Mae,3,34,3,40,0.075000
2025-09-10,Farmers Insurance Exchange,10,18,12,40,0.300000
2025-09-10,Fastenal,21,14,5,40,0.125000
2025-09-10,FedEx,12,17,11,40,0.275000
2025-09-10,Federated Mutual Insurance,17,19,4,40,0.100000
2025-09-10,Fidelity National Financial,18,18,4,40,0.100000
2025-09-10,Fidelity National Information Services,19,17,4,40,0.100000
2025-09-10,Fifth Third Bancorp,16,11,13,40,0.325000
2025-09-10,First American Financial,19,17,4,40,0.100000
2025-09-10,First Citizens BancShares,14,24,2,40,0.050000
2025-09-10,First National of Nebraska,18,22,0,40,0.000000
2025-09-10,First Solar,24,13,3,40,0.075000
2025-09-10,FirstCash,13,22,5,40,0.125000
2025-09-10,FirstEnergy,21,14,5,40,0.125000
2025-09-10,Fiserv,18,18,4,40,0.100000
2025-09-10,Five Below,19,20,1,40,0.025000
2025-09-10,Flagstar Financial,13,22,5,40,0.125000
2025-09-10,Floor & Decor,18,20,2,40,0.050000
2025-09-10,Flowers Foods,11,19,10,40,0.250000
2025-09-10,Flowserve,13,19,8,40,0.200000
2025-09-10,Fluor,16,15,9,40,0.225000
2025-09-10,Foot Locker,3,30,7,40,0.175000
2025-09-10,Ford Motor,11,22,7,40,0.175000
2025-09-10,Fortinet,18,10,12,40,0.300000
2025-09-10,Fortive,12,22,6,40,0.150000
2025-09-10,Fortune Brands Innovations,14,22,4,40,0.100000
2025-09-10,Franklin Resources,15,23,2,40,0.050000
2025-09-10,Freddie Mac,10,21,9,40,0.225000
2025-09-10,Freeport-McMoRan,17,13,10,40,0.250000
2025-09-10,Frontier Airlines,13,19,8,40,0.200000
2025-09-10,Frontier Communications,19,20,1,40,0.025000
2025-09-10,G-III Apparel Group,15,23,2,40,0.050000
2025-09-10,GE HealthCare Technologies,20,18,2,40,0.050000
2025-09-10,GMS,13,25,2,40,0.050000
2025-09-10,GXO Logistics,15,19,6,40,0.150000
2025-09-10,GameStop,17,19,4,40,0.100000
2025-09-10,Gannett,17,13,10,40,0.250000
2025-09-10,Garrett Motion inc,14,21,5,40,0.125000
2025-09-10,Gartner,13,24,3,40,0.075000
2025-09-10,Gen Digital,19,19,2,40,0.050000
2025-09-10,Generac,22,14,4,40,0.100000
2025-09-10,General Dynamics,38,1,1,40,0.025000
2025-09-10,General Electric,12,27,1,40,0.025000
2025-09-10,General Mills,20,17,3,40,0.075000
2025-09-10,General Motors,12,19,9,40,0.225000
2025-09-10,Genesis Energy,36,2,2,40,0.050000
2025-09-10,Genuine Parts,20,18,2,40,0.050000
2025-09-10,Genworth Financial,23,15,2,40,0.050000
2025-09-10,Gilead Sciences,14,23,3,40,0.075000
2025-09-10,Global Partners,16,20,4,40,0.100000
2025-09-10,Global Payments,13,25,2,40,0.050000
2025-09-10,Globe Life,16,20,4,40,0.100000
2025-09-10,GoDaddy,15,22,3,40,0.075000
2025-09-10,Goldman Sachs,15,19,6,40,0.150000
2025-09-10,Goodyear Tire & Rubber,13,24,3,40,0.075000
2025-09-10,Graham Holdings Company,23,14,3,40,0.075000
2025-09-10,Granite Construction,19,19,2,40,0.050000
2025-09-10,Graphic Packaging,13,19,8,40,0.200000
2025-09-10,Gray Television,13,22,5,40,0.125000
2025-09-10,Graybar Electric,13,22,5,40,0.125000
2025-09-10,Green Plains inc,15,19,6,40,0.150000
2025-09-10,Greenbrier,8,20,12,40,0.300000
2025-09-10,Greif,8,26,6,40,0.150000
2025-09-10,Griffon Corporation,17,22,1,40,0.025000
2025-09-10,Grocery Outlet Holding,17,22,1,40,0.025000
2025-09-10,Group 1 Automotive,17,21,2,40,0.050000
2025-09-10,Guardian Life insurance,19,21,0,40,0.000000
2025-09-10,Guess inc,14,26,0,40,0.000000
2025-09-10,H B Fuller,13,22,5,40,0.125000
2025-09-10,HCA Healthcare,24,13,3,40,0.075000
2025-09-10,HEICO,18,19,3,40,0.075000
2025-09-10,HF Sinclair,14,22,4,40,0.100000
2025-09-10,Halliburton,9,14,17,40,0.425000
2025-09-10,Hanesbrands,15,22,3,40,0.075000
2025-09-10,Hanover Insurance Group,16,21,3,40,0.075000
2025-09-10,Harley-Davidson,14,22,4,40,0.100000
2025-09-10,Hasbro,12,28,0,40,0.000000
2025-09-10,Hawaiian Airlines inc,12,27,1,40,0.025000
2025-09-10,Hawaiian Electric Industries,19,18,3,40,0.075000
2025-09-10,Helmerich & Payne,10,26,4,40,0.100000
2025-09-10,Henry Schein,22,17,1,40,0.025000
2025-09-10,Herc Rentals,17,17,6,40,0.150000
2025-09-10,Hershey,17,19,4,40,0.100000
2025-09-10,Hertz,26,6,8,40,0.200000
2025-09-10,Hewlett Packard,10,28,2,40,0.050000
2025-09-10,Hewlett Packard Enterprise,11,28,1,40,0.025000
2025-09-10,Hillenbrand,19,19,2,40,0.050000
2025-09-10,Hilton Grand Vacations,39,1,0,40,0.000000
2025-09-10,Hilton Worldwide,17,20,3,40,0.075000
2025-09-10,Hologic,12,23,5,40,0.125000
2025-09-10,Home Depot,12,22,6,40,0.150000
2025-09-10,Honeywell,15,22,3,40,0.075000
2025-09-10,Hormel Foods,9,27,4,40,0.100000
2025-09-10,Host Hotels & Resorts,10,29,1,40,0.025000
2025-09-10,Hovnanian Enterprises,11,24,5,40,0.125000
2025-09-10,Howmet Aerospace,16,22,2,40,0.050000
2025-09-10,Hub Group,14,19,7,40,0.175000
2025-09-10,Hubbell,17,19,4,40,0.100000
2025-09-10,Humana,21,13,6,40,0.150000
2025-09-10,Huntington Bancshares,15,22,3,40,0.075000
2025-09-10,Huntington Ingalls Industries,22,15,3,40,0.075000
2025-09-10,Huntsman,9,20,11,40,0.275000
2025-09-10,Hyatt Hotels,17,23,0,40,0.000000
2025-09-10,Hyster-Yale,15,21,4,40,0.100000
2025-09-10,IAC,14,19,7,40,0.175000
2025-09-10,IBM,15,21,4,40,0.100000
2025-09-10,IDEX,17,22,1,40,0.025000
2025-09-10,IDEXX Laboratories,21,16,3,40,0.075000
2025-09-10,IQVIA,24,13,3,40,0.075000
2025-09-10,ITT,15,19,6,40,0.150000
2025-09-10,Icahn Enterprises,11,14,15,40,0.375000
2025-09-10,Illinois Tool Works,25,13,2,40,0.050000
2025-09-10,Illumina inc,19,20,1,40,0.025000
2025-09-10,Incyte,20,18,2,40,0.050000
2025-09-10,Ingersoll Rand,20,16,4,40,0.100000
2025-09-10,Ingles Markets,12,21,7,40,0.175000
2025-09-10,Ingram Micro,14,12,14,40,0.350000
2025-09-10,Ingredion,22,17,1,40,0.025000
2025-09-10,Insight Enterprises,11,25,4,40,0.100000
2025-09-10,Insperity,20,17,3,40,0.075000
2025-09-10,Instacart,15,17,8,40,0.200000
2025-09-10,Installed Building Products,7,29,4,40,0.100000
2025-09-10,Intel,9,26,5,40,0.125000
2025-09-10,Interactive Brokers,13,22,5,40,0.125000
2025-09-10,Intercontinental Exchange,14,25,1,40,0.025000
2025-09-10,International Flavors & Fragrances,18,18,4,40,0.100000
2025-09-10,International Paper,8,27,5,40,0.125000
2025-09-10,Interpublic Group,24,14,2,40,0.050000
2025-09-10,Intuit,16,22,2,40,0.050000
2025-09-10,Intuitive Surgical,13,18,9,40,0.225000
2025-09-10,Iron Mountain,8,28,4,40,0.100000
2025-09-10,JB Hunt Transport Services,13,23,4,40,0.100000
2025-09-10,JELD-WEN Holding,13,21,6,40,0.150000
2025-09-10,JM Smucker,19,17,4,40,0.100000
2025-09-10,JPMorgan Chase,8,20,12,40,0.300000
2025-09-10,Jabil,18,21,1,40,0.025000
2025-09-10,Jackson Financial,13,23,4,40,0.100000
2025-09-10,Jacobs Solutions,36,1,3,40,0.075000
2025-09-10,Jefferies Financial,13,23,4,40,0.100000
2025-09-10,JetBlue Airways,15,24,1,40,0.025000
2025-09-10,Johnson & Johnson,15,17,8,40,0.200000
2025-09-10,Jones Lang LaSalle,18,17,5,40,0.125000
2025-09-10,Juniper Networks,14,23,3,40,0.075000
2025-09-10,KB Home,18,19,3,40,0.075000
2025-09-10,KBR,28,11,1,40,0.025000
2025-09-10,KKR & Co,19,19,2,40,0.050000
2025-09-10,KLA,18,18,4,40,0.100000
2025-09-10,Kaiser Aluminum,18,19,3,40,0.075000
2025-09-10,Kellanova,20,17,3,40,0.075000
2025-09-10,Kelly Services inc,19,17,4,40,0.100000
2025-09-10,Kemper,16,12,12,40,0.300000
2025-09-10,Keurig Dr Pepper,6,31,3,40,0.075000
2025-09-10,KeyCorp,15,19,6,40,0.150000
2025-09-10,Keysight Technologies,22,16,2,40,0.050000
2025-09-10,Kimberly-Clark,13,21,6,40,0.150000
2025-09-10,Kinder Morgan,40,0,0,40,0.000000
2025-09-10,Kirby Corporation,21,18,1,40,0.025000
2025-09-10,Knife River Corporation,21,15,4,40,0.100000
2025-09-10,Knight Swift Transportation,16,19,5,40,0.125000
2025-09-10,Kohls,18,16,6,40,0.150000
2025-09-10,Kontoor Brands,20,17,3,40,0.075000
2025-09-10,Korn Ferry,17,19,4,40,0.100000
2025-09-10,Kraft Heinz,12,17,11,40,0.275000
2025-09-10,Kroger,14,15,11,40,0.275000
2025-09-10,Kyndryl,14,23,3,40,0.075000
2025-09-10,L3Harris Technologies,20,18,2,40,0.050000
2025-09-10,LCI Industries,15,22,3,40,0.075000
2025-09-10,LKQ,11,28,1,40,0.025000
2025-09-10,LPL Financial,27,13,0,40,0.000000
2025-09-10,Labcorp Holdings,19,17,4,40,0.100000
2025-09-10,Lam Research,20,19,1,40,0.025000
2025-09-10,Lamb Weston,13,23,4,40,0.100000
2025-09-10,Land OLakes,9,20,11,40,0.275000
2025-09-10,Landstar System,15,13,12,40,0.300000
2025-09-10,Las Vegas Sands,14,24,2,40,0.050000
2025-09-10,Lear Corporation,22,16,2,40,0.050000
2025-09-10,Leggett & Platt,12,23,5,40,0.125000
2025-09-10,Leidos,21,13,6,40,0.150000
2025-09-10,Lennar,11,26,3,40,0.075000
2025-09-10,Lennox International,19,20,1,40,0.025000
2025-09-10,Levi Strauss,13,26,1,40,0.025000
2025-09-10,Liberty Energy,40,0,0,40,0.000000
2025-09-10,Liberty Media,37,2,1,40,0.025000
2025-09-10,Liberty Mutual Insurance,33,1,6,40,0.150000
2025-09-10,Light & Wonder,7,24,9,40,0.225000
2025-09-10,Lincoln Electric,14,25,1,40,0.025000
2025-09-10,Lincoln National,13,18,9,40,0.225000
2025-09-10,Lithia Motors,14,23,3,40,0.075000
2025-09-10,Live Nation Entertainment,35,3,2,40,0.050000
2025-09-10,Lockheed Martin,13,20,7,40,0.175000
2025-09-10,Loews,17,20,3,40,0.075000
2025-09-10,Louisiana-Pacific Corporation,23,14,3,40,0.075000
2025-09-10,Lowes,13,20,7,40,0.175000
2025-09-10,Lululemon athletica,8,15,17,40,0.425000
2025-09-10,Lumen Technologies,7,24,9,40,0.225000
2025-09-10,Lyft,13,22,5,40,0.125000
2025-09-10,M&T Bank,13,26,1,40,0.025000
2025-09-10,M/I Homes,15,22,3,40,0.075000
2025-09-10,MDU Resources Group,19,19,2,40,0.050000
2025-09-10,MGM Resorts International,11,26,3,40,0.075000
2025-09-10,MKS Instruments,18,21,1,40,0.025000
2025-09-10,MRC Global,17,23,0,40,0.000000
2025-09-10,MSC Industrial Direct,15,21,4,40,0.100000
2025-09-10,MSCI,15,22,3,40,0.075000
2025-09-10,MYR Group,16,22,2,40,0.050000
2025-09-10,Macys,14,21,5,40,0.125000
2025-09-10,ManpowerGroup,17,17,6,40,0.150000
2025-09-10,Marathon Oil,14,24,2,40,0.050000
2025-09-10,Marathon Petroleum,17,20,3,40,0.075000
2025-09-10,Markel Group,18,18,4,40,0.100000
2025-09-10,Marriott International,20,17,3,40,0.075000
2025-09-10,Marriott Vacations Worldwide,18,20,2,40,0.050000
2025-09-10,Marsh & McLennan,19,20,1,40,0.025000
2025-09-10,Martin Marietta Materials,16,16,8,40,0.200000
2025-09-10,Marvell Technology,12,23,5,40,0.125000
2025-09-10,MasTec,18,22,0,40,0.000000
2025-09-10,Masco,19,17,4,40,0.100000
2025-09-10,Mass Mutual,13,22,5,40,0.125000
2025-09-10,MasterBrand,8,31,1,40,0.025000
2025-09-10,Mastercard,19,17,4,40,0.100000
2025-09-10,Matador Resources,16,20,4,40,0.100000
2025-09-10,Match Group,9,18,13,40,0.325000
2025-09-10,Mativ,18,19,3,40,0.075000
2025-09-10,Matson inc,25,13,2,40,0.050000
2025-09-10,Mattel,14,20,6,40,0.150000
2025-09-10,Maximus,14,24,2,40,0.050000
2025-09-10,McCormick & Company,15,22,3,40,0.075000
2025-09-10,McDonalds,14,11,15,40,0.375000
2025-09-10,McKesson,16,22,2,40,0.050000
2025-09-10,Medical Mutual of Ohio,15,20,5,40,0.125000
2025-09-10,Merck,8,18,14,40,0.350000
2025-09-10,Mercury General,13,19,8,40,0.200000
2025-09-10,Meritage Homes,18,20,2,40,0.050000
2025-09-10,MetLife,11,22,7,40,0.175000
2025-09-10,Meta,16,14,10,40,0.250000
2025-09-10,Mettler-Toledo International,23,14,3,40,0.075000
2025-09-10,Microchip Technology,23,15,2,40,0.050000
2025-09-10,Micron Technology,15,21,4,40,0.100000
2025-09-10,Microsoft,7,28,5,40,0.125000
2025-09-10,Middleby,16,20,4,40,0.100000
2025-09-10,MillerKnoll,14,25,1,40,0.025000
2025-09-10,Moderna,10,20,10,40,0.250000
2025-09-10,ModivCare,8,23,9,40,0.225000
2025-09-10,Mohawk Industries,21,15,4,40,0.100000
2025-09-10,Molina Healthcare,13,13,14,40,0.350000
2025-09-10,Molson Coors Beverage,17,14,9,40,0.225000
2025-09-10,Mondelez,10,23,7,40,0.175000
2025-09-10,Monster Beverage,28,10,2,40,0.050000
2025-09-10,Moodys Corporation,3,9,2,14,0.142857
2025-09-10,Moog inc,19,19,2,40,0.050000
2025-09-10,Morgan Stanley,13,20,7,40,0.175000
2025-09-10,Mosaic,17,21,2,40,0.050000
2025-09-10,Motorola Solutions,40,0,0,40,0.000000
2025-09-10,Mueller Industries,21,18,1,40,0.025000
2025-09-10,Murphy Oil,17,21,2,40,0.050000
2025-09-10,Murphy USA,16,22,2,40,0.050000
2025-09-10,Mutual of Omaha,18,17,5,40,0.125000
2025-09-10,NCR Atleos,13,26,1,40,0.025000
2025-09-10,NCR Voyix,13,22,5,40,0.125000
2025-09-10,NGL Energy Partners,38,0,2,40,0.050000
2025-09-10,NLV Financial,4,4,2,10,0.200000
2025-09-10,NOV,11,27,2,40,0.050000
2025-09-10,NRG Energy,37,2,1,40,0.025000
2025-09-10,NVR,20,18,2,40,0.050000
2025-09-10,Nasdaq,19,18,3,40,0.075000
2025-09-10,Nationwide Insurance,8,20,12,40,0.300000
2025-09-10,Navient,17,13,10,40,0.250000
2025-09-10,NetApp,18,20,2,40,0.050000
2025-09-10,Netflix,16,14,10,40,0.250000
2025-09-10,NeueHealth,15,23,2,40,0.050000
2025-09-10,New York Life Insurance,16,22,2,40,0.050000
2025-09-10,NewMarket Corporation,17,20,3,40,0.075000
2025-09-10,Newell Brands,15,20,5,40,0.125000
2025-09-10,Newmont,15,20,5,40,0.125000
2025-09-10,News Corp,22,8,10,40,0.250000
2025-09-10,Nexstar Media Group,18,21,1,40,0.025000
2025-09-10,NextEra Energy,35,3,2,40,0.050000
2025-09-10,NiSource,15,12,13,40,0.325000
2025-09-10,Nike,8,26,6,40,0.150000
2025-09-10,Nordson,20,19,1,40,0.025000
2025-09-10,Nordstrom,17,20,3,40,0.075000
2025-09-10,Norfolk Southern,15,17,8,40,0.200000
2025-09-10,Northern Trust,37,2,1,40,0.025000
2025-09-10,Northrop Grumman,15,19,6,40,0.150000
2025-09-10,Northwestern Mutual,16,13,11,40,0.275000
2025-09-10,Nucor,14,20,6,40,0.150000
2025-09-10,Nvidia,15,20,5,40,0.125000
2025-09-10,O-I Glass,17,19,4,40,0.100000
2025-09-10,ODP Business Solutions,22,17,1,40,0.025000
2025-09-10,OGE Energy,36,2,2,40,0.050000
2025-09-10,ON Semiconductor,11,15,14,40,0.350000
2025-09-10,OReilly Automotive,7,14,7,28,0.250000
2025-09-10,Occidental Petroleum,11,20,9,40,0.225000
2025-09-10,Old Dominion Freight Line,19,15,6,40,0.150000
2025-09-10,Old National Bancorp,14,26,0,40,0.000000
2025-09-10,Old Republic International,21,16,3,40,0.075000
2025-09-10,Olin,11,15,14,40,0.350000
2025-09-10,Omnicom Group,27,11,2,40,0.050000
2025-09-10,OneMain,15,25,0,40,0.000000
2025-09-10,Oneok,23,16,1,40,0.025000
2025-09-10,Opendoor Technologies,12,21,7,40,0.175000
2025-09-10,Option Care Health,40,0,0,40,0.000000
2025-09-10,Oracle,20,17,3,40,0.075000
2025-09-10,Organon,15,18,7,40,0.175000
2025-09-10,Oscar Health,17,13,10,40,0.250000
2025-09-10,Oshkosh Corporation,15,19,6,40,0.150000
2025-09-10,Otis Worldwide,15,22,3,40,0.075000
2025-09-10,Ovintiv,18,15,7,40,0.175000
2025-09-10,Owens & Minor,8,24,8,40,0.200000
2025-09-10,Owens Corning,11,26,3,40,0.075000
2025-09-10,PACS Group,17,7,16,40,0.400000
2025-09-10,PBF Energy,34,1,5,40,0.125000
2025-09-10,PC Connection Inc,18,20,2,40,0.050000
2025-09-10,PENN Entertainment,38,2,0,40,0.000000
2025-09-10,PG&E,16,14,10,40,0.250000
2025-09-10,PNC Financial Services,20,19,1,40,0.025000
2025-09-10,PPG Industries,22,13,5,40,0.125000
2025-09-10,PPL,20,16,4,40,0.100000
2025-09-10,PVH,12,22,6,40,0.150000
2025-09-10,Paccar,16,20,4,40,0.100000
2025-09-10,Pacific Life,18,21,1,40,0.025000
2025-09-10,Packaging Corp of America,10,26,4,40,0.100000
2025-09-10,Palo Alto Networks,14,15,11,40,0.275000
2025-09-10,Par Pacific,21,18,1,40,0.025000
2025-09-10,Paramount Global,7,27,6,40,0.150000
2025-09-10,Park Hotels & Resorts,13,25,2,40,0.050000
2025-09-10,Parker-Hannifin,26,13,1,40,0.025000
2025-09-10,Parsons Corporation,23,14,3,40,0.075000
2025-09-10,Patrick Industries,15,24,1,40,0.025000
2025-09-10,Patterson Companies Inc,11,26,3,40,0.075000
2025-09-10,Patterson-UTI Energy,30,9,1,40,0.025000
2025-09-10,PayPal,14,15,11,40,0.275000
2025-09-10,Paychex,23,11,6,40,0.150000
2025-09-10,Peabody Energy,32,4,4,40,0.100000
2025-09-10,Peloton,24,15,1,40,0.025000
2025-09-10,Penn Mutual Life Insurance,20,17,3,40,0.075000
2025-09-10,PennyMac Financial Services,16,21,3,40,0.075000
2025-09-10,Penske Automotive,16,23,1,40,0.025000
2025-09-10,PepsiCo,19,19,2,40,0.050000
2025-09-10,Performance Food,13,22,5,40,0.125000
2025-09-10,Permian Resources,19,19,2,40,0.050000
2025-09-10,Petco Health and Wellness,37,2,1,40,0.025000
2025-09-10,Peter Kiewit Sons,6,20,14,40,0.350000
2025-09-10,Pfizer,15,18,7,40,0.175000
2025-09-10,Philip Morris,16,18,6,40,0.150000
2025-09-10,Phillips 66,18,18,4,40,0.100000
2025-09-10,Pinnacle West Capital,15,16,9,40,0.225000
2025-09-10,Pinterest,21,16,3,40,0.075000
2025-09-10,Pioneer Natural Resources,19,11,10,40,0.250000
2025-09-10,Pitney Bowes,22,17,1,40,0.025000
2025-09-10,Plains GP,15,13,12,40,0.300000
2025-09-10,Playtika Holding,18,16,6,40,0.150000
2025-09-10,Plexus,6,21,13,40,0.325000
2025-09-10,Polaris Inc,23,14,3,40,0.075000
2025-09-10,Pool Corporation,18,18,4,40,0.100000
2025-09-10,Popular inc,38,1,1,40,0.025000
2025-09-10,Portland General Electric,15,22,3,40,0.075000
2025-09-10,Post Holdings,11,28,1,40,0.025000
2025-09-10,PriceSmart,18,20,2,40,0.050000
2025-09-10,Primerica,17,18,5,40,0.125000
2025-09-10,Primoris Services,20,18,2,40,0.050000
2025-09-10,Principal Financial,18,20,2,40,0.050000
2025-09-10,ProFrac Holding,13,22,5,40,0.125000
2025-09-10,Procter & Gamble,21,12,7,40,0.175000
2025-09-10,Progressive Insurance,14,22,4,40,0.100000
2025-09-10,Prologis,18,20,2,40,0.050000
2025-09-10,Prudential Financial,22,15,3,40,0.075000
2025-09-10,Public Service Enterprise Group,25,14,1,40,0.025000
2025-09-10,Public Storage,16,17,7,40,0.175000
2025-09-10,Publix Super Markets,21,15,4,40,0.100000
2025-09-10,Puget Sound Energy,29,10,1,40,0.025000
2025-09-10,PulteGroup,22,17,1,40,0.025000
2025-09-10,Pure Storage,10,26,4,40,0.100000
2025-09-10,QVC,13,23,4,40,0.100000
2025-09-10,Qorvo,23,15,2,40,0.050000
2025-09-10,Quad/Graphics,13,24,3,40,0.075000
2025-09-10,Qualcomm,11,27,2,40,0.050000
2025-09-10,Quanta Services,26,14,0,40,0.000000
2025-09-10,Quest Diagnostics,14,24,2,40,0.050000
2025-09-10,QuidelOrtho,18,20,2,40,0.050000
2025-09-10,REV Group,14,22,4,40,0.100000
2025-09-10,RPM International,18,21,1,40,0.025000
2025-09-10,RTX,23,15,2,40,0.050000
2025-09-10,RXO inc,16,18,6,40,0.150000
2025-09-10,Rackspace Technology,12,23,5,40,0.125000
2025-09-10,Radius Recycling,5,21,14,40,0.350000
2025-09-10,Ralph Lauren,12,26,2,40,0.050000
2025-09-10,Range Resources,19,19,2,40,0.050000
2025-09-10,Raymond James Financial,23,15,2,40,0.050000
2025-09-10,Realty Income,22,13,5,40,0.125000
2025-09-10,Regal Rexnord,15,22,3,40,0.075000
2025-09-10,Regeneron Pharmaceuticals,23,14,3,40,0.075000
2025-09-10,Regions Financial,18,20,2,40,0.050000
2025-09-10,Reinsurance Group of America,20,18,2,40,0.050000
2025-09-10,Reliance Inc,21,15,4,40,0.100000
2025-09-10,Republic Services,10,12,18,40,0.450000
2025-09-10,ResMed,17,22,1,40,0.025000
2025-09-10,Resideo Technologies,22,16,2,40,0.050000
2025-09-10,Restoration Hardware,14,22,4,40,0.100000
2025-09-10,Revvity,20,15,5,40,0.125000
2025-09-10,Rite Aid,5,28,7,40,0.175000
2025-09-10,Rithm Capital,14,26,0,40,0.000000
2025-09-10,Rivian Automotive,7,27,6,40,0.150000
2025-09-10,Robert Half,19,19,2,40,0.050000
2025-09-10,Roblox,15,18,7,40,0.175000
2025-09-10,Rocket Companies,16,21,3,40,0.075000
2025-09-10,Rockwell Automation,22,18,0,40,0.000000
2025-09-10,Roku,22,17,1,40,0.025000
2025-09-10,Rollins inc,16,24,0,40,0.000000
2025-09-10,Roper Technologies,20,19,1,40,0.025000
2025-09-10,Ross Stores,20,16,4,40,0.100000
2025-09-10,Rush Enterprises,15,22,3,40,0.075000
2025-09-10,Ryder System,18,18,4,40,0.100000
2025-09-10,Ryerson Holding,15,16,9,40,0.225000
2025-09-10,S&P Global,11,21,8,40,0.200000
2025-09-10,SBA Communications,20,14,6,40,0.150000
2025-09-10,SS&C Technologies,19,19,2,40,0.050000
2025-09-10,Sabre Corporation,16,18,6,40,0.150000
2025-09-10,Saia inc,21,14,5,40,0.125000
2025-09-10,Salesforce,18,11,11,40,0.275000
2025-09-10,Sallie Mae,12,24,4,40,0.100000
2025-09-10,Sally Beauty,39,1,0,40,0.000000
2025-09-10,Sanmina,18,19,3,40,0.075000
2025-09-10,ScanSource,23,15,2,40,0.050000
2025-09-10,Schneider National,13,22,5,40,0.125000
2025-09-10,Science Applications International,17,19,4,40,0.100000
2025-09-10,Scotts Miracle-Gro,15,19,6,40,0.150000
2025-09-10,Seaboard,12,17,11,40,0.275000
2025-09-10,Sealed Air Corporation,14,26,0,40,0.000000
2025-09-10,Securian Financial,12,24,4,40,0.100000
2025-09-10,Select Medical,16,17,7,40,0.175000
2025-09-10,Selective Insurance Group,16,15,9,40,0.225000
2025-09-10,Sempra,29,11,0,40,0.000000
2025-09-10,Sentry Insurance Group,3,7,0,10,0.000000
2025-09-10,Service Corp International,8,10,8,26,0.307692
2025-09-10,ServiceNow,20,13,7,40,0.175000
2025-09-10,Sherwin-Williams,7,27,6,40,0.150000
2025-09-10,Shift4 Payments,12,22,6,40,0.150000
2025-09-10,Silgan,9,24,7,40,0.175000
2025-09-10,Simon Property Group,12,26,2,40,0.050000
2025-09-10,Sinclair,11,25,4,40,0.100000
2025-09-10,SiteOne Landscape Supply,15,19,6,40,0.150000
2025-09-10,Skechers USA,15,23,2,40,0.050000
2025-09-10,SkyWest,14,17,9,40,0.225000
2025-09-10,Skyline Champion,34,4,2,40,0.050000
2025-09-10,Skyworks Solutions,33,4,3,40,0.075000
2025-09-10,Smurfit Westrock,9,26,5,40,0.125000
2025-09-10,Snap Inc,16,11,13,40,0.325000
2025-09-10,Snap-on,7,28,5,40,0.125000
2025-09-10,Snowflake inc,26,13,1,40,0.025000
2025-09-10,Sonic Automotive,13,26,1,40,0.025000
2025-09-10,Sonoco Products,17,19,4,40,0.100000
2025-09-10,Southern Company,22,15,3,40,0.075000
2025-09-10,Southwest Airlines,13,25,2,40,0.050000
2025-09-10,Southwest Gas,20,18,2,40,0.050000
2025-09-10,Southwestern Energy,35,3,2,40,0.050000
2025-09-10,SpartanNash,14,24,2,40,0.050000
2025-09-10,Spectrum Brands,15,16,9,40,0.225000
2025-09-10,Spire inc,18,21,1,40,0.025000
2025-09-10,Spirit AeroSystems,32,1,7,40,0.175000
2025-09-10,Spirit Airlines,22,5,13,40,0.325000
2025-09-10,Splunk,16,22,2,40,0.050000
2025-09-10,Sprouts Farmers Market,8,30,2,40,0.050000
2025-09-10,Stagwell,13,22,5,40,0.125000
2025-09-10,Stanley Black & Decker,20,16,4,40,0.100000
2025-09-10,Starbucks,12,24,4,40,0.100000
2025-09-10,State Farm Insurance,11,20,9,40,0.225000
2025-09-10,State Street,15,15,10,40,0.250000
2025-09-10,Steel Dynamics,37,3,0,40,0.000000
2025-09-10,Steelcase,13,25,2,40,0.050000
2025-09-10,Stericycle,10,9,21,40,0.525000
2025-09-10,Stifel Financial,21,17,2,40,0.050000
2025-09-10,StoneX,15,23,2,40,0.050000
2025-09-10,Stryker,10,23,7,40,0.175000
2025-09-10,Summit Materials,12,24,4,40,0.100000
2025-09-10,Sun Communities,24,15,1,40,0.025000
2025-09-10,Super Micro Computer,36,3,1,40,0.025000
2025-09-10,Surgery Partners,13,22,5,40,0.125000
2025-09-10,Sylvamo,14,16,10,40,0.250000
2025-09-10,Synchrony Financial,25,15,0,40,0.000000
2025-09-10,Synopsys,6,15,19,40,0.475000
2025-09-10,Synovus Financial,12,22,6,40,0.150000
2025-09-10,Sysco,21,14,5,40,0.125000
2025-09-10,T Rowe Price,18,22,0,40,0.000000
2025-09-10,TD Synnex,27,13,0,40,0.000000
2025-09-10,TEGNA,11,26,3,40,0.075000
2025-09-10,TIAA,15,22,3,40,0.075000
2025-09-10,TJX,21,14,5,40,0.125000
2025-09-10,Talen Energy,36,3,1,40,0.025000
2025-09-10,Tapestry,19,18,3,40,0.075000
2025-09-10,Targa Resources,28,8,4,40,0.100000
2025-09-10,Target,12,20,8,40,0.200000
2025-09-10,Taylor Morrison Home,17,23,0,40,0.000000
2025-09-10,Teladoc Health,19,17,4,40,0.100000
2025-09-10,Teledyne Technologies,17,23,0,40,0.000000
2025-09-10,Teleflex,16,23,1,40,0.025000
2025-09-10,Telephone & Data Systems,14,20,6,40,0.150000
2025-09-10,TelevisaUnivision,11,15,14,40,0.350000
2025-09-10,Tempur Sealy International,10,24,6,40,0.150000
2025-09-10,Tenet Healthcare,16,22,2,40,0.050000
2025-09-10,Teradyne,18,20,2,40,0.050000
2025-09-10,Terex,15,22,3,40,0.075000
2025-09-10,Tesla,10,21,9,40,0.225000
2025-09-10,Tetra Tech,22,15,3,40,0.075000
2025-09-10,Texas Instruments,10,18,12,40,0.300000
2025-09-10,Texas Roadhouse,11,23,6,40,0.150000
2025-09-10,Textron,20,18,2,40,0.050000
2025-09-10,The Andersons Inc,19,21,0,40,0.000000
2025-09-10,The Coca-Cola Company,13,24,3,40,0.075000
2025-09-10,The Hartford,13,13,14,40,0.350000
2025-09-10,Thermo Fisher Scientific,18,19,3,40,0.075000
2025-09-10,Thor Industries,10,20,10,40,0.250000
2025-09-10,Thrivent Financial for Lutherans,14,20,6,40,0.150000
2025-09-10,Timken,11,26,3,40,0.075000
2025-09-10,Titan Machinery,11,23,6,40,0.150000
2025-09-10,Toast inc,23,12,5,40,0.125000
2025-09-10,Toll Brothers,10,28,2,40,0.050000
2025-09-10,TopBuild,19,20,1,40,0.025000
2025-09-10,Topgolf Callaway Brands,12,23,5,40,0.125000
2025-09-10,Toro Company,13,27,0,40,0.000000
2025-09-10,Tractor Supply,17,18,5,40,0.125000
2025-09-10,TransDigm,19,15,6,40,0.150000
2025-09-10,TransUnion,17,15,8,40,0.200000
2025-09-10,Travelers Insurance,12,18,10,40,0.250000
2025-09-10,TreeHouse Foods,10,23,7,40,0.175000
2025-09-10,Tri Pointe Homes,13,25,2,40,0.050000
2025-09-10,TriNet Group,23,15,2,40,0.050000
2025-09-10,Trimble,8,25,7,40,0.175000
2025-09-10,Trinity Industries,16,18,6,40,0.150000
2025-09-10,TruStage,26,13,1,40,0.025000
2025-09-10,Truist Financial,17,20,3,40,0.075000
2025-09-10,Tutor Perini Corporation,22,16,2,40,0.050000
2025-09-10,Twilio,21,15,4,40,0.100000
2025-09-10,Tyson Foods,13,18,9,40,0.225000
2025-09-10,U-Haul,4,6,30,40,0.750000
2025-09-10,UFP Industries,15,22,3,40,0.075000
2025-09-10,UGI Utilities Inc,18,14,8,40,0.200000
2025-09-10,UL Solutions,35,2,3,40,0.075000
2025-09-10,UPS,15,14,11,40,0.275000
2025-09-10,US Bancorp,18,22,0,40,0.000000
2025-09-10,US Foods,20,17,3,40,0.075000
2025-09-10,USAA,18,13,9,40,0.225000
2025-09-10,Uber,6,24,10,40,0.250000
2025-09-10,Ulta Beauty,34,2,4,40,0.100000
2025-09-10,Under Armour,13,25,2,40,0.050000
2025-09-10,Union Pacific,14,20,6,40,0.150000
2025-09-10,United Airlines,34,2,4,40,0.100000
2025-09-10,United Natural Foods,38,1,1,40,0.025000
2025-09-10,United Rentals,39,1,0,40,0.000000
2025-09-10,United States Steel,22,13,5,40,0.125000
2025-09-10,UnitedHealth,9,25,6,40,0.150000
2025-09-10,Universal Corporation,14,25,1,40,0.025000
2025-09-10,Universal Health Services,17,18,5,40,0.125000
2025-09-10,Unum Group,15,21,4,40,0.100000
2025-09-10,Upbound Group,28,12,0,40,0.000000
2025-09-10,Urban Outfitters,16,23,1,40,0.025000
2025-09-10,V2X,22,16,2,40,0.050000
2025-09-10,VF Corporation,10,26,4,40,0.100000
2025-09-10,VICI Properties,20,18,2,40,0.050000
2025-09-10,Vail Resorts,12,11,17,40,0.425000
2025-09-10,Valero Energy,33,3,4,40,0.100000
2025-09-10,Valley National Bancorp,12,21,7,40,0.175000
2025-09-10,Valmont Industries,23,14,3,40,0.075000
2025-09-10,Valvoline inc,13,25,2,40,0.050000
2025-09-10,Ventas inc,27,13,0,40,0.000000
2025-09-10,Verisk Analytics,20,14,6,40,0.150000
2025-09-10,Verizon,16,20,4,40,0.100000
2025-09-10,Vertex Pharmaceuticals,22,15,3,40,0.075000
2025-09-10,Vertiv,23,14,3,40,0.075000
2025-09-10,Viasat,20,17,3,40,0.075000
2025-09-10,Viatris,11,19,10,40,0.250000
2025-09-10,Victorias Secret,14,18,8,40,0.200000
2025-09-10,Visa,6,23,11,40,0.275000
2025-09-10,Vishay Intertechnology,13,20,7,40,0.175000
2025-09-10,Vista Outdoor,16,20,4,40,0.100000
2025-09-10,Visteon,16,22,2,40,0.050000
2025-09-10,Vistra,22,15,3,40,0.075000
2025-09-10,Vontier,18,19,3,40,0.075000
2025-09-10,Voya Financial,19,18,3,40,0.075000
2025-09-10,Vulcan Materials,12,21,7,40,0.175000
2025-09-10,WEC Energy,38,0,2,40,0.050000
2025-09-10,WESCO International,17,22,1,40,0.025000
2025-09-10,WEX,17,19,4,40,0.100000
2025-09-10,WR Berkley,14,24,2,40,0.050000
2025-09-10,WW Grainger,18,16,6,40,0.150000
2025-09-10,Wabash National,16,12,12,40,0.300000
2025-09-10,Walgreens,8,24,8,40,0.200000
2025-09-10,Walmart,16,14,10,40,0.250000
2025-09-10,Walt Disney,16,17,7,40,0.175000
2025-09-10,Warner Bros Discovery,8,20,12,40,0.300000
2025-09-10,Waters Corporation,22,15,3,40,0.075000
2025-09-10,Watsco,11,21,8,40,0.200000
2025-09-10,Wayfair,21,18,1,40,0.025000
2025-09-10,Webster Financial,17,20,3,40,0.075000
2025-09-10,Weis Markets,11,23,6,40,0.150000
2025-09-10,Wells Fargo,32,3,5,40,0.125000
2025-09-10,Welltower,28,11,1,40,0.025000
2025-09-10,Werner Enterprises,20,14,6,40,0.150000
2025-09-10,West Pharmaceutical Services,17,19,4,40,0.100000
2025-09-10,Western & Southern Financial,14,22,4,40,0.100000
2025-09-10,Western Alliance Bancorp,15,17,8,40,0.200000
2025-09-10,Western Digital,16,23,1,40,0.025000
2025-09-10,Western Midstream Partners,20,19,1,40,0.025000
2025-09-10,Western Union,13,24,3,40,0.075000
2025-09-10,Westinghouse Air Brake Technologies,15,19,6,40,0.150000
2025-09-10,Westlake Corporation,10,23,7,40,0.175000
2025-09-10,Weyerhaeuser,20,18,2,40,0.050000
2025-09-10,Whirlpool,11,21,8,40,0.200000
2025-09-10,Williams,12,22,6,40,0.150000
2025-09-10,Williams-Sonoma,14,22,4,40,0.100000
2025-09-10,Winnebago Industries,12,25,3,40,0.075000
2025-09-10,Wintrust Financial,18,21,1,40,0.025000
2025-09-10,Woodward inc,20,20,0,40,0.000000
2025-09-10,Workday,10,19,11,40,0.275000
2025-09-10,World Kinect,19,16,5,40,0.125000
2025-09-10,Worthington Enterprises,17,23,0,40,0.000000
2025-09-10,Wynn Resorts,12,21,7,40,0.175000
2025-09-10,XPO,16,20,4,40,0.100000
2025-09-10,Xcel Energy,32,7,1,40,0.025000
2025-09-10,Xerox,13,23,4,40,0.100000
2025-09-10,Xylem Inc,24,15,1,40,0.025000
2025-09-10,Yum Brands,10,28,2,40,0.050000
2025-09-10,Yum China,18,19,3,40,0.075000
2025-09-10,Zebra Technologies,22,15,3,40,0.075000
2025-09-10,Zimmer Biomet,18,21,1,40,0.025000
2025-09-10,Zions Bancorp,18,18,4,40,0.100000
2025-09-10,Zoetis,24,16,0,40,0.000000
2025-09-10,Zoom Video Communications,12,23,5,40,0.125000
2025-09-10,eXp World,18,19,3,40,0.075000
2025-09-10,iHeartMedia,13,25,2,40,0.050000
2025-09-11,3M,17,20,3,40,0.075000
2025-09-11,A O Smith,15,24,1,40,0.025000
2025-09-11,A-Mark Precious Metals,38,2,0,40,0.000000
2025-09-11,ABM Industries,10,20,10,40,0.250000
2025-09-11,ADT,12,21,7,40,0.175000
2025-09-11,AECOM,25,14,1,40,0.025000
2025-09-11,AES,16,17,7,40,0.175000
2025-09-11,AGCO,18,19,3,40,0.075000
2025-09-11,AGNC Investment,16,19,5,40,0.125000
2025-09-11,AMC Entertainment,36,1,3,40,0.075000
2025-09-11,AMC Networks,12,19,9,40,0.225000
2025-09-11,AMN Healthcare Services,11,22,7,40,0.175000
2025-09-11,APA,14,22,4,40,0.100000
2025-09-11,APi Group,22,15,3,40,0.075000
2025-09-11,ARKO,9,29,2,40,0.050000
2025-09-11,ASGN,11,20,9,40,0.225000
2025-09-11,AT&T,14,22,4,40,0.100000
2025-09-11,ATI inc,18,20,2,40,0.050000
2025-09-11,AbbVie,21,12,7,40,0.175000
2025-09-11,Abbott Laboratories,21,12,7,40,0.175000
2025-09-11,Abercrombie & Fitch,13,25,2,40,0.050000
2025-09-11,Academy Sports and Outdoors,12,25,3,40,0.075000
2025-09-11,Acadia Healthcare,9,22,9,40,0.225000
2025-09-11,Acuity Inc,21,18,1,40,0.025000
2025-09-11,Adams Resources & Energy,16,7,2,25,0.080000
2025-09-11,AdaptHealth,17,20,3,40,0.075000
2025-09-11,Adobe,7,27,6,40,0.150000
2025-09-11,Advance Auto Parts,8,21,11,40,0.275000
2025-09-11,Advanced Drainage Systems,35,4,1,40,0.025000
2025-09-11,Advanced Micro Devices,29,5,6,40,0.150000
2025-09-11,Advantage Solutions,36,0,4,40,0.100000
2025-09-11,Aflac,11,14,15,40,0.375000
2025-09-11,Agilent Technologies,18,21,1,40,0.025000
2025-09-11,Agilon Health,13,20,7,40,0.175000
2025-09-11,Air Lease,10,28,2,40,0.050000
2025-09-11,Air Products & Chemicals,14,20,6,40,0.150000
2025-09-11,Airbnb,15,19,6,40,0.150000
2025-09-11,Akamai Technologies,17,21,2,40,0.050000
2025-09-11,Alaska Air,7,30,3,40,0.075000
2025-09-11,Albemarle Corporation,14,23,3,40,0.075000
2025-09-11,Albertsons,13,25,2,40,0.050000
2025-09-11,Alcoa Corporation,8,26,6,40,0.150000
2025-09-11,Alexandria Real Estate Equities,16,20,4,40,0.100000
2025-09-11,Alight Solutions,12,24,4,40,0.100000
2025-09-11,Align Technology,7,21,12,40,0.300000
2025-09-11,Allegiant Travel Company,15,23,2,40,0.050000
2025-09-11,Alliance Resource Partners,12,18,10,40,0.250000
2025-09-11,Alliant Energy,34,3,3,40,0.075000
2025-09-11,Allison Transmission,15,19,6,40,0.150000
2025-09-11,Allstate,23,12,5,40,0.125000
2025-09-11,Ally Financial,16,23,1,40,0.025000
2025-09-11,Alpha Metallurgical Resources,17,16,7,40,0.175000
2025-09-11,Alphabet,22,13,5,40,0.125000
2025-09-11,Altice,16,19,5,40,0.125000
2025-09-11,Altria Group,18,19,3,40,0.075000
2025-09-11,Amazon,34,3,3,40,0.075000
2025-09-11,Ameren,18,20,2,40,0.050000
2025-09-11,American Airlines,15,13,12,40,0.300000
2025-09-11,American Axle & Manufacturing,11,27,2,40,0.050000
2025-09-11,American Eagle Outfitters,15,19,6,40,0.150000
2025-09-11,American Electric Power,19,17,4,40,0.100000
2025-09-11,American Express,19,18,3,40,0.075000
2025-09-11,American Family Insurance,21,15,4,40,0.100000
2025-09-11,American Financial,20,17,3,40,0.075000
2025-09-11,American International Group,18,20,2,40,0.050000
2025-09-11,American Tower,22,15,3,40,0.075000
2025-09-11,American Water Works,21,15,4,40,0.100000
2025-09-11,Americold Realty Trust,35,2,3,40,0.075000
2025-09-11,Ameriprise Financial,25,11,4,40,0.100000
2025-09-11,Ametek,24,16,0,40,0.000000
2025-09-11,Amgen,18,20,2,40,0.050000
2025-09-11,Amica Mutual Insurance,12,26,2,40,0.050000
2025-09-11,Amkor Technology,11,28,1,40,0.025000
2025-09-11,Amphenol,24,16,0,40,0.000000
2025-09-11,Analog Devices,15,23,2,40,0.050000
2025-09-11,Antero Resources,14,25,1,40,0.025000
2025-09-11,Anywhere Real Estate Inc,19,18,3,40,0.075000
2025-09-11,Apollo Global Management,16,23,1,40,0.025000
2025-09-11,AppLovin,8,29,3,40,0.075000
2025-09-11,Apple,10,27,3,40,0.075000
2025-09-11,Applied Industrial Technologies,17,23,0,40,0.000000
2025-09-11,Applied Materials,6,16,18,40,0.450000
2025-09-11,AptarGroup,19,19,2,40,0.050000
2025-09-11,Aramark,19,18,3,40,0.075000
2025-09-11,ArcBest,13,22,5,40,0.125000
2025-09-11,Arch Resources,30,5,5,40,0.125000
2025-09-11,Archer Daniels Midland,22,17,1,40,0.025000
2025-09-11,Ares Management,21,18,1,40,0.025000
2025-09-11,Arista Networks,20,20,0,40,0.000000
2025-09-11,Arrow Electronics,20,14,6,40,0.150000
2025-09-11,Arthur J Gallagher,14,24,2,40,0.050000
2025-09-11,Asbury Automotive Group,13,23,4,40,0.100000
2025-09-11,Assurant,26,9,5,40,0.125000
2025-09-11,Atkore,16,21,3,40,0.075000
2025-09-11,Atlassian,16,18,6,40,0.150000
2025-09-11,Atmos Energy,37,2,1,40,0.025000
2025-09-11,Auto-Owners Insurance,16,19,5,40,0.125000
2025-09-11,AutoNation,20,16,4,40,0.100000
2025-09-11,AutoZone,8,20,12,40,0.300000
2025-09-11,Autodesk,20,20,0,40,0.000000
2025-09-11,Autoliv,23,15,2,40,0.050000
2025-09-11,Automatic Data Processing,20,20,0,40,0.000000
2025-09-11,AvalonBay Communities,15,22,3,40,0.075000
2025-09-11,Avantor,13,19,8,40,0.200000
2025-09-11,Avery Dennison,13,26,1,40,0.025000
2025-09-11,Avient,13,24,3,40,0.075000
2025-09-11,Avis Budget,9,25,6,40,0.150000
2025-09-11,Avnet,14,24,2,40,0.050000
2025-09-11,BJs Wholesale Club,9,23,8,40,0.200000
2025-09-11,BOK Financial,23,12,5,40,0.125000
2025-09-11,BWX Technologies,25,14,1,40,0.025000
2025-09-11,Baker Hughes,9,27,4,40,0.100000
2025-09-11,Ball,14,18,8,40,0.200000
2025-09-11,Bank of America,17,19,4,40,0.100000
2025-09-11,Bank of New York Mellon,26,11,3,40,0.075000
2025-09-11,Bath & Body Works,10,17,13,40,0.325000
2025-09-11,Baxter International,12,21,7,40,0.175000
2025-09-11,Beacon Roofing Supply,7,24,9,40,0.225000
2025-09-11,Becton Dickinson,17,19,4,40,0.100000
2025-09-11,Belden,10,24,6,40,0.150000
2025-09-11,Benchmark Electronics,19,17,4,40,0.100000
2025-09-11,Berkshire Hathaway,16,15,9,40,0.225000
2025-09-11,Best Buy,25,3,12,40,0.300000
2025-09-11,Big Lots,6,31,3,40,0.075000
2025-09-11,Bio-Rad Laboratories,19,19,2,40,0.050000
2025-09-11,Biogen,14,26,0,40,0.000000
2025-09-11,BlackRock,12,25,3,40,0.075000
2025-09-11,Blackstone,12,27,1,40,0.025000
2025-09-11,Bloomin Brands,7,26,7,40,0.175000
2025-09-11,BlueLinx,16,19,5,40,0.125000
2025-09-11,Boeing,11,24,5,40,0.125000
2025-09-11,Boise Cascade,9,19,12,40,0.300000
2025-09-11,Booking Holdings,26,14,0,40,0.000000
2025-09-11,Booz Allen Hamilton,20,15,5,40,0.125000
2025-09-11,BorgWarner,19,19,2,40,0.050000
2025-09-11,Boston Properties,12,21,7,40,0.175000
2025-09-11,Boston Scientific,11,26,3,40,0.075000
2025-09-11,Boyd Gaming,13,26,1,40,0.025000
2025-09-11,Bread Financial,21,15,4,40,0.100000
2025-09-11,BrightSpring Health Services,16,20,4,40,0.100000
2025-09-11,BrightView Holdings,19,17,4,40,0.100000
2025-09-11,Brighthouse Financial,14,24,2,40,0.050000
2025-09-11,Brinker International,20,20,0,40,0.000000
2025-09-11,Brinks Company,9,3,5,17,0.294118
2025-09-11,Bristol-Myers Squibb,11,25,4,40,0.100000
2025-09-11,Broadcom,23,13,4,40,0.100000
2025-09-11,Broadridge Financial Solutions,32,7,1,40,0.025000
2025-09-11,Brookdale Senior Living,12,20,8,40,0.200000
2025-09-11,Brown & Brown,16,18,6,40,0.150000
2025-09-11,Brown-Forman,8,24,8,40,0.200000
2025-09-11,Bruker,12,20,8,40,0.200000
2025-09-11,Brunswick,5,24,11,40,0.275000
2025-09-11,Builders FirstSource,24,15,1,40,0.025000
2025-09-11,Burlington Stores,20,18,2,40,0.050000
2025-09-11,CACI International,21,15,4,40,0.100000
2025-09-11,CBRE Group,18,21,1,40,0.025000
2025-09-11,CDW,19,19,2,40,0.050000
2025-09-11,CF Industries,26,14,0,40,0.000000
2025-09-11,CH Robinson Worldwide,19,16,5,40,0.125000
2025-09-11,CHS,14,22,4,40,0.100000
2025-09-11,CME Group,20,16,4,40,0.100000
2025-09-11,CMS Energy,39,1,0,40,0.000000
2025-09-11,CNO Financial Group,17,20,3,40,0.075000
2025-09-11,CNX Resources,19,19,2,40,0.050000
2025-09-11,CSX,15,18,7,40,0.175000
2025-09-11,CVS Health,17,18,5,40,0.125000
2025-09-11,Cabot Corporation,18,21,1,40,0.025000
2025-09-11,Cadence,10,24,6,40,0.150000
2025-09-11,Caesars Entertainment,33,7,0,40,0.000000
2025-09-11,Cal-Maine Foods,30,9,1,40,0.025000
2025-09-11,Caleres inc,23,12,5,40,0.125000
2025-09-11,California Resources,16,21,3,40,0.075000
2025-09-11,Calumet,4,16,20,40,0.500000
2025-09-11,Campbell Soup,15,22,3,40,0.075000
2025-09-11,Camping World,12,22,6,40,0.150000
2025-09-11,Capital One,18,17,5,40,0.125000
2025-09-11,CarMax,6,30,4,40,0.100000
2025-09-11,Cardinal Health,18,16,6,40,0.150000
2025-09-11,Carlisle Companies,17,16,7,40,0.175000
2025-09-11,Carlyle Group,9,28,3,40,0.075000
2025-09-11,Carpenter Technology,15,22,3,40,0.075000
2025-09-11,Carrier Global,21,17,2,40,0.050000
2025-09-11,Carters inc,10,22,2,34,0.058824
2025-09-11,Carvana,24,12,4,40,0.100000
2025-09-11,Caseys General Stores,15,20,5,40,0.125000
2025-09-11,Catalent,11,26,3,40,0.075000
2025-09-11,Caterpillar,18,17,5,40,0.125000
2025-09-11,Cboe Global Markets,13,25,2,40,0.050000
2025-09-11,Celanese,12,19,9,40,0.225000
2025-09-11,Cencora,23,10,7,40,0.175000
2025-09-11,Centene,16,13,11,40,0.275000
2025-09-11,CenterPoint Energy,24,8,8,40,0.200000
2025-09-11,Central Garden & Pet,5,35,0,40,0.000000
2025-09-11,Century Communities,12,24,4,40,0.100000
2025-09-11,ChampionX,22,18,0,40,0.000000
2025-09-11,Charles River Laboratories International,13,20,7,40,0.175000
2025-09-11,Charles Schwab,14,19,7,40,0.175000
2025-09-11,Chart Industries,13,24,3,40,0.075000
2025-09-11,Charter Communications,10,20,10,40,0.250000
2025-09-11,Cheesecake Factory,14,18,8,40,0.200000
2025-09-11,Chefs Warehouse,17,19,4,40,0.100000
2025-09-11,Chemours,13,14,13,40,0.325000
2025-09-11,Cheniere Energy,38,2,0,40,0.000000
2025-09-11,Chevron,21,15,4,40,0.100000
2025-09-11,Chewy,14,20,6,40,0.150000
2025-09-11,Chipotle Mexican Grill,17,21,2,40,0.050000
2025-09-11,Chord Energy,36,1,3,40,0.075000
2025-09-11,Church & Dwight,12,28,0,40,0.000000
2025-09-11,Ciena,21,17,2,40,0.050000
2025-09-11,Cigna,18,18,4,40,0.100000
2025-09-11,Cincinnati Financial,15,20,5,40,0.125000
2025-09-11,Cinemark,7,27,6,40,0.150000
2025-09-11,Cintas,23,15,2,40,0.050000
2025-09-11,Cisco Systems,13,23,4,40,0.100000
2025-09-11,Citigroup,13,23,4,40,0.100000
2025-09-11,Citizens Financial Group,13,26,1,40,0.025000
2025-09-11,Civitas Resources,13,18,9,40,0.225000
2025-09-11,Clean Harbors,32,2,6,40,0.150000
2025-09-11,Clear Channel Outdoor Hldgs,11,0,1,12,0.083333
2025-09-11,Cleveland-Cliffs,15,17,8,40,0.200000
2025-09-11,Clorox,14,17,9,40,0.225000
2025-09-11,Cognizant Technology Solutions,38,0,2,40,0.050000
2025-09-11,Coherent,21,16,3,40,0.075000
2025-09-11,Coinbase Global,13,22,5,40,0.125000
2025-09-11,Colgate-Palmolive,16,15,9,40,0.225000
2025-09-11,Columbia Banking System,11,28,1,40,0.025000
2025-09-11,Columbia Sportswear,8,20,12,40,0.300000
2025-09-11,Comcast,23,12,5,40,0.125000
2025-09-11,Comerica,23,13,4,40,0.100000
2025-09-11,Comfort Systems USA,39,1,0,40,0.000000
2025-09-11,CommScope,15,24,1,40,0.025000
2025-09-11,Commercial Metals,10,20,10,40,0.250000
2025-09-11,Community Health Systems,16,17,7,40,0.175000
2025-09-11,Compass,14,20,6,40,0.150000
2025-09-11,Conagra Brands,19,21,0,40,0.000000
2025-09-11,Concentrix,16,20,4,40,0.100000
2025-09-11,Conduent,14,19,7,40,0.175000
2025-09-11,ConocoPhillips,11,19,10,40,0.250000
2025-09-11,Consol Energy,32,5,3,40,0.075000
2025-09-11,Consolidated Edison,12,22,6,40,0.150000
2025-09-11,Constellation Brands,9,13,18,40,0.450000
2025-09-11,Constellation Energy,32,3,5,40,0.125000
2025-09-11,Continental Resources,19,13,8,40,0.200000
2025-09-11,Cooper Cos,6,30,4,40,0.100000
2025-09-11,Cooper-Standard,9,29,2,40,0.050000
2025-09-11,Copart,16,20,4,40,0.100000
2025-09-11,Core & Main,10,21,9,40,0.225000
2025-09-11,Cornerstone Building Brands,15,19,6,40,0.150000
2025-09-11,Corning,15,20,5,40,0.125000
2025-09-11,Corpay,20,20,0,40,0.000000
2025-09-11,Corteva,16,20,4,40,0.100000
2025-09-11,Costco,18,15,7,40,0.175000
2025-09-11,Coterra Energy,37,2,1,40,0.025000
2025-09-11,Coty,12,19,9,40,0.225000
2025-09-11,Country Financial,17,21,2,40,0.050000
2025-09-11,Coupang,16,12,12,40,0.300000
2025-09-11,Cracker Barrel Old Country Store,3,28,9,40,0.225000
2025-09-11,Crocs,9,27,4,40,0.100000
2025-09-11,CrossAmerica Partners,14,25,1,40,0.025000
2025-09-11,CrowdStrike,20,7,13,40,0.325000
2025-09-11,Crown Castle,17,23,0,40,0.000000
2025-09-11,Crown Holdings,20,17,3,40,0.075000
2025-09-11,Cullen Frost Bankers,15,20,5,40,0.125000
2025-09-11,Cummins,10,21,9,40,0.225000
2025-09-11,Curtiss-Wright,25,15,0,40,0.000000
2025-09-11,DR Horton,12,21,7,40,0.175000
2025-09-11,DTE Energy,32,3,5,40,0.125000
2025-09-11,DXC Technology,21,18,1,40,0.025000
2025-09-11,DaVita,16,12,12,40,0.300000
2025-09-11,Dana Incorporated,18,17,5,40,0.125000
2025-09-11,Danaher,13,24,3,40,0.075000
2025-09-11,Darden Restaurants,24,13,3,40,0.075000
2025-09-11,Darling Ingredients,39,0,1,40,0.025000
2025-09-11,Deckers Outdoor,26,13,1,40,0.025000
2025-09-11,Deere,7,22,11,40,0.275000
2025-09-11,Delek US,25,12,3,40,0.075000
2025-09-11,Dell Technologies,12,17,11,40,0.275000
2025-09-11,Delta Air Lines,5,21,14,40,0.350000
2025-09-11,Dentsply Sirona,11,28,1,40,0.025000
2025-09-11,Designer Brands,10,26,4,40,0.100000
2025-09-11,Devon Energy,37,0,3,40,0.075000
2025-09-11,DexCom,15,21,4,40,0.100000
2025-09-11,Diamondback Energy,36,1,3,40,0.075000
2025-09-11,Dicks Sporting Goods,13,26,1,40,0.025000
2025-09-11,Diebold Nixdorf,17,23,0,40,0.000000
2025-09-11,Digital Realty Trust,35,5,0,40,0.000000
2025-09-11,Dillards,14,17,9,40,0.225000
2025-09-11,DocuSign,21,17,2,40,0.050000
2025-09-11,Dollar General,6,18,16,40,0.400000
2025-09-11,Dollar Tree,22,14,4,40,0.100000
2025-09-11,Dominion Energy,27,9,4,40,0.100000
2025-09-11,Dominos Pizza inc,14,18,6,38,0.157895
2025-09-11,Domtar,10,23,7,40,0.175000
2025-09-11,Donaldson Company,26,13,1,40,0.025000
2025-09-11,DoorDash,18,16,6,40,0.150000
2025-09-11,Dover Corporation,25,11,4,40,0.100000
2025-09-11,DraftKings,31,8,1,40,0.025000
2025-09-11,Dream Finders Homes,37,1,2,40,0.050000
2025-09-11,Dropbox,22,15,3,40,0.075000
2025-09-11,DuPont,15,16,9,40,0.225000
2025-09-11,Duke Energy,36,2,2,40,0.050000
2025-09-11,Dycom Industries,20,15,5,40,0.125000
2025-09-11,EMCOR Group,15,24,1,40,0.025000
2025-09-11,EOG Resources,21,18,1,40,0.025000
2025-09-11,EPAM Systems,21,16,3,40,0.075000
2025-09-11,EQT,20,20,0,40,0.000000
2025-09-11,ESAB,13,24,3,40,0.075000
2025-09-11,East West Bancorp,18,22,0,40,0.000000
2025-09-11,Eastman Chemical,13,17,10,40,0.250000
2025-09-11,Ebay,11,25,4,40,0.100000
2025-09-11,EchoStar,10,22,8,40,0.200000
2025-09-11,Ecolab,19,18,3,40,0.075000
2025-09-11,Edison International,10,21,9,40,0.225000
2025-09-11,Edward Jones,16,16,8,40,0.200000
2025-09-11,Edwards Lifesciences,20,14,6,40,0.150000
2025-09-11,Elanco Animal Health,19,18,3,40,0.075000
2025-09-11,Electronic Arts,13,22,5,40,0.125000
2025-09-11,Elevance Health,20,9,11,40,0.275000
2025-09-11,Eli Lilly,15,19,6,40,0.150000
2025-09-11,Emerson Electric,19,21,0,40,0.000000
2025-09-11,EnLink Midstream,18,18,4,40,0.100000
2025-09-11,Encompass Health,13,22,5,40,0.125000
2025-09-11,Endeavor Group,13,23,4,40,0.100000
2025-09-11,EnerSys,20,20,0,40,0.000000
2025-09-11,Energizer,38,1,1,40,0.025000
2025-09-11,Energy Transfer,31,1,8,40,0.200000
2025-09-11,Ensign Group,23,17,0,40,0.000000
2025-09-11,Entegris,23,14,3,40,0.075000
2025-09-11,Entergy,22,16,2,40,0.050000
2025-09-11,Enterprise Products Partners,20,13,7,40,0.175000
2025-09-11,Envista,15,23,2,40,0.050000
2025-09-11,Equifax,23,7,10,40,0.250000
2025-09-11,Equinix,18,21,1,40,0.025000
2025-09-11,Equitable,23,11,6,40,0.150000
2025-09-11,Equity Residential,18,18,4,40,0.100000
2025-09-11,Erie Insurance,15,14,11,40,0.275000
2025-09-11,Estée Lauder,15,18,7,40,0.175000
2025-09-11,Etsy,6,13,21,40,0.525000
2025-09-11,Euronet Worldwide,19,19,2,40,0.050000
2025-09-11,Evergy,25,11,4,40,0.100000
2025-09-11,Eversource Energy,28,6,6,40,0.150000
2025-09-11,Exact Sciences,14,17,9,40,0.225000
2025-09-11,Exelon,16,22,2,40,0.050000
2025-09-11,Expand Energy,39,1,0,40,0.000000
2025-09-11,Expedia,20,16,4,40,0.100000
2025-09-11,Expeditors International of Washington,17,22,1,40,0.025000
2025-09-11,Extra Space Storage,15,24,1,40,0.025000
2025-09-11,Exxon Mobil,14,23,3,40,0.075000
2025-09-11,F5,7,26,7,40,0.175000
2025-09-11,FM Global,17,15,8,40,0.200000
2025-09-11,FMC Corporation,20,20,0,40,0.000000
2025-09-11,FTI Consulting,12,20,8,40,0.200000
2025-09-11,Fannie Mae,4,34,2,40,0.050000
2025-09-11,Farmers Insurance Exchange,10,18,12,40,0.300000
2025-09-11,Fastenal,19,17,4,40,0.100000
2025-09-11,FedEx,12,16,12,40,0.300000
2025-09-11,Federated Mutual Insurance,6,6,0,12,0.000000
2025-09-11,Fidelity National Financial,17,18,5,40,0.125000
2025-09-11,Fidelity National Information Services,21,15,4,40,0.100000
2025-09-11,Fifth Third Bancorp,18,10,12,40,0.300000
2025-09-11,First American Financial,20,17,3,40,0.075000
2025-09-11,First Citizens BancShares,13,24,3,40,0.075000
2025-09-11,First Horizon,19,21,0,40,0.000000
2025-09-11,First National of Nebraska,18,21,1,40,0.025000
2025-09-11,First Solar,23,15,2,40,0.050000
2025-09-11,FirstCash,11,23,6,40,0.150000
2025-09-11,FirstEnergy,21,14,5,40,0.125000
2025-09-11,Fiserv,18,17,5,40,0.125000
2025-09-11,Five Below,17,21,2,40,0.050000
2025-09-11,Flagstar Financial,12,22,6,40,0.150000
2025-09-11,Floor & Decor,17,21,2,40,0.050000
2025-09-11,Flowers Foods,10,22,8,40,0.200000
2025-09-11,Flowserve,16,18,6,40,0.150000
2025-09-11,Fluor,17,15,8,40,0.200000
2025-09-11,Foot Locker,3,34,3,40,0.075000
2025-09-11,Ford Motor,11,23,6,40,0.150000
2025-09-11,Fortinet,16,9,15,40,0.375000
2025-09-11,Fortive,21,17,2,40,0.050000
2025-09-11,Fortune Brands Innovations,13,22,5,40,0.125000
2025-09-11,Franklin Resources,14,23,3,40,0.075000
2025-09-11,Freddie Mac,11,22,7,40,0.175000
2025-09-11,Freeport-McMoRan,18,16,6,40,0.150000
2025-09-11,Frontier Airlines,14,18,8,40,0.200000
2025-09-11,Frontier Communications,16,19,5,40,0.125000
2025-09-11,G-III Apparel Group,15,22,3,40,0.075000
2025-09-11,GE HealthCare Technologies,21,18,1,40,0.025000
2025-09-11,GMS,14,25,1,40,0.025000
2025-09-11,GXO Logistics,15,21,4,40,0.100000
2025-09-11,GameStop,20,16,4,40,0.100000
2025-09-11,Gannett,16,14,10,40,0.250000
2025-09-11,Garrett Motion inc,12,23,5,40,0.125000
2025-09-11,Gartner,10,25,5,40,0.125000
2025-09-11,Gen Digital,18,20,2,40,0.050000
2025-09-11,Generac,19,13,8,40,0.200000
2025-09-11,General Dynamics,38,1,1,40,0.025000
2025-09-11,General Electric,12,26,2,40,0.050000
2025-09-11,General Mills,20,18,2,40,0.050000
2025-09-11,General Motors,12,17,11,40,0.275000
2025-09-11,Genesis Energy,35,3,2,40,0.050000
2025-09-11,Genuine Parts,17,22,1,40,0.025000
2025-09-11,Genworth Financial,23,15,2,40,0.050000
2025-09-11,Gilead Sciences,14,23,3,40,0.075000
2025-09-11,Global Partners,20,16,4,40,0.100000
2025-09-11,Global Payments,12,25,3,40,0.075000
2025-09-11,Globe Life,17,19,4,40,0.100000
2025-09-11,GoDaddy,14,24,2,40,0.050000
2025-09-11,Goldman Sachs,16,18,6,40,0.150000
2025-09-11,Goodyear Tire & Rubber,12,25,3,40,0.075000
2025-09-11,Graham Holdings Company,20,17,3,40,0.075000
2025-09-11,Granite Construction,19,19,2,40,0.050000
2025-09-11,Graphic Packaging,12,20,8,40,0.200000
2025-09-11,Gray Television,14,21,5,40,0.125000
2025-09-11,Graybar Electric,12,22,6,40,0.150000
2025-09-11,Green Plains inc,17,18,5,40,0.125000
2025-09-11,Greenbrier,8,21,11,40,0.275000
2025-09-11,Greif,8,26,6,40,0.150000
2025-09-11,Griffon Corporation,17,22,1,40,0.025000
2025-09-11,Grocery Outlet Holding,18,21,1,40,0.025000
2025-09-11,Group 1 Automotive,17,21,2,40,0.050000
2025-09-11,Guardian Life insurance,19,21,0,40,0.000000
2025-09-11,Guess inc,14,24,2,40,0.050000
2025-09-11,H B Fuller,13,22,5,40,0.125000
2025-09-11,HCA Healthcare,21,16,3,40,0.075000
2025-09-11,HEICO,17,20,3,40,0.075000
2025-09-11,HF Sinclair,15,20,5,40,0.125000
2025-09-11,Halliburton,9,12,19,40,0.475000
2025-09-11,Hanesbrands,15,22,3,40,0.075000
2025-09-11,Hanover Insurance Group,14,23,3,40,0.075000
2025-09-11,Harley-Davidson,14,23,3,40,0.075000
2025-09-11,Hasbro,11,28,1,40,0.025000
2025-09-11,Hawaiian Airlines inc,13,26,1,40,0.025000
2025-09-11,Hawaiian Electric Industries,20,17,3,40,0.075000
2025-09-11,Helmerich & Payne,9,27,4,40,0.100000
2025-09-11,Henry Schein,20,18,2,40,0.050000
2025-09-11,Herc Rentals,17,17,6,40,0.150000
2025-09-11,Hershey,18,20,2,40,0.050000
2025-09-11,Hertz,25,10,5,40,0.125000
2025-09-11,Hewlett Packard,10,28,2,40,0.050000
2025-09-11,Hewlett Packard Enterprise,12,27,1,40,0.025000
2025-09-11,Hillenbrand,17,21,2,40,0.050000
2025-09-11,Hilton Grand Vacations,38,2,0,40,0.000000
2025-09-11,Hilton Worldwide,20,18,2,40,0.050000
2025-09-11,Hologic,15,21,4,40,0.100000
2025-09-11,Home Depot,12,16,12,40,0.300000
2025-09-11,Honeywell,17,21,2,40,0.050000
2025-09-11,Hormel Foods,10,27,3,40,0.075000
2025-09-11,Host Hotels & Resorts,9,30,1,40,0.025000
2025-09-11,Hovnanian Enterprises,14,22,4,40,0.100000
2025-09-11,Howmet Aerospace,17,20,3,40,0.075000
2025-09-11,Hub Group,13,19,8,40,0.200000
2025-09-11,Hubbell,11,25,4,40,0.100000
2025-09-11,Humana,22,13,5,40,0.125000
2025-09-11,Huntington Bancshares,15,22,3,40,0.075000
2025-09-11,Huntington Ingalls Industries,23,14,3,40,0.075000
2025-09-11,Huntsman,8,21,11,40,0.275000
2025-09-11,Hyatt Hotels,16,24,0,40,0.000000
2025-09-11,Hyster-Yale,17,19,4,40,0.100000
2025-09-11,IAC,14,21,5,40,0.125000
2025-09-11,IBM,16,21,3,40,0.075000
2025-09-11,IDEX,13,23,4,40,0.100000
2025-09-11,IDEXX Laboratories,23,14,3,40,0.075000
2025-09-11,IQVIA,25,12,3,40,0.075000
2025-09-11,ITT,16,18,6,40,0.150000
2025-09-11,Icahn Enterprises,11,15,14,40,0.350000
2025-09-11,Illinois Tool Works,23,14,3,40,0.075000
2025-09-11,Illumina inc,18,21,1,40,0.025000
2025-09-11,Incyte,20,18,2,40,0.050000
2025-09-11,Ingersoll Rand,19,16,5,40,0.125000
2025-09-11,Ingles Markets,12,21,7,40,0.175000
2025-09-11,Ingram Micro,12,13,15,40,0.375000
2025-09-11,Ingredion,22,17,1,40,0.025000
2025-09-11,Insight Enterprises,10,26,4,40,0.100000
2025-09-11,Insperity,18,19,3,40,0.075000
2025-09-11,Instacart,14,18,8,40,0.200000
2025-09-11,Installed Building Products,10,26,4,40,0.100000
2025-09-11,Intel,13,23,4,40,0.100000
2025-09-11,Interactive Brokers,15,21,4,40,0.100000
2025-09-11,Intercontinental Exchange,14,25,1,40,0.025000
2025-09-11,International Flavors & Fragrances,18,19,3,40,0.075000
2025-09-11,International Paper,7,28,5,40,0.125000
2025-09-11,Interpublic Group,23,15,2,40,0.050000
2025-09-11,Intuit,16,20,4,40,0.100000
2025-09-11,Intuitive Surgical,13,16,11,40,0.275000
2025-09-11,Iron Mountain,8,27,5,40,0.125000
2025-09-11,JB Hunt Transport Services,11,25,4,40,0.100000
2025-09-11,JELD-WEN Holding,14,20,6,40,0.150000
2025-09-11,JM Smucker,20,16,4,40,0.100000
2025-09-11,JPMorgan Chase,9,19,12,40,0.300000
2025-09-11,Jabil,16,23,1,40,0.025000
2025-09-11,Jackson Financial,15,20,5,40,0.125000
2025-09-11,Jacobs Solutions,36,1,3,40,0.075000
2025-09-11,Jefferies Financial,9,25,6,40,0.150000
2025-09-11,JetBlue Airways,15,24,1,40,0.025000
2025-09-11,Johnson & Johnson,17,18,5,40,0.125000
2025-09-11,Jones Lang LaSalle,19,16,5,40,0.125000
2025-09-11,Juniper Networks,13,24,3,40,0.075000
2025-09-11,KB Home,20,18,2,40,0.050000
2025-09-11,KBR,26,13,1,40,0.025000
2025-09-11,KKR & Co,25,14,1,40,0.025000
2025-09-11,KLA,20,16,4,40,0.100000
2025-09-11,Kaiser Aluminum,17,20,3,40,0.075000
2025-09-11,Kellanova,19,18,3,40,0.075000
2025-09-11,Kelly Services inc,19,17,4,40,0.100000
2025-09-11,Kemper,16,13,11,40,0.275000
2025-09-11,Keurig Dr Pepper,7,29,4,40,0.100000
2025-09-11,KeyCorp,17,18,5,40,0.125000
2025-09-11,Keysight Technologies,20,17,3,40,0.075000
2025-09-11,Kimberly-Clark,13,21,6,40,0.150000
2025-09-11,Kinder Morgan,40,0,0,40,0.000000
2025-09-11,Kirby Corporation,22,17,1,40,0.025000
2025-09-11,Knife River Corporation,22,15,3,40,0.075000
2025-09-11,Knight Swift Transportation,16,18,6,40,0.150000
2025-09-11,Kohls,15,20,5,40,0.125000
2025-09-11,Kontoor Brands,20,16,4,40,0.100000
2025-09-11,Korn Ferry,16,21,3,40,0.075000
2025-09-11,Kraft Heinz,13,16,11,40,0.275000
2025-09-11,Kroger,19,16,5,40,0.125000
2025-09-11,Kyndryl,13,24,3,40,0.075000
2025-09-11,L3Harris Technologies,20,17,3,40,0.075000
2025-09-11,LCI Industries,14,22,4,40,0.100000
2025-09-11,LKQ,10,29,1,40,0.025000
2025-09-11,LPL Financial,30,10,0,40,0.000000
2025-09-11,Labcorp Holdings,22,15,3,40,0.075000
2025-09-11,Lam Research,19,20,1,40,0.025000
2025-09-11,Lamb Weston,12,24,4,40,0.100000
2025-09-11,Land OLakes,9,20,11,40,0.275000
2025-09-11,Landstar System,13,16,11,40,0.275000
2025-09-11,Las Vegas Sands,13,25,2,40,0.050000
2025-09-11,Lear Corporation,20,18,2,40,0.050000
2025-09-11,Leggett & Platt,13,22,5,40,0.125000
2025-09-11,Leidos,17,18,5,40,0.125000
2025-09-11,Lennar,9,28,3,40,0.075000
2025-09-11,Lennox International,18,21,1,40,0.025000
2025-09-11,Levi Strauss,13,26,1,40,0.025000
2025-09-11,Liberty Energy,40,0,0,40,0.000000
2025-09-11,Liberty Media,36,3,1,40,0.025000
2025-09-11,Liberty Mutual Insurance,32,2,6,40,0.150000
2025-09-11,Light & Wonder,7,23,10,40,0.250000
2025-09-11,Lincoln Electric,12,28,0,40,0.000000
2025-09-11,Lincoln National,13,18,9,40,0.225000
2025-09-11,Lithia Motors,15,22,3,40,0.075000
2025-09-11,Live Nation Entertainment,34,4,2,40,0.050000
2025-09-11,Lockheed Martin,14,17,9,40,0.225000
2025-09-11,Loews,13,23,4,40,0.100000
2025-09-11,Louisiana-Pacific Corporation,21,15,4,40,0.100000
2025-09-11,Lowes,11,24,5,40,0.125000
2025-09-11,Lululemon athletica,7,18,15,40,0.375000
2025-09-11,Lumen Technologies,7,24,9,40,0.225000
2025-09-11,Lyft,11,24,5,40,0.125000
2025-09-11,M&T Bank,13,26,1,40,0.025000
2025-09-11,M/I Homes,17,18,5,40,0.125000
2025-09-11,MDU Resources Group,19,20,1,40,0.025000
2025-09-11,MGM Resorts International,12,26,2,40,0.050000
2025-09-11,MKS Instruments,19,20,1,40,0.025000
2025-09-11,MRC Global,17,23,0,40,0.000000
2025-09-11,MSC Industrial Direct,15,22,3,40,0.075000
2025-09-11,MSCI,15,22,3,40,0.075000
2025-09-11,MYR Group,14,24,2,40,0.050000
2025-09-11,Macys,11,25,4,40,0.100000
2025-09-11,ManpowerGroup,18,16,6,40,0.150000
2025-09-11,Marathon Oil,14,23,3,40,0.075000
2025-09-11,Marathon Petroleum,19,18,3,40,0.075000
2025-09-11,Markel Group,19,18,3,40,0.075000
2025-09-11,Marriott International,18,19,3,40,0.075000
2025-09-11,Marriott Vacations Worldwide,19,19,2,40,0.050000
2025-09-11,Marsh & McLennan,21,18,1,40,0.025000
2025-09-11,Martin Marietta Materials,17,15,8,40,0.200000
2025-09-11,Marvell Technology,10,23,7,40,0.175000
2025-09-11,MasTec,16,23,1,40,0.025000
2025-09-11,Masco,17,19,4,40,0.100000
2025-09-11,Mass Mutual,13,22,5,40,0.125000
2025-09-11,MasterBrand,8,31,1,40,0.025000
2025-09-11,Mastercard,18,18,4,40,0.100000
2025-09-11,Matador Resources,16,18,6,40,0.150000
2025-09-11,Match Group,11,18,11,40,0.275000
2025-09-11,Mativ,17,20,3,40,0.075000
2025-09-11,Matson inc,24,14,2,40,0.050000
2025-09-11,Mattel,16,18,6,40,0.150000
2025-09-11,Maximus,15,23,2,40,0.050000
2025-09-11,McCormick & Company,22,16,2,40,0.050000
2025-09-11,McDonalds,19,12,9,40,0.225000
2025-09-11,McKesson,21,17,2,40,0.050000
2025-09-11,Medical Mutual of Ohio,15,20,5,40,0.125000
2025-09-11,Merck,12,15,13,40,0.325000
2025-09-11,Mercury General,13,18,9,40,0.225000
2025-09-11,Meritage Homes,18,20,2,40,0.050000
2025-09-11,MetLife,12,22,6,40,0.150000
2025-09-11,Meta,12,16,12,40,0.300000
2025-09-11,Mettler-Toledo International,24,13,3,40,0.075000
2025-09-11,Microchip Technology,16,22,2,40,0.050000
2025-09-11,Micron Technology,16,20,4,40,0.100000
2025-09-11,Microsoft,11,24,5,40,0.125000
2025-09-11,Middleby,15,21,4,40,0.100000
2025-09-11,MillerKnoll,15,24,1,40,0.025000
2025-09-11,Moderna,13,19,8,40,0.200000
2025-09-11,ModivCare,9,23,8,40,0.200000
2025-09-11,Mohawk Industries,20,17,3,40,0.075000
2025-09-11,Molina Healthcare,16,13,11,40,0.275000
2025-09-11,Molson Coors Beverage,15,13,12,40,0.300000
2025-09-11,Mondelez,13,20,7,40,0.175000
2025-09-11,Monster Beverage,25,12,3,40,0.075000
2025-09-11,Moodys Corporation,3,9,2,14,0.142857
2025-09-11,Moog inc,20,19,1,40,0.025000
2025-09-11,Morgan Stanley,19,15,6,40,0.150000
2025-09-11,Mosaic,16,22,2,40,0.050000
2025-09-11,Motorola Solutions,40,0,0,40,0.000000
2025-09-11,Mueller Industries,23,17,0,40,0.000000
2025-09-11,Murphy Oil,17,21,2,40,0.050000
2025-09-11,Murphy USA,16,22,2,40,0.050000
2025-09-11,Mutual of Omaha,17,19,4,40,0.100000
2025-09-11,NCR Atleos,12,27,1,40,0.025000
2025-09-11,NCR Voyix,11,24,5,40,0.125000
2025-09-11,NGL Energy Partners,38,0,2,40,0.050000
2025-09-11,NLV Financial,4,4,2,10,0.200000
2025-09-11,NOV,15,20,5,40,0.125000
2025-09-11,NRG Energy,37,2,1,40,0.025000
2025-09-11,NVR,20,18,2,40,0.050000
2025-09-11,Nasdaq,17,19,4,40,0.100000
2025-09-11,Nationwide Insurance,9,19,12,40,0.300000
2025-09-11,Navient,17,13,10,40,0.250000
2025-09-11,NetApp,17,20,3,40,0.075000
2025-09-11,Netflix,17,16,7,40,0.175000
2025-09-11,NeueHealth,15,23,2,40,0.050000
2025-09-11,New York Life Insurance,16,22,2,40,0.050000
2025-09-11,NewMarket Corporation,19,18,3,40,0.075000
2025-09-11,Newell Brands,10,22,8,40,0.200000
2025-09-11,Newmont,11,25,4,40,0.100000
2025-09-11,News Corp,20,12,8,40,0.200000
2025-09-11,Nexstar Media Group,19,21,0,40,0.000000
2025-09-11,NextEra Energy,34,4,2,40,0.050000
2025-09-11,NiSource,18,12,10,40,0.250000
2025-09-11,Nike,8,28,4,40,0.100000
2025-09-11,Nordson,22,18,0,40,0.000000
2025-09-11,Nordstrom,16,21,3,40,0.075000
2025-09-11,Norfolk Southern,17,15,8,40,0.200000
2025-09-11,Northern Trust,37,2,1,40,0.025000
2025-09-11,Northrop Grumman,16,20,4,40,0.100000
2025-09-11,Northwestern Mutual,17,14,9,40,0.225000
2025-09-11,Nucor,14,19,7,40,0.175000
2025-09-11,Nvidia,21,16,3,40,0.075000
2025-09-11,O-I Glass,17,20,3,40,0.075000
2025-09-11,ODP Business Solutions,21,18,1,40,0.025000
2025-09-11,OGE Energy,36,2,2,40,0.050000
2025-09-11,ON Semiconductor,12,18,10,40,0.250000
2025-09-11,OReilly Automotive,6,14,7,27,0.259259
2025-09-11,Occidental Petroleum,9,21,10,40,0.250000
2025-09-11,Old Dominion Freight Line,17,16,7,40,0.175000
2025-09-11,Old National Bancorp,13,27,0,40,0.000000
2025-09-11,Old Republic International,20,17,3,40,0.075000
2025-09-11,Olin,9,17,14,40,0.350000
2025-09-11,Omnicom Group,27,11,2,40,0.050000
2025-09-11,OneMain,15,25,0,40,0.000000
2025-09-11,Oneok,24,15,1,40,0.025000
2025-09-11,Opendoor Technologies,9,23,8,40,0.200000
2025-09-11,Option Care Health,40,0,0,40,0.000000
2025-09-11,Oracle,23,12,5,40,0.125000
2025-09-11,Organon,18,15,7,40,0.175000
2025-09-11,Oscar Health,15,17,8,40,0.200000
2025-09-11,Oshkosh Corporation,15,19,6,40,0.150000
2025-09-11,Otis Worldwide,16,21,3,40,0.075000
2025-09-11,Ovintiv,22,13,5,40,0.125000
2025-09-11,Owens & Minor,8,25,7,40,0.175000
2025-09-11,Owens Corning,11,26,3,40,0.075000
2025-09-11,PACS Group,13,12,15,40,0.375000
2025-09-11,PBF Energy,35,0,5,40,0.125000
2025-09-11,PC Connection Inc,22,16,2,40,0.050000
2025-09-11,PENN Entertainment,38,2,0,40,0.000000
2025-09-11,PG&E,14,16,10,40,0.250000
2025-09-11,PNC Financial Services,22,16,2,40,0.050000
2025-09-11,PPG Industries,20,16,4,40,0.100000
2025-09-11,PPL,21,15,4,40,0.100000
2025-09-11,PVH,13,22,5,40,0.125000
2025-09-11,Paccar,15,20,5,40,0.125000
2025-09-11,Pacific Life,16,23,1,40,0.025000
2025-09-11,Packaging Corp of America,10,26,4,40,0.100000
2025-09-11,Palo Alto Networks,15,15,10,40,0.250000
2025-09-11,Par Pacific,21,18,1,40,0.025000
2025-09-11,Paramount Global,5,30,5,40,0.125000
2025-09-11,Park Hotels & Resorts,11,26,3,40,0.075000
2025-09-11,Parker-Hannifin,28,11,1,40,0.025000
2025-09-11,Parsons Corporation,23,15,2,40,0.050000
2025-09-11,Patrick Industries,15,24,1,40,0.025000
2025-09-11,Patterson Companies Inc,11,26,3,40,0.075000
2025-09-11,Patterson-UTI Energy,32,7,1,40,0.025000
2025-09-11,PayPal,13,14,13,40,0.325000
2025-09-11,Paychex,22,13,5,40,0.125000
2025-09-11,Peabody Energy,32,6,2,40,0.050000
2025-09-11,Peloton,25,14,1,40,0.025000
2025-09-11,Penn Mutual Life Insurance,20,16,4,40,0.100000
2025-09-11,PennyMac Financial Services,17,21,2,40,0.050000
2025-09-11,Penske Automotive,12,26,2,40,0.050000
2025-09-11,PepsiCo,17,18,5,40,0.125000
2025-09-11,Performance Food,11,24,5,40,0.125000
2025-09-11,Permian Resources,20,17,3,40,0.075000
2025-09-11,Petco Health and Wellness,37,2,1,40,0.025000
2025-09-11,Peter Kiewit Sons,6,19,15,40,0.375000
2025-09-11,Pfizer,18,17,5,40,0.125000
2025-09-11,Philip Morris,16,17,7,40,0.175000
2025-09-11,Phillips 66,16,21,3,40,0.075000
2025-09-11,Pinnacle West Capital,17,14,9,40,0.225000
2025-09-11,Pinterest,19,18,3,40,0.075000
2025-09-11,Pioneer Natural Resources,18,10,12,40,0.300000
2025-09-11,Pitney Bowes,21,18,1,40,0.025000
2025-09-11,Plains GP,15,14,11,40,0.275000
2025-09-11,Playtika Holding,17,18,5,40,0.125000
2025-09-11,Plexus,7,21,12,40,0.300000
2025-09-11,Polaris Inc,20,16,4,40,0.100000
2025-09-11,Pool Corporation,20,16,4,40,0.100000
2025-09-11,Popular inc,39,1,0,40,0.000000
2025-09-11,Portland General Electric,16,21,3,40,0.075000
2025-09-11,Post Holdings,11,28,1,40,0.025000
2025-09-11,PriceSmart,16,22,2,40,0.050000
2025-09-11,Primerica,16,18,6,40,0.150000
2025-09-11,Primoris Services,22,17,1,40,0.025000
2025-09-11,Principal Financial,19,19,2,40,0.050000
2025-09-11,ProFrac Holding,14,20,6,40,0.150000
2025-09-11,Procter & Gamble,19,13,8,40,0.200000
2025-09-11,Progressive Insurance,15,21,4,40,0.100000
2025-09-11,Prologis,17,22,1,40,0.025000
2025-09-11,Prudential Financial,20,18,2,40,0.050000
2025-09-11,Public Service Enterprise Group,27,12,1,40,0.025000
2025-09-11,Public Storage,17,17,6,40,0.150000
2025-09-11,Publix Super Markets,22,15,3,40,0.075000
2025-09-11,Puget Sound Energy,28,10,2,40,0.050000
2025-09-11,PulteGroup,22,17,1,40,0.025000
2025-09-11,Pure Storage,10,28,2,40,0.050000
2025-09-11,QVC,13,23,4,40,0.100000
2025-09-11,Qorvo,21,17,2,40,0.050000
2025-09-11,Quad/Graphics,13,23,4,40,0.100000
2025-09-11,Qualcomm,10,29,1,40,0.025000
2025-09-11,Quanta Services,27,13,0,40,0.000000
2025-09-11,Quest Diagnostics,12,26,2,40,0.050000
2025-09-11,QuidelOrtho,17,21,2,40,0.050000
2025-09-11,REV Group,14,22,4,40,0.100000
2025-09-11,RPM International,16,22,2,40,0.050000
2025-09-11,RTX,26,13,1,40,0.025000
2025-09-11,RXO inc,16,18,6,40,0.150000
2025-09-11,Rackspace Technology,12,23,5,40,0.125000
2025-09-11,Radius Recycling,5,21,14,40,0.350000
2025-09-11,Ralph Lauren,13,26,1,40,0.025000
2025-09-11,Range Resources,21,17,2,40,0.050000
2025-09-11,Raymond James Financial,25,14,1,40,0.025000
2025-09-11,Realty Income,20,11,9,40,0.225000
2025-09-11,Regal Rexnord,16,21,3,40,0.075000
2025-09-11,Regeneron Pharmaceuticals,26,11,3,40,0.075000
2025-09-11,Regions Financial,20,19,1,40,0.025000
2025-09-11,Reinsurance Group of America,17,22,1,40,0.025000
2025-09-11,Reliance Inc,18,18,4,40,0.100000
2025-09-11,Republic Services,8,14,18,40,0.450000
2025-09-11,ResMed,18,22,0,40,0.000000
2025-09-11,Resideo Technologies,24,15,1,40,0.025000
2025-09-11,Restoration Hardware,14,21,5,40,0.125000
2025-09-11,Revvity,20,14,6,40,0.150000
2025-09-11,Rite Aid,5,28,7,40,0.175000
2025-09-11,Rithm Capital,16,24,0,40,0.000000
2025-09-11,Rivian Automotive,6,27,7,40,0.175000
2025-09-11,Robert Half,18,20,2,40,0.050000
2025-09-11,Roblox,13,15,12,40,0.300000
2025-09-11,Rocket Companies,16,21,3,40,0.075000
2025-09-11,Rockwell Automation,20,19,1,40,0.025000
2025-09-11,Roku,19,20,1,40,0.025000
2025-09-11,Rollins inc,18,22,0,40,0.000000
2025-09-11,Roper Technologies,21,18,1,40,0.025000
2025-09-11,Ross Stores,16,21,3,40,0.075000
2025-09-11,Rush Enterprises,14,23,3,40,0.075000
2025-09-11,Ryder System,18,19,3,40,0.075000
2025-09-11,Ryerson Holding,15,16,9,40,0.225000
2025-09-11,S&P Global,14,17,9,40,0.225000
2025-09-11,SBA Communications,20,12,8,40,0.200000
2025-09-11,SS&C Technologies,21,18,1,40,0.025000
2025-09-11,Sabre Corporation,15,20,5,40,0.125000
2025-09-11,Saia inc,18,17,5,40,0.125000
2025-09-11,Salesforce,17,12,11,40,0.275000
2025-09-11,Sallie Mae,14,22,4,40,0.100000
2025-09-11,Sally Beauty,39,1,0,40,0.000000
2025-09-11,Sanmina,16,21,3,40,0.075000
2025-09-11,ScanSource,22,16,2,40,0.050000
2025-09-11,Schneider National,14,22,4,40,0.100000
2025-09-11,Science Applications International,18,19,3,40,0.075000
2025-09-11,Scotts Miracle-Gro,15,19,6,40,0.150000
2025-09-11,Seaboard,12,16,12,40,0.300000
2025-09-11,Sealed Air Corporation,14,24,2,40,0.050000
2025-09-11,Securian Financial,11,25,4,40,0.100000
2025-09-11,Select Medical,20,13,7,40,0.175000
2025-09-11,Selective Insurance Group,16,14,10,40,0.250000
2025-09-11,Sempra,23,17,0,40,0.000000
2025-09-11,Sentry Insurance Group,3,7,0,10,0.000000
2025-09-11,Service Corp International,8,10,7,25,0.280000
2025-09-11,ServiceNow,21,12,7,40,0.175000
2025-09-11,Sherwin-Williams,8,27,5,40,0.125000
2025-09-11,Shift4 Payments,15,19,6,40,0.150000
2025-09-11,Silgan,9,24,7,40,0.175000
2025-09-11,Simon Property Group,12,26,2,40,0.050000
2025-09-11,Sinclair,6,30,4,40,0.100000
2025-09-11,SiteOne Landscape Supply,15,18,7,40,0.175000
2025-09-11,Skechers USA,14,24,2,40,0.050000
2025-09-11,SkyWest,11,18,11,40,0.275000
2025-09-11,Skyline Champion,34,4,2,40,0.050000
2025-09-11,Skyworks Solutions,35,3,2,40,0.050000
2025-09-11,Smurfit Westrock,11,25,4,40,0.100000
2025-09-11,Snap Inc,16,11,13,40,0.325000
2025-09-11,Snap-on,9,25,6,40,0.150000
2025-09-11,Snowflake inc,29,11,0,40,0.000000
2025-09-11,Sonic Automotive,11,27,2,40,0.050000
2025-09-11,Sonoco Products,19,17,4,40,0.100000
2025-09-11,Southern Company,23,15,2,40,0.050000
2025-09-11,Southwest Airlines,15,24,1,40,0.025000
2025-09-11,Southwest Gas,21,17,2,40,0.050000
2025-09-11,Southwestern Energy,35,3,2,40,0.050000
2025-09-11,SpartanNash,14,24,2,40,0.050000
2025-09-11,Spectrum Brands,15,17,8,40,0.200000
2025-09-11,Spire inc,21,18,1,40,0.025000
2025-09-11,Spirit AeroSystems,33,1,6,40,0.150000
2025-09-11,Spirit Airlines,22,6,12,40,0.300000
2025-09-11,Splunk,17,20,3,40,0.075000
2025-09-11,Sprouts Farmers Market,7,31,2,40,0.050000
2025-09-11,Stagwell,10,23,7,40,0.175000
2025-09-11,Stanley Black & Decker,19,17,4,40,0.100000
2025-09-11,Starbucks,13,22,5,40,0.125000
2025-09-11,State Farm Insurance,13,20,7,40,0.175000
2025-09-11,State Street,16,14,10,40,0.250000
2025-09-11,Steel Dynamics,38,2,0,40,0.000000
2025-09-11,Steelcase,11,28,1,40,0.025000
2025-09-11,Stericycle,11,8,21,40,0.525000
2025-09-11,Stifel Financial,24,15,1,40,0.025000
2025-09-11,StoneX,15,24,1,40,0.025000
2025-09-11,Stryker,9,21,10,40,0.250000
2025-09-11,Summit Materials,12,24,4,40,0.100000
2025-09-11,Sun Communities,23,16,1,40,0.025000
2025-09-11,Super Micro Computer,36,3,1,40,0.025000
2025-09-11,Surgery Partners,14,22,4,40,0.100000
2025-09-11,Sylvamo,14,18,8,40,0.200000
2025-09-11,Synchrony Financial,25,14,1,40,0.025000
2025-09-11,Synopsys,9,14,17,40,0.425000
2025-09-11,Synovus Financial,13,22,5,40,0.125000
2025-09-11,Sysco,20,16,4,40,0.100000
2025-09-11,T Rowe Price,18,22,0,40,0.000000
2025-09-11,TD Synnex,24,16,0,40,0.000000
2025-09-11,TEGNA,9,28,3,40,0.075000
2025-09-11,TIAA,15,22,3,40,0.075000
2025-09-11,TJX,18,17,5,40,0.125000
2025-09-11,Take-Two Interactive Software,20,18,2,40,0.050000
2025-09-11,Talen Energy,37,2,1,40,0.025000
2025-09-11,Tapestry,17,20,3,40,0.075000
2025-09-11,Targa Resources,27,10,3,40,0.075000
2025-09-11,Target,15,18,7,40,0.175000
2025-09-11,Taylor Morrison Home,18,21,1,40,0.025000
2025-09-11,Teladoc Health,18,18,4,40,0.100000
2025-09-11,Teledyne Technologies,20,18,2,40,0.050000
2025-09-11,Teleflex,16,22,2,40,0.050000
2025-09-11,Telephone & Data Systems,13,22,5,40,0.125000
2025-09-11,TelevisaUnivision,12,15,13,40,0.325000
2025-09-11,Tempur Sealy International,9,25,6,40,0.150000
2025-09-11,Tenet Healthcare,16,20,4,40,0.100000
2025-09-11,Teradyne,21,19,0,40,0.000000
2025-09-11,Terex,13,24,3,40,0.075000
2025-09-11,Tesla,8,21,11,40,0.275000
2025-09-11,Tetra Tech,22,14,4,40,0.100000
2025-09-11,Texas Instruments,9,22,9,40,0.225000
2025-09-11,Texas Roadhouse,10,21,9,40,0.225000
2025-09-11,Textron,20,18,2,40,0.050000
2025-09-11,The Andersons Inc,17,23,0,40,0.000000
2025-09-11,The Coca-Cola Company,11,26,3,40,0.075000
2025-09-11,The Hartford,13,13,14,40,0.350000
2025-09-11,Thermo Fisher Scientific,19,18,3,40,0.075000
2025-09-11,Thor Industries,10,20,10,40,0.250000
2025-09-11,Thrivent Financial for Lutherans,15,19,6,40,0.150000
2025-09-11,Timken,12,24,4,40,0.100000
2025-09-11,Titan Machinery,11,23,6,40,0.150000
2025-09-11,Toast inc,25,11,4,40,0.100000
2025-09-11,Toll Brothers,9,29,2,40,0.050000
2025-09-11,TopBuild,20,19,1,40,0.025000
2025-09-11,Topgolf Callaway Brands,14,19,7,40,0.175000
2025-09-11,Toro Company,12,28,0,40,0.000000
2025-09-11,Tractor Supply,14,20,6,40,0.150000
2025-09-11,TransDigm,18,15,7,40,0.175000
2025-09-11,TransUnion,17,15,8,40,0.200000
2025-09-11,Travelers Insurance,13,16,11,40,0.275000
2025-09-11,TreeHouse Foods,10,24,6,40,0.150000
2025-09-11,Tri Pointe Homes,14,25,1,40,0.025000
2025-09-11,TriNet Group,23,15,2,40,0.050000
2025-09-11,Trimble,9,26,5,40,0.125000
2025-09-11,Trinity Industries,15,18,7,40,0.175000
2025-09-11,TruStage,27,12,1,40,0.025000
2025-09-11,Truist Financial,13,25,2,40,0.050000
2025-09-11,Tutor Perini Corporation,20,18,2,40,0.050000
2025-09-11,Twilio,18,17,5,40,0.125000
2025-09-11,Tyson Foods,12,18,10,40,0.250000
2025-09-11,U-Haul,6,6,28,40,0.700000
2025-09-11,UFP Industries,16,21,3,40,0.075000
2025-09-11,UGI Utilities Inc,18,14,8,40,0.200000
2025-09-11,UL Solutions,35,2,3,40,0.075000
2025-09-11,UPS,16,14,10,40,0.250000
2025-09-11,US Bancorp,18,22,0,40,0.000000
2025-09-11,US Foods,19,17,4,40,0.100000
2025-09-11,USAA,17,15,8,40,0.200000
2025-09-11,Uber,7,23,10,40,0.250000
2025-09-11,Ulta Beauty,33,2,5,40,0.125000
2025-09-11,Under Armour,11,26,3,40,0.075000
2025-09-11,Union Pacific,13,22,5,40,0.125000
2025-09-11,United Airlines,36,1,3,40,0.075000
2025-09-11,United Natural Foods,38,1,1,40,0.025000
2025-09-11,United Rentals,39,1,0,40,0.000000
2025-09-11,United States Steel,25,11,4,40,0.100000
2025-09-11,UnitedHealth,18,20,2,40,0.050000
2025-09-11,Universal Corporation,15,24,1,40,0.025000
2025-09-11,Universal Health Services,21,14,5,40,0.125000
2025-09-11,Unum Group,19,18,3,40,0.075000
2025-09-11,Upbound Group,29,11,0,40,0.000000
2025-09-11,Urban Outfitters,17,21,2,40,0.050000
2025-09-11,V2X,22,16,2,40,0.050000
2025-09-11,VF Corporation,12,24,4,40,0.100000
2025-09-11,VICI Properties,20,17,3,40,0.075000
2025-09-11,Vail Resorts,12,11,17,40,0.425000
2025-09-11,Valero Energy,31,4,5,40,0.125000
2025-09-11,Valley National Bancorp,11,22,7,40,0.175000
2025-09-11,Valmont Industries,24,13,3,40,0.075000
2025-09-11,Valvoline inc,13,25,2,40,0.050000
2025-09-11,Ventas inc,23,17,0,40,0.000000
2025-09-11,Verisk Analytics,21,15,4,40,0.100000
2025-09-11,Verizon,18,17,5,40,0.125000
2025-09-11,Vertex Pharmaceuticals,12,18,10,40,0.250000
2025-09-11,Vertiv,26,12,2,40,0.050000
2025-09-11,Viasat,19,16,5,40,0.125000
2025-09-11,Viatris,12,18,10,40,0.250000
2025-09-11,Victorias Secret,13,18,9,40,0.225000
2025-09-11,Visa,7,13,20,40,0.500000
2025-09-11,Vishay Intertechnology,14,18,8,40,0.200000
2025-09-11,Vista Outdoor,15,21,4,40,0.100000
2025-09-11,Visteon,16,22,2,40,0.050000
2025-09-11,Vistra,23,15,2,40,0.050000
2025-09-11,Vontier,19,19,2,40,0.050000
2025-09-11,Voya Financial,20,17,3,40,0.075000
2025-09-11,Vulcan Materials,13,20,7,40,0.175000
2025-09-11,WEC Energy,38,0,2,40,0.050000
2025-09-11,WESCO International,19,20,1,40,0.025000
2025-09-11,WEX,16,19,5,40,0.125000
2025-09-11,WR Berkley,14,24,2,40,0.050000
2025-09-11,WW Grainger,18,15,7,40,0.175000
2025-09-11,Wabash National,16,12,12,40,0.300000
2025-09-11,Walgreens,5,25,10,40,0.250000
2025-09-11,Walmart,13,12,15,40,0.375000
2025-09-11,Walt Disney,15,19,6,40,0.150000
2025-09-11,Warner Bros Discovery,6,24,10,40,0.250000
2025-09-11,Warner Music Group,9,30,1,40,0.025000
2025-09-11,Waters Corporation,20,17,3,40,0.075000
2025-09-11,Watsco,10,23,7,40,0.175000
2025-09-11,Wayfair,21,19,0,40,0.000000
2025-09-11,Webster Financial,17,20,3,40,0.075000
2025-09-11,Weis Markets,10,24,6,40,0.150000
2025-09-11,Wells Fargo,32,2,6,40,0.150000
2025-09-11,Welltower,32,8,0,40,0.000000
2025-09-11,Werner Enterprises,18,14,8,40,0.200000
2025-09-11,West Pharmaceutical Services,18,19,3,40,0.075000
2025-09-11,Western & Southern Financial,14,22,4,40,0.100000
2025-09-11,Western Alliance Bancorp,15,16,9,40,0.225000
2025-09-11,Western Digital,16,18,6,40,0.150000
2025-09-11,Western Midstream Partners,21,19,0,40,0.000000
2025-09-11,Western Union,12,26,2,40,0.050000
2025-09-11,Westinghouse Air Brake Technologies,15,20,5,40,0.125000
2025-09-11,Westlake Corporation,11,23,6,40,0.150000
2025-09-11,Weyerhaeuser,16,21,3,40,0.075000
2025-09-11,Whirlpool,12,20,8,40,0.200000
2025-09-11,Williams,12,14,14,40,0.350000
2025-09-11,Williams-Sonoma,16,20,4,40,0.100000
2025-09-11,Winnebago Industries,12,25,3,40,0.075000
2025-09-11,Wintrust Financial,16,23,1,40,0.025000
2025-09-11,Woodward inc,21,19,0,40,0.000000
2025-09-11,Workday,14,16,10,40,0.250000
2025-09-11,World Kinect,19,17,4,40,0.100000
2025-09-11,Worthington Enterprises,18,22,0,40,0.000000
2025-09-11,Wynn Resorts,13,21,6,40,0.150000
2025-09-11,XPO,14,21,5,40,0.125000
2025-09-11,Xcel Energy,33,6,1,40,0.025000
2025-09-11,Xerox,16,21,3,40,0.075000
2025-09-11,Xylem Inc,23,16,1,40,0.025000
2025-09-11,Yum Brands,10,27,3,40,0.075000
2025-09-11,Yum China,20,18,2,40,0.050000
2025-09-11,Zebra Technologies,22,15,3,40,0.075000
2025-09-11,Zimmer Biomet,18,20,2,40,0.050000
2025-09-11,Zions Bancorp,18,18,4,40,0.100000
2025-09-11,Zoetis,25,14,1,40,0.025000
2025-09-11,Zoom Video Communications,13,22,5,40,0.125000
2025-09-11,eXp World,20,17,3,40,0.075000
2025-09-11,iHeartMedia,12,26,2,40,0.050000
2025-09-12,3M,22,14,4,40,0.100000
2025-09-12,A O Smith,16,23,1,40,0.025000
2025-09-12,A-Mark Precious Metals,39,1,0,40,0.000000
2025-09-12,ABM Industries,10,19,11,40,0.275000
2025-09-12,ADT,11,21,8,40,0.200000
2025-09-12,AECOM,25,13,2,40,0.050000
2025-09-12,AES,18,16,6,40,0.150000
2025-09-12,AGCO,19,18,3,40,0.075000
2025-09-12,AGNC Investment,14,17,9,40,0.225000
2025-09-12,AMC Entertainment,35,1,4,40,0.100000
2025-09-12,AMC Networks,13,19,8,40,0.200000
2025-09-12,AMN Healthcare Services,9,22,9,40,0.225000
2025-09-12,APA,19,17,4,40,0.100000
2025-09-12,APi Group,20,18,2,40,0.050000
2025-09-12,ARKO,8,30,2,40,0.050000
2025-09-12,ASGN,12,19,9,40,0.225000
2025-09-12,AT&T,12,22,6,40,0.150000
2025-09-12,ATI inc,17,21,2,40,0.050000
2025-09-12,AbbVie,22,12,6,40,0.150000
2025-09-12,Abbott Laboratories,23,14,3,40,0.075000
2025-09-12,Abercrombie & Fitch,12,26,2,40,0.050000
2025-09-12,Academy Sports and Outdoors,11,25,4,40,0.100000
2025-09-12,Acadia Healthcare,16,17,7,40,0.175000
2025-09-12,Acuity Inc,23,16,1,40,0.025000
2025-09-12,Adams Resources & Energy,18,7,2,27,0.074074
2025-09-12,AdaptHealth,17,20,3,40,0.075000
2025-09-12,Adobe,18,18,4,40,0.100000
2025-09-12,Advance Auto Parts,11,19,10,40,0.250000
2025-09-12,Advanced Drainage Systems,34,4,2,40,0.050000
2025-09-12,Advanced Micro Devices,29,3,8,40,0.200000
2025-09-12,Advantage Solutions,36,0,4,40,0.100000
2025-09-12,Aflac,10,13,17,40,0.425000
2025-09-12,Agilent Technologies,20,20,0,40,0.000000
2025-09-12,Agilon Health,12,20,8,40,0.200000
2025-09-12,Air Lease,9,29,2,40,0.050000
2025-09-12,Air Products & Chemicals,14,21,5,40,0.125000
2025-09-12,Airbnb,12,22,6,40,0.150000
2025-09-12,Akamai Technologies,18,20,2,40,0.050000
2025-09-12,Alaska Air,10,29,1,40,0.025000
2025-09-12,Albemarle Corporation,14,23,3,40,0.075000
2025-09-12,Albertsons,13,25,2,40,0.050000
2025-09-12,Alcoa Corporation,6,27,7,40,0.175000
2025-09-12,Alexandria Real Estate Equities,18,18,4,40,0.100000
2025-09-12,Alight Solutions,12,22,6,40,0.150000
2025-09-12,Align Technology,7,22,11,40,0.275000
2025-09-12,Allegiant Travel Company,16,23,1,40,0.025000
2025-09-12,Alliance Resource Partners,12,19,9,40,0.225000
2025-09-12,Alliant Energy,32,5,3,40,0.075000
2025-09-12,Allison Transmission,15,19,6,40,0.150000
2025-09-12,Allstate,16,15,9,40,0.225000
2025-09-12,Ally Financial,17,22,1,40,0.025000
2025-09-12,Alpha Metallurgical Resources,19,17,4,40,0.100000
2025-09-12,Alphabet,15,18,7,40,0.175000
2025-09-12,Altice,13,22,5,40,0.125000
2025-09-12,Altria Group,17,21,2,40,0.050000
2025-09-12,Amazon,32,2,6,40,0.150000
2025-09-12,Ameren,17,21,2,40,0.050000
2025-09-12,American Airlines,16,17,7,40,0.175000
2025-09-12,American Axle & Manufacturing,13,25,2,40,0.050000
2025-09-12,American Eagle Outfitters,15,21,4,40,0.100000
2025-09-12,American Electric Power,20,17,3,40,0.075000
2025-09-12,American Express,22,13,5,40,0.125000
2025-09-12,American Family Insurance,22,14,4,40,0.100000
2025-09-12,American Financial,21,15,4,40,0.100000
2025-09-12,American International Group,17,22,1,40,0.025000
2025-09-12,American Tower,19,17,4,40,0.100000
2025-09-12,American Water Works,25,14,1,40,0.025000
2025-09-12,Americold Realty Trust,35,3,2,40,0.050000
2025-09-12,Ameriprise Financial,19,16,5,40,0.125000
2025-09-12,Ametek,23,17,0,40,0.000000
2025-09-12,Amgen,16,20,4,40,0.100000
2025-09-12,Amica Mutual Insurance,12,26,2,40,0.050000
2025-09-12,Amkor Technology,15,23,2,40,0.050000
2025-09-12,Amphenol,22,17,1,40,0.025000
2025-09-12,Analog Devices,16,22,2,40,0.050000
2025-09-12,Antero Resources,17,23,0,40,0.000000
2025-09-12,Anywhere Real Estate Inc,18,19,3,40,0.075000
2025-09-12,Apollo Global Management,13,25,2,40,0.050000
2025-09-12,AppLovin,11,26,3,40,0.075000
2025-09-12,Apple,15,19,6,40,0.150000
2025-09-12,Applied Industrial Technologies,15,24,1,40,0.025000
2025-09-12,Applied Materials,8,15,17,40,0.425000
2025-09-12,AptarGroup,17,22,1,40,0.025000
2025-09-12,Aramark,22,17,1,40,0.025000
2025-09-12,ArcBest,15,19,6,40,0.150000
2025-09-12,Arch Resources,30,6,4,40,0.100000
2025-09-12,Archer Daniels Midland,23,14,3,40,0.075000
2025-09-12,Ares Management,22,16,2,40,0.050000
2025-09-12,Arista Networks,17,23,0,40,0.000000
2025-09-12,Arrow Electronics,19,15,6,40,0.150000
2025-09-12,Arthur J Gallagher,18,21,1,40,0.025000
2025-09-12,Asbury Automotive Group,12,25,3,40,0.075000
2025-09-12,Assurant,27,9,4,40,0.100000
2025-09-12,Atkore,23,15,2,40,0.050000
2025-09-12,Atlassian,18,15,7,40,0.175000
2025-09-12,Atmos Energy,37,2,1,40,0.025000
2025-09-12,Auto-Owners Insurance,16,19,5,40,0.125000
2025-09-12,AutoNation,19,16,5,40,0.125000
2025-09-12,AutoZone,10,22,8,40,0.200000
2025-09-12,Autodesk,18,22,0,40,0.000000
2025-09-12,Autoliv,26,13,1,40,0.025000
2025-09-12,Automatic Data Processing,25,15,0,40,0.000000
2025-09-12,AvalonBay Communities,18,19,3,40,0.075000
2025-09-12,Avantor,15,16,9,40,0.225000
2025-09-12,Avery Dennison,9,29,2,40,0.050000
2025-09-12,Avient,12,25,3,40,0.075000
2025-09-12,Avis Budget,11,22,7,40,0.175000
2025-09-12,Avnet,14,23,3,40,0.075000
2025-09-12,BJs Wholesale Club,11,23,6,40,0.150000
2025-09-12,BOK Financial,23,12,5,40,0.125000
2025-09-12,BWX Technologies,24,16,0,40,0.000000
2025-09-12,Baker Hughes,18,21,1,40,0.025000
2025-09-12,Ball,11,20,9,40,0.225000
2025-09-12,Bank of America,13,18,9,40,0.225000
2025-09-12,Bank of New York Mellon,23,14,3,40,0.075000
2025-09-12,Bath & Body Works,13,19,8,40,0.200000
2025-09-12,Baxter International,11,21,8,40,0.200000
2025-09-12,Beacon Roofing Supply,5,26,9,40,0.225000
2025-09-12,Becton Dickinson,17,19,4,40,0.100000
2025-09-12,Belden,11,26,3,40,0.075000
2025-09-12,Benchmark Electronics,20,16,4,40,0.100000
2025-09-12,Berkshire Hathaway,12,15,13,40,0.325000
2025-09-12,Best Buy,29,2,9,40,0.225000
2025-09-12,Big Lots,5,32,3,40,0.075000
2025-09-12,Bio-Rad Laboratories,19,19,2,40,0.050000
2025-09-12,Biogen,15,25,0,40,0.000000
2025-09-12,BlackRock,9,28,3,40,0.075000
2025-09-12,Blackstone,10,29,1,40,0.025000
2025-09-12,Bloomin Brands,6,27,7,40,0.175000
2025-09-12,BlueLinx,16,19,5,40,0.125000
2025-09-12,Boeing,4,25,11,40,0.275000
2025-09-12,Boise Cascade,9,20,11,40,0.275000
2025-09-12,Booking Holdings,24,14,2,40,0.050000
2025-09-12,Booz Allen Hamilton,20,16,4,40,0.100000
2025-09-12,BorgWarner,22,16,2,40,0.050000
2025-09-12,Boston Properties,9,22,9,40,0.225000
2025-09-12,Boston Scientific,10,27,3,40,0.075000
2025-09-12,Boyd Gaming,13,25,2,40,0.050000
2025-09-12,Bread Financial,22,15,3,40,0.075000
2025-09-12,BrightSpring Health Services,19,17,4,40,0.100000
2025-09-12,BrightView Holdings,20,17,3,40,0.075000
2025-09-12,Brighthouse Financial,15,23,2,40,0.050000
2025-09-12,Brinker International,21,19,0,40,0.000000
2025-09-12,Brinks Company,10,4,6,20,0.300000
2025-09-12,Bristol-Myers Squibb,13,22,5,40,0.125000
2025-09-12,Broadcom,19,16,5,40,0.125000
2025-09-12,Broadridge Financial Solutions,33,7,0,40,0.000000
2025-09-12,Brookdale Senior Living,12,19,9,40,0.225000
2025-09-12,Brown & Brown,18,20,2,40,0.050000
2025-09-12,Brown-Forman,10,22,8,40,0.200000
2025-09-12,Bruker,12,18,10,40,0.250000
2025-09-12,Brunswick,7,27,6,40,0.150000
2025-09-12,Builders FirstSource,27,12,1,40,0.025000
2025-09-12,Burlington Stores,19,20,1,40,0.025000
2025-09-12,CACI International,25,13,2,40,0.050000
2025-09-12,CBRE Group,21,17,2,40,0.050000
2025-09-12,CDW,20,16,4,40,0.100000
2025-09-12,CF Industries,23,17,0,40,0.000000
2025-09-12,CH Robinson Worldwide,19,19,2,40,0.050000
2025-09-12,CHS,12,26,2,40,0.050000
2025-09-12,CME Group,17,18,5,40,0.125000
2025-09-12,CMS Energy,36,4,0,40,0.000000
2025-09-12,CNO Financial Group,15,24,1,40,0.025000
2025-09-12,CNX Resources,18,20,2,40,0.050000
2025-09-12,CSX,11,23,6,40,0.150000
2025-09-12,CVS Health,19,16,5,40,0.125000
2025-09-12,Cabot Corporation,17,22,1,40,0.025000
2025-09-12,Cadence,9,27,4,40,0.100000
2025-09-12,Caesars Entertainment,34,6,0,40,0.000000
2025-09-12,Cal-Maine Foods,28,10,2,40,0.050000
2025-09-12,Caleres inc,21,15,4,40,0.100000
2025-09-12,California Resources,18,19,3,40,0.075000
2025-09-12,Calumet,6,12,22,40,0.550000
2025-09-12,Campbell Soup,15,20,5,40,0.125000
2025-09-12,Camping World,11,22,7,40,0.175000
2025-09-12,Capital One,12,16,12,40,0.300000
2025-09-12,CarMax,7,28,5,40,0.125000
2025-09-12,Cardinal Health,22,13,5,40,0.125000
2025-09-12,Carlisle Companies,14,20,6,40,0.150000
2025-09-12,Carlyle Group,8,28,4,40,0.100000
2025-09-12,Carpenter Technology,20,18,2,40,0.050000
2025-09-12,Carrier Global,13,19,8,40,0.200000
2025-09-12,Carters inc,10,23,2,35,0.057143
2025-09-12,Carvana,22,14,4,40,0.100000
2025-09-12,Caseys General Stores,14,21,5,40,0.125000
2025-09-12,Catalent,9,26,5,40,0.125000
2025-09-12,Caterpillar,19,16,5,40,0.125000
2025-09-12,Cboe Global Markets,8,30,2,40,0.050000
2025-09-12,Celanese,9,21,10,40,0.250000
2025-09-12,Cencora,25,10,5,40,0.125000
2025-09-12,Centene,14,23,3,40,0.075000
2025-09-12,CenterPoint Energy,25,7,8,40,0.200000
2025-09-12,Central Garden & Pet,5,35,0,40,0.000000
2025-09-12,Century Communities,15,22,3,40,0.075000
2025-09-12,ChampionX,20,20,0,40,0.000000
2025-09-12,Charles River Laboratories International,17,16,7,40,0.175000
2025-09-12,Charles Schwab,14,22,4,40,0.100000
2025-09-12,Chart Industries,14,23,3,40,0.075000
2025-09-12,Charter Communications,8,21,11,40,0.275000
2025-09-12,Cheesecake Factory,17,16,7,40,0.175000
2025-09-12,Chefs Warehouse,19,18,3,40,0.075000
2025-09-12,Chemours,17,12,11,40,0.275000
2025-09-12,Cheniere Energy,36,4,0,40,0.000000
2025-09-12,Chevron,24,13,3,40,0.075000
2025-09-12,Chewy,10,12,18,40,0.450000
2025-09-12,Chipotle Mexican Grill,16,21,3,40,0.075000
2025-09-12,Chord Energy,38,0,2,40,0.050000
2025-09-12,Church & Dwight,15,24,1,40,0.025000
2025-09-12,Ciena,19,18,3,40,0.075000
2025-09-12,Cigna,17,19,4,40,0.100000
2025-09-12,Cincinnati Financial,16,19,5,40,0.125000
2025-09-12,Cinemark,9,25,6,40,0.150000
2025-09-12,Cintas,21,16,3,40,0.075000
2025-09-12,Cisco Systems,12,23,5,40,0.125000
2025-09-12,Citigroup,16,20,4,40,0.100000
2025-09-12,Citizens Financial Group,13,26,1,40,0.025000
2025-09-12,Civitas Resources,13,17,10,40,0.250000
2025-09-12,Clean Harbors,34,1,5,40,0.125000
2025-09-12,Clear Channel Outdoor Hldgs,9,0,1,10,0.100000
2025-09-12,Cleveland-Cliffs,16,16,8,40,0.200000
2025-09-12,Clorox,15,16,9,40,0.225000
2025-09-12,Cognizant Technology Solutions,39,1,0,40,0.000000
2025-09-12,Coherent,19,16,5,40,0.125000
2025-09-12,Coinbase Global,16,21,3,40,0.075000
2025-09-12,Colgate-Palmolive,11,18,11,40,0.275000
2025-09-12,Columbia Banking System,13,25,2,40,0.050000
2025-09-12,Columbia Sportswear,7,20,13,40,0.325000
2025-09-12,Comcast,22,14,4,40,0.100000
2025-09-12,Comerica,21,16,3,40,0.075000
2025-09-12,Comfort Systems USA,40,0,0,40,0.000000
2025-09-12,CommScope,17,23,0,40,0.000000
2025-09-12,Commercial Metals,11,19,10,40,0.250000
2025-09-12,Community Health Systems,16,18,6,40,0.150000
2025-09-12,Compass,11,26,3,40,0.075000
2025-09-12,Conagra Brands,17,22,1,40,0.025000
2025-09-12,Concentrix,18,17,5,40,0.125000
2025-09-12,Conduent,14,18,8,40,0.200000
2025-09-12,ConocoPhillips,10,19,11,40,0.275000
2025-09-12,Consol Energy,31,6,3,40,0.075000
2025-09-12,Consolidated Edison,8,26,6,40,0.150000
2025-09-12,Constellation Brands,8,13,19,40,0.475000
2025-09-12,Constellation Energy,31,4,5,40,0.125000
2025-09-12,Continental Resources,19,13,8,40,0.200000
2025-09-12,Cooper Cos,8,28,4,40,0.100000
2025-09-12,Cooper-Standard,9,30,1,40,0.025000
2025-09-12,Copart,16,22,2,40,0.050000
2025-09-12,Core & Main,11,16,13,40,0.325000
2025-09-12,Cornerstone Building Brands,15,20,5,40,0.125000
2025-09-12,Corning,19,16,5,40,0.125000
2025-09-12,Corpay,19,21,0,40,0.000000
2025-09-12,Corteva,17,20,3,40,0.075000
2025-09-12,Costco,19,17,4,40,0.100000
2025-09-12,Coterra Energy,38,1,1,40,0.025000
2025-09-12,Coty,10,20,10,40,0.250000
2025-09-12,Country Financial,14,24,2,40,0.050000
2025-09-12,Coupang,19,12,9,40,0.225000
2025-09-12,Cracker Barrel Old Country Store,3,29,8,40,0.200000
2025-09-12,Crocs,11,25,4,40,0.100000
2025-09-12,CrossAmerica Partners,13,26,1,40,0.025000
2025-09-12,CrowdStrike,17,10,13,40,0.325000
2025-09-12,Crown Castle,18,21,1,40,0.025000
2025-09-12,Crown Holdings,17,19,4,40,0.100000
2025-09-12,Cullen Frost Bankers,16,20,4,40,0.100000
2025-09-12,Cummins,5,18,17,40,0.425000
2025-09-12,Curtiss-Wright,25,14,1,40,0.025000
2025-09-12,DR Horton,14,19,7,40,0.175000
2025-09-12,DTE Energy,33,2,5,40,0.125000
2025-09-12,DXC Technology,22,17,1,40,0.025000
2025-09-12,DaVita,18,11,11,40,0.275000
2025-09-12,Dana Incorporated,19,16,5,40,0.125000
2025-09-12,Danaher,15,23,2,40,0.050000
2025-09-12,Darden Restaurants,21,17,2,40,0.050000
2025-09-12,Darling Ingredients,39,0,1,40,0.025000
2025-09-12,Deckers Outdoor,26,13,1,40,0.025000
2025-09-12,Deere,10,19,11,40,0.275000
2025-09-12,Delek US,21,17,2,40,0.050000
2025-09-12,Dell Technologies,15,17,8,40,0.200000
2025-09-12,Delta Air Lines,7,24,9,40,0.225000
2025-09-12,Dentsply Sirona,12,27,1,40,0.025000
2025-09-12,Designer Brands,10,26,4,40,0.100000
2025-09-12,Devon Energy,37,1,2,40,0.050000
2025-09-12,DexCom,16,21,3,40,0.075000
2025-09-12,Diamondback Energy,37,0,3,40,0.075000
2025-09-12,Dicks Sporting Goods,13,25,2,40,0.050000
2025-09-12,Diebold Nixdorf,17,23,0,40,0.000000
2025-09-12,Digital Realty Trust,36,4,0,40,0.000000
2025-09-12,Dillards,15,16,9,40,0.225000
2025-09-12,DocuSign,18,17,5,40,0.125000
2025-09-12,Dollar General,6,22,12,40,0.300000
2025-09-12,Dollar Tree,19,17,4,40,0.100000
2025-09-12,Dominion Energy,26,7,7,40,0.175000
2025-09-12,Dominos Pizza inc,14,15,6,35,0.171429
2025-09-12,Domtar,9,24,7,40,0.175000
2025-09-12,Donaldson Company,27,12,1,40,0.025000
2025-09-12,DoorDash,18,14,8,40,0.200000
2025-09-12,Dover Corporation,28,9,3,40,0.075000
2025-09-12,DraftKings,30,8,2,40,0.050000
2025-09-12,Dream Finders Homes,38,1,1,40,0.025000
2025-09-12,Dropbox,21,15,4,40,0.100000
2025-09-12,DuPont,16,16,8,40,0.200000
2025-09-12,Duke Energy,35,1,4,40,0.100000
2025-09-12,Dycom Industries,16,18,6,40,0.150000
2025-09-12,EMCOR Group,16,23,1,40,0.025000
2025-09-12,EOG Resources,23,16,1,40,0.025000
2025-09-12,EPAM Systems,22,16,2,40,0.050000
2025-09-12,EQT,20,19,1,40,0.025000
2025-09-12,ESAB,13,24,3,40,0.075000
2025-09-12,East West Bancorp,21,19,0,40,0.000000
2025-09-12,Eastman Chemical,13,17,10,40,0.250000
2025-09-12,Ebay,11,27,2,40,0.050000
2025-09-12,EchoStar,11,22,7,40,0.175000
2025-09-12,Ecolab,18,19,3,40,0.075000
2025-09-12,Edison International,7,24,9,40,0.225000
2025-09-12,Edward Jones,15,17,8,40,0.200000
2025-09-12,Edwards Lifesciences,20,13,7,40,0.175000
2025-09-12,Elanco Animal Health,16,22,2,40,0.050000
2025-09-12,Electronic Arts,15,18,7,40,0.175000
2025-09-12,Elevance Health,21,8,11,40,0.275000
2025-09-12,Eli Lilly,8,20,12,40,0.300000
2025-09-12,Emerson Electric,24,15,1,40,0.025000
2025-09-12,EnLink Midstream,17,19,4,40,0.100000
2025-09-12,Encompass Health,15,21,4,40,0.100000
2025-09-12,Endeavor Group,14,22,4,40,0.100000
2025-09-12,EnerSys,19,21,0,40,0.000000
2025-09-12,Energizer,39,1,0,40,0.000000
2025-09-12,Energy Transfer,33,0,7,40,0.175000
2025-09-12,Ensign Group,24,15,1,40,0.025000
2025-09-12,Entegris,20,17,3,40,0.075000
2025-09-12,Entergy,22,14,4,40,0.100000
2025-09-12,Enterprise Products Partners,23,10,7,40,0.175000
2025-09-12,Envista,15,22,3,40,0.075000
2025-09-12,Equifax,20,15,5,40,0.125000
2025-09-12,Equinix,20,18,2,40,0.050000
2025-09-12,Equitable,24,11,5,40,0.125000
2025-09-12,Equity Residential,24,15,1,40,0.025000
2025-09-12,Erie Insurance,18,11,11,40,0.275000
2025-09-12,Estée Lauder,14,18,8,40,0.200000
2025-09-12,Etsy,8,9,23,40,0.575000
2025-09-12,Euronet Worldwide,15,22,3,40,0.075000
2025-09-12,Evergy,24,13,3,40,0.075000
2025-09-12,Eversource Energy,32,4,4,40,0.100000
2025-09-12,Exact Sciences,8,20,12,40,0.300000
2025-09-12,Exelon,18,20,2,40,0.050000
2025-09-12,Expand Energy,39,1,0,40,0.000000
2025-09-12,Expedia,19,15,6,40,0.150000
2025-09-12,Expeditors International of Washington,21,18,1,40,0.025000
2025-09-12,Extra Space Storage,16,23,1,40,0.025000
2025-09-12,Exxon Mobil,18,20,2,40,0.050000
2025-09-12,F5,22,18,0,40,0.000000
2025-09-12,FM Global,15,18,7,40,0.175000
2025-09-12,FMC Corporation,22,18,0,40,0.000000
2025-09-12,FTI Consulting,12,20,8,40,0.200000
2025-09-12,Fannie Mae,6,31,3,40,0.075000
2025-09-12,Farmers Insurance Exchange,10,17,13,40,0.325000
2025-09-12,Fastenal,21,16,3,40,0.075000
2025-09-12,FedEx,12,17,11,40,0.275000
2025-09-12,Federated Mutual Insurance,15,23,2,40,0.050000
2025-09-12,Fidelity National Financial,16,17,7,40,0.175000
2025-09-12,Fidelity National Information Services,27,11,2,40,0.050000
2025-09-12,Fifth Third Bancorp,15,12,13,40,0.325000
2025-09-12,First American Financial,20,18,2,40,0.050000
2025-09-12,First Citizens BancShares,12,26,2,40,0.050000
2025-09-12,First Horizon,23,17,0,40,0.000000
2025-09-12,First National of Nebraska,18,21,1,40,0.025000
2025-09-12,First Solar,25,14,1,40,0.025000
2025-09-12,FirstCash,11,22,7,40,0.175000
2025-09-12,FirstEnergy,21,15,4,40,0.100000
2025-09-12,Fiserv,20,16,4,40,0.100000
2025-09-12,Five Below,19,20,1,40,0.025000
2025-09-12,Flagstar Financial,13,22,5,40,0.125000
2025-09-12,Floor & Decor,19,18,3,40,0.075000
2025-09-12,Flowers Foods,9,23,8,40,0.200000
2025-09-12,Flowserve,15,21,4,40,0.100000
2025-09-12,Fluor,15,16,9,40,0.225000
2025-09-12,Foot Locker,5,31,4,40,0.100000
2025-09-12,Ford Motor,10,22,8,40,0.200000
2025-09-12,Fortinet,20,8,12,40,0.300000
2025-09-12,Fortive,20,18,2,40,0.050000
2025-09-12,Fortune Brands Innovations,15,21,4,40,0.100000
2025-09-12,Franklin Resources,13,23,4,40,0.100000
2025-09-12,Freddie Mac,10,16,14,40,0.350000
2025-09-12,Freeport-McMoRan,13,15,12,40,0.300000
2025-09-12,Frontier Airlines,17,17,6,40,0.150000
2025-09-12,Frontier Communications,20,19,1,40,0.025000
2025-09-12,G-III Apparel Group,15,22,3,40,0.075000
2025-09-12,GE HealthCare Technologies,23,16,1,40,0.025000
2025-09-12,GMS,15,24,1,40,0.025000
2025-09-12,GXO Logistics,15,21,4,40,0.100000
2025-09-12,GameStop,20,16,4,40,0.100000
2025-09-12,Gannett,16,15,9,40,0.225000
2025-09-12,Garrett Motion inc,14,21,5,40,0.125000
2025-09-12,Gartner,12,23,5,40,0.125000
2025-09-12,Gen Digital,18,19,3,40,0.075000
2025-09-12,Generac,18,15,7,40,0.175000
2025-09-12,General Dynamics,37,2,1,40,0.025000
2025-09-12,General Electric,12,27,1,40,0.025000
2025-09-12,General Mills,20,18,2,40,0.050000
2025-09-12,General Motors,17,15,8,40,0.200000
2025-09-12,Genesis Energy,36,3,1,40,0.025000
2025-09-12,Genuine Parts,18,19,3,40,0.075000
2025-09-12,Genworth Financial,17,23,0,40,0.000000
2025-09-12,Gilead Sciences,17,21,2,40,0.050000
2025-09-12,Global Partners,19,18,3,40,0.075000
2025-09-12,Global Payments,16,20,4,40,0.100000
2025-09-12,Globe Life,18,18,4,40,0.100000
2025-09-12,GoDaddy,16,22,2,40,0.050000
2025-09-12,Goldman Sachs,23,13,4,40,0.100000
2025-09-12,Goodyear Tire & Rubber,12,25,3,40,0.075000
2025-09-12,Graham Holdings Company,20,18,2,40,0.050000
2025-09-12,Granite Construction,22,17,1,40,0.025000
2025-09-12,Graphic Packaging,13,20,7,40,0.175000
2025-09-12,Gray Television,16,19,5,40,0.125000
2025-09-12,Graybar Electric,13,22,5,40,0.125000
2025-09-12,Green Plains inc,18,17,5,40,0.125000
2025-09-12,Greenbrier,10,19,11,40,0.275000
2025-09-12,Greif,10,24,6,40,0.150000
2025-09-12,Griffon Corporation,17,22,1,40,0.025000
2025-09-12,Grocery Outlet Holding,20,19,1,40,0.025000
2025-09-12,Group 1 Automotive,14,23,3,40,0.075000
2025-09-12,Guardian Life insurance,19,21,0,40,0.000000
2025-09-12,Guess inc,14,25,1,40,0.025000
2025-09-12,H B Fuller,12,23,5,40,0.125000
2025-09-12,HCA Healthcare,23,15,2,40,0.050000
2025-09-12,HEICO,16,20,4,40,0.100000
2025-09-12,HF Sinclair,13,23,4,40,0.100000
2025-09-12,Halliburton,4,19,17,40,0.425000
2025-09-12,Hanesbrands,15,22,3,40,0.075000
2025-09-12,Hanover Insurance Group,16,22,2,40,0.050000
2025-09-12,Harley-Davidson,14,25,1,40,0.025000
2025-09-12,Hasbro,9,28,3,40,0.075000
2025-09-12,Hawaiian Airlines inc,13,26,1,40,0.025000
2025-09-12,Hawaiian Electric Industries,16,20,4,40,0.100000
2025-09-12,Helmerich & Payne,7,27,6,40,0.150000
2025-09-12,Henry Schein,22,17,1,40,0.025000
2025-09-12,Herc Rentals,19,15,6,40,0.150000
2025-09-12,Hershey,14,25,1,40,0.025000
2025-09-12,Hertz,25,12,3,40,0.075000
2025-09-12,Hewlett Packard,8,30,2,40,0.050000
2025-09-12,Hewlett Packard Enterprise,12,26,2,40,0.050000
2025-09-12,Hillenbrand,16,22,2,40,0.050000
2025-09-12,Hilton Grand Vacations,39,1,0,40,0.000000
2025-09-12,Hilton Worldwide,20,18,2,40,0.050000
2025-09-12,Hologic,15,20,5,40,0.125000
2025-09-12,Home Depot,15,15,10,40,0.250000
2025-09-12,Honeywell,17,20,3,40,0.075000
2025-09-12,Hormel Foods,10,28,2,40,0.050000
2025-09-12,Host Hotels & Resorts,11,28,1,40,0.025000
2025-09-12,Hovnanian Enterprises,12,24,4,40,0.100000
2025-09-12,Howmet Aerospace,18,22,0,40,0.000000
2025-09-12,Hub Group,11,21,8,40,0.200000
2025-09-12,Hubbell,24,12,4,40,0.100000
2025-09-12,Humana,23,13,4,40,0.100000
2025-09-12,Huntington Bancshares,19,19,2,40,0.050000
2025-09-12,Huntington Ingalls Industries,23,12,5,40,0.125000
2025-09-12,Huntsman,6,23,11,40,0.275000
2025-09-12,Hyatt Hotels,17,23,0,40,0.000000
2025-09-12,Hyster-Yale,13,23,4,40,0.100000
2025-09-12,IAC,10,25,5,40,0.125000
2025-09-12,IBM,16,22,2,40,0.050000
2025-09-12,IDEX,17,19,4,40,0.100000
2025-09-12,IDEXX Laboratories,20,16,4,40,0.100000
2025-09-12,IQVIA,23,16,1,40,0.025000
2025-09-12,ITT,13,21,6,40,0.150000
2025-09-12,Icahn Enterprises,10,16,14,40,0.350000
2025-09-12,Illinois Tool Works,28,11,1,40,0.025000
2025-09-12,Illumina inc,18,21,1,40,0.025000
2025-09-12,Incyte,20,16,4,40,0.100000
2025-09-12,Ingersoll Rand,18,18,4,40,0.100000
2025-09-12,Ingles Markets,10,22,8,40,0.200000
2025-09-12,Ingram Micro,13,12,15,40,0.375000
2025-09-12,Ingredion,23,16,1,40,0.025000
2025-09-12,Insight Enterprises,14,21,5,40,0.125000
2025-09-12,Insperity,17,22,1,40,0.025000
2025-09-12,Instacart,12,21,7,40,0.175000
2025-09-12,Installed Building Products,10,27,3,40,0.075000
2025-09-12,Intel,8,22,10,40,0.250000
2025-09-12,Interactive Brokers,10,24,6,40,0.150000
2025-09-12,Intercontinental Exchange,12,27,1,40,0.025000
2025-09-12,International Flavors & Fragrances,17,21,2,40,0.050000
2025-09-12,International Paper,11,25,4,40,0.100000
2025-09-12,Interpublic Group,25,13,2,40,0.050000
2025-09-12,Intuit,14,23,3,40,0.075000
2025-09-12,Intuitive Surgical,12,16,12,40,0.300000
2025-09-12,Iron Mountain,12,23,5,40,0.125000
2025-09-12,JB Hunt Transport Services,15,24,1,40,0.025000
2025-09-12,JELD-WEN Holding,12,23,5,40,0.125000
2025-09-12,JM Smucker,18,17,5,40,0.125000
2025-09-12,JPMorgan Chase,15,15,10,40,0.250000
2025-09-12,Jabil,13,26,1,40,0.025000
2025-09-12,Jackson Financial,14,22,4,40,0.100000
2025-09-12,Jacobs Solutions,35,1,4,40,0.100000
2025-09-12,Jefferies Financial,11,24,5,40,0.125000
2025-09-12,JetBlue Airways,13,26,1,40,0.025000
2025-09-12,Johnson & Johnson,18,19,3,40,0.075000
2025-09-12,Jones Lang LaSalle,22,15,3,40,0.075000
2025-09-12,Juniper Networks,13,24,3,40,0.075000
2025-09-12,KB Home,25,13,2,40,0.050000
2025-09-12,KBR,24,15,1,40,0.025000
2025-09-12,KKR & Co,27,12,1,40,0.025000
2025-09-12,KLA,21,15,4,40,0.100000
2025-09-12,Kaiser Aluminum,17,19,4,40,0.100000
2025-09-12,Kellanova,16,21,3,40,0.075000
2025-09-12,Kelly Services inc,15,20,5,40,0.125000
2025-09-12,Kemper,15,13,12,40,0.300000
2025-09-12,Keurig Dr Pepper,8,29,3,40,0.075000
2025-09-12,KeyCorp,19,18,3,40,0.075000
2025-09-12,Keysight Technologies,21,16,3,40,0.075000
2025-09-12,Kimberly-Clark,14,21,5,40,0.125000
2025-09-12,Kinder Morgan,40,0,0,40,0.000000
2025-09-12,Kirby Corporation,21,18,1,40,0.025000
2025-09-12,Knife River Corporation,19,17,4,40,0.100000
2025-09-12,Knight Swift Transportation,18,16,6,40,0.150000
2025-09-12,Kohls,14,18,8,40,0.200000
2025-09-12,Kontoor Brands,21,17,2,40,0.050000
2025-09-12,Korn Ferry,17,19,4,40,0.100000
2025-09-12,Kraft Heinz,10,17,13,40,0.325000
2025-09-12,Kroger,18,12,10,40,0.250000
2025-09-12,Kyndryl,12,26,2,40,0.050000
2025-09-12,L3Harris Technologies,18,19,3,40,0.075000
2025-09-12,LCI Industries,14,23,3,40,0.075000
2025-09-12,LKQ,10,28,2,40,0.050000
2025-09-12,LPL Financial,29,11,0,40,0.000000
2025-09-12,Labcorp Holdings,17,21,2,40,0.050000
2025-09-12,Lam Research,16,22,2,40,0.050000
2025-09-12,Lamb Weston,12,22,6,40,0.150000
2025-09-12,Land OLakes,9,20,10,39,0.256410
2025-09-12,Landstar System,13,18,9,40,0.225000
2025-09-12,Las Vegas Sands,13,25,2,40,0.050000
2025-09-12,Lear Corporation,25,13,2,40,0.050000
2025-09-12,Leggett & Platt,13,22,5,40,0.125000
2025-09-12,Leidos,19,16,5,40,0.125000
2025-09-12,Lennar,10,27,3,40,0.075000
2025-09-12,Lennox International,18,21,1,40,0.025000
2025-09-12,Levi Strauss,13,26,1,40,0.025000
2025-09-12,Liberty Energy,39,0,1,40,0.025000
2025-09-12,Liberty Media,37,2,1,40,0.025000
2025-09-12,Liberty Mutual Insurance,33,1,6,40,0.150000
2025-09-12,Light & Wonder,6,21,13,40,0.325000
2025-09-12,Lincoln Electric,14,25,1,40,0.025000
2025-09-12,Lincoln National,15,14,11,40,0.275000
2025-09-12,Lithia Motors,16,20,4,40,0.100000
2025-09-12,Live Nation Entertainment,35,4,1,40,0.025000
2025-09-12,Lockheed Martin,15,19,6,40,0.150000
2025-09-12,Loews,16,19,5,40,0.125000
2025-09-12,Louisiana-Pacific Corporation,21,16,3,40,0.075000
2025-09-12,Lowes,12,19,9,40,0.225000
2025-09-12,Lululemon athletica,7,20,13,40,0.325000
2025-09-12,Lumen Technologies,6,25,9,40,0.225000
2025-09-12,Lyft,12,22,6,40,0.150000
2025-09-12,M&T Bank,15,25,0,40,0.000000
2025-09-12,M/I Homes,15,21,4,40,0.100000
2025-09-12,MDU Resources Group,17,23,0,40,0.000000
2025-09-12,MGM Resorts International,15,22,3,40,0.075000
2025-09-12,MKS Instruments,18,21,1,40,0.025000
2025-09-12,MRC Global,19,21,0,40,0.000000
2025-09-12,MSC Industrial Direct,13,24,3,40,0.075000
2025-09-12,MSCI,14,25,1,40,0.025000
2025-09-12,MYR Group,17,21,2,40,0.050000
2025-09-12,Macys,11,25,4,40,0.100000
2025-09-12,ManpowerGroup,19,15,6,40,0.150000
2025-09-12,Marathon Oil,15,23,2,40,0.050000
2025-09-12,Marathon Petroleum,19,18,3,40,0.075000
2025-09-12,Markel Group,19,18,3,40,0.075000
2025-09-12,Marriott International,16,21,3,40,0.075000
2025-09-12,Marriott Vacations Worldwide,19,18,3,40,0.075000
2025-09-12,Marsh & McLennan,22,16,2,40,0.050000
2025-09-12,Martin Marietta Materials,15,17,8,40,0.200000
2025-09-12,Marvell Technology,10,25,5,40,0.125000
2025-09-12,MasTec,23,17,0,40,0.000000
2025-09-12,Masco,22,13,5,40,0.125000
2025-09-12,Mass Mutual,12,24,4,40,0.100000
2025-09-12,MasterBrand,8,31,1,40,0.025000
2025-09-12,Mastercard,15,22,3,40,0.075000
2025-09-12,Matador Resources,12,22,6,40,0.150000
2025-09-12,Match Group,12,19,9,40,0.225000
2025-09-12,Mativ,17,20,3,40,0.075000
2025-09-12,Matson inc,23,14,3,40,0.075000
2025-09-12,Mattel,14,20,6,40,0.150000
2025-09-12,Maximus,14,24,2,40,0.050000
2025-09-12,McCormick & Company,21,17,2,40,0.050000
2025-09-12,McDonalds,16,17,7,40,0.175000
2025-09-12,McKesson,20,16,4,40,0.100000
2025-09-12,Medical Mutual of Ohio,14,20,6,40,0.150000
2025-09-12,Merck,14,18,8,40,0.200000
2025-09-12,Mercury General,12,18,10,40,0.250000
2025-09-12,Meritage Homes,18,20,2,40,0.050000
2025-09-12,MetLife,13,22,5,40,0.125000
2025-09-12,Meta,17,16,7,40,0.175000
2025-09-12,Mettler-Toledo International,28,11,1,40,0.025000
2025-09-12,Microchip Technology,23,15,2,40,0.050000
2025-09-12,Micron Technology,16,19,5,40,0.125000
2025-09-12,Microsoft,24,13,3,40,0.075000
2025-09-12,Middleby,16,19,5,40,0.125000
2025-09-12,MillerKnoll,17,22,1,40,0.025000
2025-09-12,Moderna,13,16,11,40,0.275000
2025-09-12,ModivCare,9,23,8,40,0.200000
2025-09-12,Mohawk Industries,21,17,2,40,0.050000
2025-09-12,Molina Healthcare,18,13,9,40,0.225000
2025-09-12,Molson Coors Beverage,15,16,9,40,0.225000
2025-09-12,Mondelez,13,22,5,40,0.125000
2025-09-12,Monster Beverage,26,11,3,40,0.075000
2025-09-12,Moodys Corporation,3,11,2,16,0.125000
2025-09-12,Moog inc,19,19,2,40,0.050000
2025-09-12,Morgan Stanley,14,19,7,40,0.175000
2025-09-12,Mosaic,17,22,1,40,0.025000
2025-09-12,Motorola Solutions,40,0,0,40,0.000000
2025-09-12,Mueller Industries,21,17,2,40,0.050000
2025-09-12,Murphy Oil,17,21,2,40,0.050000
2025-09-12,Murphy USA,15,24,1,40,0.025000
2025-09-12,Mutual of Omaha,18,18,4,40,0.100000
2025-09-12,NCR Atleos,12,27,1,40,0.025000
2025-09-12,NCR Voyix,12,24,4,40,0.100000
2025-09-12,NGL Energy Partners,38,0,2,40,0.050000
2025-09-12,NLV Financial,4,4,2,10,0.200000
2025-09-12,NOV,10,23,7,40,0.175000
2025-09-12,NRG Energy,39,0,1,40,0.025000
2025-09-12,NVR,20,19,1,40,0.025000
2025-09-12,Nasdaq,13,22,5,40,0.125000
2025-09-12,Navient,16,17,7,40,0.175000
2025-09-12,NetApp,16,21,3,40,0.075000
2025-09-12,Netflix,18,7,15,40,0.375000
2025-09-12,NeueHealth,11,27,2,40,0.050000
2025-09-12,New York Life Insurance,17,21,2,40,0.050000
2025-09-12,NewMarket Corporation,14,23,3,40,0.075000
2025-09-12,Newell Brands,11,24,5,40,0.125000
2025-09-12,Newmont,14,23,3,40,0.075000
2025-09-12,News Corp,16,14,10,40,0.250000
2025-09-12,Nexstar Media Group,18,21,1,40,0.025000
2025-09-12,NextEra Energy,33,3,4,40,0.100000
2025-09-12,NiSource,14,15,11,40,0.275000
2025-09-12,Nike,9,28,3,40,0.075000
2025-09-12,Nordson,22,18,0,40,0.000000
2025-09-12,Nordstrom,19,18,3,40,0.075000
2025-09-12,Norfolk Southern,16,15,9,40,0.225000
2025-09-12,Northern Trust,37,2,1,40,0.025000
2025-09-12,Northrop Grumman,13,22,5,40,0.125000
2025-09-12,Northwestern Mutual,17,14,9,40,0.225000
2025-09-12,Nucor,12,23,5,40,0.125000
2025-09-12,Nvidia,20,14,6,40,0.150000
2025-09-12,O-I Glass,14,23,3,40,0.075000
2025-09-12,ODP Business Solutions,19,20,1,40,0.025000
2025-09-12,OGE Energy,38,1,1,40,0.025000
2025-09-12,ON Semiconductor,13,17,10,40,0.250000
2025-09-12,OReilly Automotive,7,14,7,28,0.250000
2025-09-12,Occidental Petroleum,10,20,10,40,0.250000
2025-09-12,Old Dominion Freight Line,19,13,8,40,0.200000
2025-09-12,Old National Bancorp,16,24,0,40,0.000000
2025-09-12,Old Republic International,20,17,3,40,0.075000
2025-09-12,Olin,12,16,12,40,0.300000
2025-09-12,Omnicom Group,28,10,2,40,0.050000
2025-09-12,OneMain,15,25,0,40,0.000000
2025-09-12,Oneok,26,14,0,40,0.000000
2025-09-12,Opendoor Technologies,14,19,7,40,0.175000
2025-09-12,Option Care Health,40,0,0,40,0.000000
2025-09-12,Oracle,18,16,6,40,0.150000
2025-09-12,Organon,18,17,5,40,0.125000
2025-09-12,Oscar Health,19,13,8,40,0.200000
2025-09-12,Oshkosh Corporation,16,19,5,40,0.125000
2025-09-12,Otis Worldwide,13,24,3,40,0.075000
2025-09-12,Ovintiv,19,14,7,40,0.175000
2025-09-12,Owens & Minor,8,25,7,40,0.175000
2025-09-12,Owens Corning,18,19,3,40,0.075000
2025-09-12,PACS Group,14,14,12,40,0.300000
2025-09-12,PBF Energy,35,0,5,40,0.125000
2025-09-12,PC Connection Inc,23,15,2,40,0.050000
2025-09-12,PENN Entertainment,37,3,0,40,0.000000
2025-09-12,PG&E,14,15,11,40,0.275000
2025-09-12,PNC Financial Services,21,19,0,40,0.000000
2025-09-12,PPG Industries,20,15,5,40,0.125000
2025-09-12,PPL,20,15,5,40,0.125000
2025-09-12,PVH,12,22,6,40,0.150000
2025-09-12,Paccar,16,18,6,40,0.150000
2025-09-12,Pacific Life,15,24,1,40,0.025000
2025-09-12,Packaging Corp of America,9,27,4,40,0.100000
2025-09-12,Palo Alto Networks,12,16,12,40,0.300000
2025-09-12,Par Pacific,17,22,1,40,0.025000
2025-09-12,Paramount Global,10,27,3,40,0.075000
2025-09-12,Park Hotels & Resorts,11,26,3,40,0.075000
2025-09-12,Parker-Hannifin,29,10,1,40,0.025000
2025-09-12,Parsons Corporation,23,15,2,40,0.050000
2025-09-12,Patrick Industries,17,22,1,40,0.025000
2025-09-12,Patterson Companies Inc,11,26,3,40,0.075000
2025-09-12,Patterson-UTI Energy,32,6,2,40,0.050000
2025-09-12,PayPal,16,14,10,40,0.250000
2025-09-12,Paychex,25,12,3,40,0.075000
2025-09-12,Peabody Energy,33,4,3,40,0.075000
2025-09-12,Peloton,21,16,3,40,0.075000
2025-09-12,Penn Mutual Life Insurance,19,17,4,40,0.100000
2025-09-12,PennyMac Financial Services,16,21,3,40,0.075000
2025-09-12,Penske Automotive,9,29,2,40,0.050000
2025-09-12,PepsiCo,17,20,3,40,0.075000
2025-09-12,Performance Food,11,25,4,40,0.100000
2025-09-12,Permian Resources,18,21,1,40,0.025000
2025-09-12,Petco Health and Wellness,36,3,1,40,0.025000
2025-09-12,Peter Kiewit Sons,6,19,15,40,0.375000
2025-09-12,Pfizer,20,15,5,40,0.125000
2025-09-12,Philip Morris,18,17,5,40,0.125000
2025-09-12,Phillips 66,16,22,2,40,0.050000
2025-09-12,Pinnacle West Capital,16,17,7,40,0.175000
2025-09-12,Pinterest,18,19,3,40,0.075000
2025-09-12,Pioneer Natural Resources,18,10,12,40,0.300000
2025-09-12,Pitney Bowes,19,21,0,40,0.000000
2025-09-12,Plains GP,17,13,10,40,0.250000
2025-09-12,Playtika Holding,13,18,9,40,0.225000
2025-09-12,Plexus,6,21,13,40,0.325000
2025-09-12,Polaris Inc,20,16,4,40,0.100000
2025-09-12,Pool Corporation,19,18,3,40,0.075000
2025-09-12,Popular inc,39,1,0,40,0.000000
2025-09-12,Portland General Electric,15,22,3,40,0.075000
2025-09-12,Post Holdings,9,30,1,40,0.025000
2025-09-12,PriceSmart,17,20,3,40,0.075000
2025-09-12,Primerica,19,17,4,40,0.100000
2025-09-12,Primoris Services,21,18,1,40,0.025000
2025-09-12,Principal Financial,19,18,3,40,0.075000
2025-09-12,ProFrac Holding,15,19,6,40,0.150000
2025-09-12,Procter & Gamble,17,12,11,40,0.275000
2025-09-12,Progressive Insurance,12,23,5,40,0.125000
2025-09-12,Prologis,19,20,1,40,0.025000
2025-09-12,Prudential Financial,24,14,2,40,0.050000
2025-09-12,Public Service Enterprise Group,24,15,1,40,0.025000
2025-09-12,Public Storage,16,17,7,40,0.175000
2025-09-12,Publix Super Markets,22,15,3,40,0.075000
2025-09-12,Puget Sound Energy,29,9,2,40,0.050000
2025-09-12,PulteGroup,18,20,2,40,0.050000
2025-09-12,Pure Storage,13,25,2,40,0.050000
2025-09-12,QVC,17,19,4,40,0.100000
2025-09-12,Qorvo,18,18,4,40,0.100000
2025-09-12,Quad/Graphics,15,21,4,40,0.100000
2025-09-12,Qualcomm,9,30,1,40,0.025000
2025-09-12,Quanta Services,24,14,2,40,0.050000
2025-09-12,Quest Diagnostics,16,22,2,40,0.050000
2025-09-12,QuidelOrtho,18,20,2,40,0.050000
2025-09-12,REV Group,15,21,4,40,0.100000
2025-09-12,RPM International,18,21,1,40,0.025000
2025-09-12,RTX,26,12,2,40,0.050000
2025-09-12,RXO inc,17,17,6,40,0.150000
2025-09-12,Rackspace Technology,12,23,5,40,0.125000
2025-09-12,Radius Recycling,4,22,14,40,0.350000
2025-09-12,Ralph Lauren,9,28,3,40,0.075000
2025-09-12,Range Resources,19,19,2,40,0.050000
2025-09-12,Raymond James Financial,24,13,3,40,0.075000
2025-09-12,Realty Income,19,16,5,40,0.125000
2025-09-12,Regal Rexnord,16,22,2,40,0.050000
2025-09-12,Regeneron Pharmaceuticals,24,13,3,40,0.075000
2025-09-12,Regions Financial,23,14,3,40,0.075000
2025-09-12,Reinsurance Group of America,20,19,1,40,0.025000
2025-09-12,Reliance Inc,20,16,4,40,0.100000
2025-09-12,Republic Services,7,15,18,40,0.450000
2025-09-12,ResMed,17,23,0,40,0.000000
2025-09-12,Resideo Technologies,25,14,1,40,0.025000
2025-09-12,Restoration Hardware,13,21,6,40,0.150000
2025-09-12,Revvity,22,12,6,40,0.150000
2025-09-12,Rite Aid,6,26,8,40,0.200000
2025-09-12,Rithm Capital,16,24,0,40,0.000000
2025-09-12,Rivian Automotive,9,24,7,40,0.175000
2025-09-12,Robert Half,17,21,2,40,0.050000
2025-09-12,Roblox,19,9,12,40,0.300000
2025-09-12,Rocket Companies,12,24,4,40,0.100000
2025-09-12,Rockwell Automation,17,20,3,40,0.075000
2025-09-12,Roku,17,21,2,40,0.050000
2025-09-12,Rollins inc,20,20,0,40,0.000000
2025-09-12,Roper Technologies,21,19,0,40,0.000000
2025-09-12,Ross Stores,21,18,1,40,0.025000
2025-09-12,Rush Enterprises,17,21,2,40,0.050000
2025-09-12,Ryder System,21,15,4,40,0.100000
2025-09-12,Ryerson Holding,14,17,9,40,0.225000
2025-09-12,S&P Global,12,22,6,40,0.150000
2025-09-12,SBA Communications,19,15,6,40,0.150000
2025-09-12,SS&C Technologies,26,12,2,40,0.050000
2025-09-12,Sabre Corporation,15,19,6,40,0.150000
2025-09-12,Saia inc,21,15,4,40,0.100000
2025-09-12,Salesforce,14,14,12,40,0.300000
2025-09-12,Sallie Mae,12,24,4,40,0.100000
2025-09-12,Sally Beauty,39,1,0,40,0.000000
2025-09-12,Sanmina,16,21,3,40,0.075000
2025-09-12,ScanSource,26,12,2,40,0.050000
2025-09-12,Schneider National,15,20,5,40,0.125000
2025-09-12,Science Applications International,17,18,5,40,0.125000
2025-09-12,Scotts Miracle-Gro,15,20,5,40,0.125000
2025-09-12,Seaboard,15,14,11,40,0.275000
2025-09-12,Sealed Air Corporation,15,24,1,40,0.025000
2025-09-12,Securian Financial,11,25,4,40,0.100000
2025-09-12,Select Medical,19,13,8,40,0.200000
2025-09-12,Selective Insurance Group,13,17,10,40,0.250000
2025-09-12,Sempra,24,16,0,40,0.000000
2025-09-12,Sentry Insurance Group,4,6,0,10,0.000000
2025-09-12,Service Corp International,8,12,6,26,0.230769
2025-09-12,ServiceNow,20,13,7,40,0.175000
2025-09-12,Sherwin-Williams,10,25,5,40,0.125000
2025-09-12,Shift4 Payments,12,20,8,40,0.200000
2025-09-12,Silgan,9,26,5,40,0.125000
2025-09-12,Simon Property Group,11,27,2,40,0.050000
2025-09-12,Sinclair,7,27,6,40,0.150000
2025-09-12,SiteOne Landscape Supply,14,18,8,40,0.200000
2025-09-12,Skechers USA,15,22,3,40,0.075000
2025-09-12,SkyWest,8,22,10,40,0.250000
2025-09-12,Skyline Champion,33,4,3,40,0.075000
2025-09-12,Skyworks Solutions,34,3,3,40,0.075000
2025-09-12,Smurfit Westrock,13,22,5,40,0.125000
2025-09-12,Snap Inc,14,13,13,40,0.325000
2025-09-12,Snap-on,7,26,7,40,0.175000
2025-09-12,Snowflake inc,27,13,0,40,0.000000
2025-09-12,Sonic Automotive,11,27,2,40,0.050000
2025-09-12,Sonoco Products,20,18,2,40,0.050000
2025-09-12,Southern Company,23,16,1,40,0.025000
2025-09-12,Southwest Airlines,13,23,4,40,0.100000
2025-09-12,Southwest Gas,18,20,2,40,0.050000
2025-09-12,Southwestern Energy,36,2,2,40,0.050000
2025-09-12,SpartanNash,12,27,1,40,0.025000
2025-09-12,Spectrum Brands,11,20,9,40,0.225000
2025-09-12,Spire inc,22,16,2,40,0.050000
2025-09-12,Spirit AeroSystems,30,2,8,40,0.200000
2025-09-12,Spirit Airlines,24,6,10,40,0.250000
2025-09-12,Splunk,17,20,3,40,0.075000
2025-09-12,Sprouts Farmers Market,11,27,2,40,0.050000
2025-09-12,Stagwell,11,21,8,40,0.200000
2025-09-12,Stanley Black & Decker,17,20,3,40,0.075000
2025-09-12,Starbucks,16,18,6,40,0.150000
2025-09-12,State Farm Insurance,14,20,6,40,0.150000
2025-09-12,State Street,14,17,9,40,0.225000
2025-09-12,Steel Dynamics,37,3,0,40,0.000000
2025-09-12,Steelcase,13,26,1,40,0.025000
2025-09-12,Stericycle,10,8,22,40,0.550000
2025-09-12,Stifel Financial,22,17,1,40,0.025000
2025-09-12,StoneX,16,22,2,40,0.050000
2025-09-12,Stryker,8,22,10,40,0.250000
2025-09-12,Summit Materials,12,25,3,40,0.075000
2025-09-12,Sun Communities,21,17,2,40,0.050000
2025-09-12,Super Micro Computer,38,2,0,40,0.000000
2025-09-12,Surgery Partners,13,23,4,40,0.100000
2025-09-12,Sylvamo,11,21,8,40,0.200000
2025-09-12,Synchrony Financial,21,17,2,40,0.050000
2025-09-12,Synopsys,6,20,14,40,0.350000
2025-09-12,Synovus Financial,15,22,3,40,0.075000
2025-09-12,Sysco,17,19,4,40,0.100000
2025-09-12,T Rowe Price,19,21,0,40,0.000000
2025-09-12,TD Synnex,25,15,0,40,0.000000
2025-09-12,TEGNA,10,28,2,40,0.050000
2025-09-12,TIAA,12,25,3,40,0.075000
2025-09-12,TJX,23,12,5,40,0.125000
2025-09-12,Take-Two Interactive Software,19,18,3,40,0.075000
2025-09-12,Talen Energy,39,0,1,40,0.025000
2025-09-12,Tapestry,17,19,4,40,0.100000
2025-09-12,Targa Resources,27,12,1,40,0.025000
2025-09-12,Target,12,19,9,40,0.225000
2025-09-12,Taylor Morrison Home,21,19,0,40,0.000000
2025-09-12,Teladoc Health,18,18,4,40,0.100000
2025-09-12,Teledyne Technologies,22,17,1,40,0.025000
2025-09-12,Teleflex,14,24,2,40,0.050000
2025-09-12,Telephone & Data Systems,12,23,5,40,0.125000
2025-09-12,TelevisaUnivision,14,14,12,40,0.300000
2025-09-12,Tempur Sealy International,11,24,5,40,0.125000
2025-09-12,Tenet Healthcare,17,19,4,40,0.100000
2025-09-12,Teradyne,21,18,1,40,0.025000
2025-09-12,Terex,15,23,2,40,0.050000
2025-09-12,Tesla,8,25,7,40,0.175000
2025-09-12,Tetra Tech,20,16,4,40,0.100000
2025-09-12,Texas Instruments,12,23,5,40,0.125000
2025-09-12,Texas Roadhouse,8,22,10,40,0.250000
2025-09-12,Textron,18,20,2,40,0.050000
2025-09-12,The Andersons Inc,15,23,2,40,0.050000
2025-09-12,The Coca-Cola Company,10,28,2,40,0.050000
2025-09-12,The Hartford,16,14,10,40,0.250000
2025-09-12,Thermo Fisher Scientific,17,19,4,40,0.100000
2025-09-12,Thor Industries,15,17,8,40,0.200000
2025-09-12,Thrivent Financial for Lutherans,14,20,6,40,0.150000
2025-09-12,Timken,11,26,3,40,0.075000
2025-09-12,Titan Machinery,10,26,4,40,0.100000
2025-09-12,Toast inc,19,16,5,40,0.125000
2025-09-12,Toll Brothers,10,28,2,40,0.050000
2025-09-12,TopBuild,17,23,0,40,0.000000
2025-09-12,Topgolf Callaway Brands,12,21,7,40,0.175000
2025-09-12,Toro Company,16,24,0,40,0.000000
2025-09-12,Tractor Supply,19,18,3,40,0.075000
2025-09-12,TransDigm,21,14,5,40,0.125000
2025-09-12,TransUnion,19,16,5,40,0.125000
2025-09-12,Travelers Insurance,13,18,9,40,0.225000
2025-09-12,TreeHouse Foods,11,22,7,40,0.175000
2025-09-12,Tri Pointe Homes,14,25,1,40,0.025000
2025-09-12,TriNet Group,21,17,2,40,0.050000
2025-09-12,Trimble,11,24,5,40,0.125000
2025-09-12,Trinity Industries,16,16,8,40,0.200000
2025-09-12,TruStage,27,11,2,40,0.050000
2025-09-12,Truist Financial,20,18,2,40,0.050000
2025-09-12,Tutor Perini Corporation,21,16,3,40,0.075000
2025-09-12,Twilio,18,19,3,40,0.075000
2025-09-12,Tyson Foods,14,17,9,40,0.225000
2025-09-12,U-Haul,5,6,29,40,0.725000
2025-09-12,UFP Industries,14,24,2,40,0.050000
2025-09-12,UGI Utilities Inc,19,13,8,40,0.200000
2025-09-12,UL Solutions,35,2,3,40,0.075000
2025-09-12,UPS,15,15,10,40,0.250000
2025-09-12,US Bancorp,17,23,0,40,0.000000
2025-09-12,US Foods,19,18,3,40,0.075000
2025-09-12,USAA,16,15,9,40,0.225000
2025-09-12,Uber,6,19,15,40,0.375000
2025-09-12,Ulta Beauty,36,2,2,40,0.050000
2025-09-12,Under Armour,11,25,4,40,0.100000
2025-09-12,Union Pacific,14,18,8,40,0.200000
2025-09-12,United Airlines,33,1,6,40,0.150000
2025-09-12,United Natural Foods,37,2,1,40,0.025000
2025-09-12,United Rentals,39,1,0,40,0.000000
2025-09-12,United States Steel,26,10,4,40,0.100000
2025-09-12,UnitedHealth,13,22,5,40,0.125000
2025-09-12,Universal Corporation,15,24,1,40,0.025000
2025-09-12,Universal Health Services,20,14,6,40,0.150000
2025-09-12,Unum Group,16,20,4,40,0.100000
2025-09-12,Upbound Group,30,10,0,40,0.000000
2025-09-12,Urban Outfitters,18,20,2,40,0.050000
2025-09-12,V2X,23,15,2,40,0.050000
2025-09-12,VF Corporation,12,23,5,40,0.125000
2025-09-12,VICI Properties,18,18,4,40,0.100000
2025-09-12,Vail Resorts,11,12,17,40,0.425000
2025-09-12,Valero Energy,33,3,4,40,0.100000
2025-09-12,Valley National Bancorp,10,23,7,40,0.175000
2025-09-12,Valmont Industries,24,13,3,40,0.075000
2025-09-12,Valvoline inc,15,24,1,40,0.025000
2025-09-12,Ventas inc,23,17,0,40,0.000000
2025-09-12,Verisk Analytics,21,14,5,40,0.125000
2025-09-12,Verizon,19,17,4,40,0.100000
2025-09-12,Vertex Pharmaceuticals,24,14,2,40,0.050000
2025-09-12,Vertiv,29,9,2,40,0.050000
2025-09-12,Viasat,19,17,4,40,0.100000
2025-09-12,Viatris,12,19,9,40,0.225000
2025-09-12,Victorias Secret,12,18,10,40,0.250000
2025-09-12,Visa,9,14,17,40,0.425000
2025-09-12,Vishay Intertechnology,12,22,6,40,0.150000
2025-09-12,Vista Outdoor,16,20,4,40,0.100000
2025-09-12,Visteon,18,20,2,40,0.050000
2025-09-12,Vistra,20,17,3,40,0.075000
2025-09-12,Vontier,20,18,2,40,0.050000
2025-09-12,Voya Financial,21,16,3,40,0.075000
2025-09-12,Vulcan Materials,13,20,7,40,0.175000
2025-09-12,WEC Energy,38,1,1,40,0.025000
2025-09-12,WESCO International,19,20,1,40,0.025000
2025-09-12,WEX,18,18,4,40,0.100000
2025-09-12,WR Berkley,16,22,2,40,0.050000
2025-09-12,WW Grainger,20,17,3,40,0.075000
2025-09-12,Wabash National,16,12,12,40,0.300000
2025-09-12,Walgreens,8,22,10,40,0.250000
2025-09-12,Walmart,11,10,19,40,0.475000
2025-09-12,Walt Disney,18,19,3,40,0.075000
2025-09-12,Warner Bros Discovery,8,26,6,40,0.150000
2025-09-12,Warner Music Group,10,28,2,40,0.050000
2025-09-12,Waters Corporation,19,18,3,40,0.075000
2025-09-12,Watsco,15,19,6,40,0.150000
2025-09-12,Wayfair,22,16,2,40,0.050000
2025-09-12,Webster Financial,17,21,2,40,0.050000
2025-09-12,Weis Markets,11,24,5,40,0.125000
2025-09-12,Wells Fargo,34,1,5,40,0.125000
2025-09-12,Welltower,31,9,0,40,0.000000
2025-09-12,Werner Enterprises,19,12,9,40,0.225000
2025-09-12,West Pharmaceutical Services,17,21,2,40,0.050000
2025-09-12,Western & Southern Financial,13,23,4,40,0.100000
2025-09-12,Western Alliance Bancorp,14,16,10,40,0.250000
2025-09-12,Western Digital,16,17,7,40,0.175000
2025-09-12,Western Midstream Partners,21,19,0,40,0.000000
2025-09-12,Western Union,15,23,2,40,0.050000
2025-09-12,Westinghouse Air Brake Technologies,14,21,5,40,0.125000
2025-09-12,Westlake Corporation,10,23,7,40,0.175000
2025-09-12,Weyerhaeuser,17,20,3,40,0.075000
2025-09-12,Whirlpool,13,20,7,40,0.175000
2025-09-12,Williams,10,21,9,40,0.225000
2025-09-12,Williams-Sonoma,14,21,5,40,0.125000
2025-09-12,Winnebago Industries,14,23,3,40,0.075000
2025-09-12,Wintrust Financial,17,19,4,40,0.100000
2025-09-12,Woodward inc,18,22,0,40,0.000000
2025-09-12,Workday,16,16,8,40,0.200000
2025-09-12,World Kinect,17,20,3,40,0.075000
2025-09-12,Worthington Enterprises,18,21,1,40,0.025000
2025-09-12,Wynn Resorts,15,18,7,40,0.175000
2025-09-12,XPO,16,19,5,40,0.125000
2025-09-12,Xcel Energy,32,5,3,40,0.075000
2025-09-12,Xerox,15,21,4,40,0.100000
2025-09-12,Xylem Inc,22,16,2,40,0.050000
2025-09-12,Yum Brands,11,28,1,40,0.025000
2025-09-12,Yum China,18,17,5,40,0.125000
2025-09-12,Zebra Technologies,20,17,3,40,0.075000
2025-09-12,Zimmer Biomet,14,23,3,40,0.075000
2025-09-12,Zions Bancorp,19,16,5,40,0.125000
2025-09-12,Zoetis,28,11,1,40,0.025000
2025-09-12,Zoom Video Communications,14,21,5,40,0.125000
2025-09-12,eXp World,18,19,3,40,0.075000
2025-09-12,iHeartMedia,12,25,3,40,0.075000
2025-09-13,3M,23,14,3,40,0.075000
2025-09-13,A O Smith,16,23,1,40,0.025000
2025-09-13,A-Mark Precious Metals,37,3,0,40,0.000000
2025-09-13,ABM Industries,8,22,10,40,0.250000
2025-09-13,ADT,13,20,7,40,0.175000
2025-09-13,AECOM,23,15,2,40,0.050000
2025-09-13,AES,17,17,6,40,0.150000
2025-09-13,AGCO,17,20,3,40,0.075000
2025-09-13,AGNC Investment,15,18,7,40,0.175000
2025-09-13,AMC Entertainment,34,3,3,40,0.075000
2025-09-13,AMC Networks,14,18,8,40,0.200000
2025-09-13,AMN Healthcare Services,8,23,9,40,0.225000
2025-09-13,APA,19,15,6,40,0.150000
2025-09-13,APi Group,19,18,3,40,0.075000
2025-09-13,ARKO,8,30,2,40,0.050000
2025-09-13,ASGN,14,16,10,40,0.250000
2025-09-13,AT&T,11,25,4,40,0.100000
2025-09-13,ATI inc,19,20,1,40,0.025000
2025-09-13,AbbVie,20,12,8,40,0.200000
2025-09-13,Abbott Laboratories,16,18,6,40,0.150000
2025-09-13,Abercrombie & Fitch,13,25,2,40,0.050000
2025-09-13,Academy Sports and Outdoors,13,24,3,40,0.075000
2025-09-13,Acadia Healthcare,14,19,7,40,0.175000
2025-09-13,Acuity Inc,21,18,1,40,0.025000
2025-09-13,Adams Resources & Energy,19,7,2,28,0.071429
2025-09-13,AdaptHealth,17,21,2,40,0.050000
2025-09-13,Adobe,17,18,5,40,0.125000
2025-09-13,Advance Auto Parts,10,20,10,40,0.250000
2025-09-13,Advanced Drainage Systems,35,2,3,40,0.075000
2025-09-13,Advanced Micro Devices,28,5,7,40,0.175000
2025-09-13,Advantage Solutions,36,0,4,40,0.100000
2025-09-13,Aflac,13,15,12,40,0.300000
2025-09-13,Agilent Technologies,19,20,1,40,0.025000
2025-09-13,Agilon Health,12,23,5,40,0.125000
2025-09-13,Air Lease,8,30,2,40,0.050000
2025-09-13,Air Products & Chemicals,14,21,5,40,0.125000
2025-09-13,Airbnb,16,18,6,40,0.150000
2025-09-13,Akamai Technologies,17,19,4,40,0.100000
2025-09-13,Alaska Air,9,31,0,40,0.000000
2025-09-13,Albemarle Corporation,16,21,3,40,0.075000
2025-09-13,Albertsons,11,27,2,40,0.050000
2025-09-13,Alcoa Corporation,6,26,8,40,0.200000
2025-09-13,Alexandria Real Estate Equities,14,20,6,40,0.150000
2025-09-13,Alight Solutions,12,23,5,40,0.125000
2025-09-13,Align Technology,8,21,11,40,0.275000
2025-09-13,Allegiant Travel Company,14,25,1,40,0.025000
2025-09-13,Alliance Resource Partners,13,18,9,40,0.225000
2025-09-13,Alliant Energy,34,4,2,40,0.050000
2025-09-13,Allison Transmission,14,19,7,40,0.175000
2025-09-13,Allstate,16,20,4,40,0.100000
2025-09-13,Ally Financial,14,25,1,40,0.025000
2025-09-13,Alpha Metallurgical Resources,19,16,5,40,0.125000
2025-09-13,Alphabet,21,14,5,40,0.125000
2025-09-13,Altice,13,22,5,40,0.125000
2025-09-13,Altria Group,20,18,2,40,0.050000
2025-09-13,Amazon,34,1,5,40,0.125000
2025-09-13,Ameren,17,18,5,40,0.125000
2025-09-13,American Airlines,16,19,5,40,0.125000
2025-09-13,American Axle & Manufacturing,12,26,2,40,0.050000
2025-09-13,American Eagle Outfitters,20,18,2,40,0.050000
2025-09-13,American Electric Power,17,19,4,40,0.100000
2025-09-13,American Express,21,16,3,40,0.075000
2025-09-13,American Family Insurance,23,13,4,40,0.100000
2025-09-13,American Financial,24,12,4,40,0.100000
2025-09-13,American International Group,20,19,1,40,0.025000
2025-09-13,American Tower,19,16,5,40,0.125000
2025-09-13,American Water Works,22,15,3,40,0.075000
2025-09-13,Americold Realty Trust,37,2,1,40,0.025000
2025-09-13,Ameriprise Financial,26,11,3,40,0.075000
2025-09-13,Ametek,25,15,0,40,0.000000
2025-09-13,Amgen,27,12,1,40,0.025000
2025-09-13,Amica Mutual Insurance,12,26,2,40,0.050000
2025-09-13,Amkor Technology,17,22,1,40,0.025000
2025-09-13,Amphenol,21,19,0,40,0.000000
2025-09-13,Analog Devices,18,22,0,40,0.000000
2025-09-13,Antero Resources,19,20,1,40,0.025000
2025-09-13,Anywhere Real Estate Inc,18,19,3,40,0.075000
2025-09-13,Apollo Global Management,10,26,4,40,0.100000
2025-09-13,AppLovin,15,22,3,40,0.075000
2025-09-13,Apple,10,24,6,40,0.150000
2025-09-13,Applied Industrial Technologies,16,23,1,40,0.025000
2025-09-13,Applied Materials,8,16,16,40,0.400000
2025-09-13,AptarGroup,16,23,1,40,0.025000
2025-09-13,Aramark,23,16,1,40,0.025000
2025-09-13,ArcBest,15,20,5,40,0.125000
2025-09-13,Arch Resources,30,6,4,40,0.100000
2025-09-13,Archer Daniels Midland,20,17,3,40,0.075000
2025-09-13,Ares Management,21,16,3,40,0.075000
2025-09-13,Arista Networks,18,20,2,40,0.050000
2025-09-13,Arrow Electronics,21,13,6,40,0.150000
2025-09-13,Arthur J Gallagher,15,23,2,40,0.050000
2025-09-13,Asbury Automotive Group,12,24,4,40,0.100000
2025-09-13,Assurant,25,11,4,40,0.100000
2025-09-13,Atkore,19,19,2,40,0.050000
2025-09-13,Atlassian,16,18,6,40,0.150000
2025-09-13,Atmos Energy,37,2,1,40,0.025000
2025-09-13,Auto-Owners Insurance,16,19,5,40,0.125000
2025-09-13,AutoNation,18,14,8,40,0.200000
2025-09-13,AutoZone,20,18,2,40,0.050000
2025-09-13,Autodesk,17,21,2,40,0.050000
2025-09-13,Autoliv,26,13,1,40,0.025000
2025-09-13,Automatic Data Processing,29,11,0,40,0.000000
2025-09-13,AvalonBay Communities,20,16,4,40,0.100000
2025-09-13,Avantor,17,15,8,40,0.200000
2025-09-13,Avery Dennison,16,24,0,40,0.000000
2025-09-13,Avient,12,25,3,40,0.075000
2025-09-13,Avis Budget,10,23,7,40,0.175000
2025-09-13,Avnet,12,26,2,40,0.050000
2025-09-13,BJs Wholesale Club,12,24,4,40,0.100000
2025-09-13,BOK Financial,22,13,5,40,0.125000
2025-09-13,BWX Technologies,27,13,0,40,0.000000
2025-09-13,Baker Hughes,20,20,0,40,0.000000
2025-09-13,Ball,16,18,6,40,0.150000
2025-09-13,Bank of America,13,21,6,40,0.150000
2025-09-13,Bank of New York Mellon,20,17,3,40,0.075000
2025-09-13,Bath & Body Works,18,13,9,40,0.225000
2025-09-13,Baxter International,10,22,8,40,0.200000
2025-09-13,Beacon Roofing Supply,9,23,8,40,0.200000
2025-09-13,Becton Dickinson,24,14,2,40,0.050000
2025-09-13,Belden,10,25,5,40,0.125000
2025-09-13,Benchmark Electronics,18,18,4,40,0.100000
2025-09-13,Berkshire Hathaway,9,19,12,40,0.300000
2025-09-13,Best Buy,33,0,7,40,0.175000
2025-09-13,Big Lots,6,31,3,40,0.075000
2025-09-13,Bio-Rad Laboratories,14,22,4,40,0.100000
2025-09-13,Biogen,22,17,1,40,0.025000
2025-09-13,BlackRock,13,26,1,40,0.025000
2025-09-13,Blackstone,16,20,4,40,0.100000
2025-09-13,Bloomin Brands,7,25,8,40,0.200000
2025-09-13,BlueLinx,16,19,5,40,0.125000
2025-09-13,Boeing,7,10,23,40,0.575000
2025-09-13,Boise Cascade,10,19,11,40,0.275000
2025-09-13,Booking Holdings,27,13,0,40,0.000000
2025-09-13,Booz Allen Hamilton,16,21,3,40,0.075000
2025-09-13,BorgWarner,27,10,3,40,0.075000
2025-09-13,Boston Properties,9,22,9,40,0.225000
2025-09-13,Boston Scientific,12,26,2,40,0.050000
2025-09-13,Boyd Gaming,17,21,2,40,0.050000
2025-09-13,Bread Financial,23,14,3,40,0.075000
2025-09-13,BrightSpring Health Services,20,16,4,40,0.100000
2025-09-13,BrightView Holdings,20,18,2,40,0.050000
2025-09-13,Brighthouse Financial,13,24,3,40,0.075000
2025-09-13,Brinker International,19,21,0,40,0.000000
2025-09-13,Brinks Company,11,4,6,21,0.285714
2025-09-13,Bristol-Myers Squibb,12,22,6,40,0.150000
2025-09-13,Broadcom,17,18,5,40,0.125000
2025-09-13,Broadridge Financial Solutions,34,6,0,40,0.000000
2025-09-13,Brookdale Senior Living,12,20,8,40,0.200000
2025-09-13,Brown & Brown,17,19,4,40,0.100000
2025-09-13,Brown-Forman,10,21,9,40,0.225000
2025-09-13,Bruker,12,22,6,40,0.150000
2025-09-13,Brunswick,4,28,8,40,0.200000
2025-09-13,Builders FirstSource,20,19,1,40,0.025000
2025-09-13,Burlington Stores,19,20,1,40,0.025000
2025-09-13,CACI International,25,12,3,40,0.075000
2025-09-13,CBRE Group,19,19,2,40,0.050000
2025-09-13,CDW,20,16,4,40,0.100000
2025-09-13,CF Industries,26,14,0,40,0.000000
2025-09-13,CH Robinson Worldwide,21,16,3,40,0.075000
2025-09-13,CHS,12,24,4,40,0.100000
2025-09-13,CME Group,22,14,4,40,0.100000
2025-09-13,CMS Energy,37,3,0,40,0.000000
2025-09-13,CNO Financial Group,16,23,1,40,0.025000
2025-09-13,CNX Resources,19,19,2,40,0.050000
2025-09-13,CSX,16,18,6,40,0.150000
2025-09-13,CVS Health,18,15,7,40,0.175000
2025-09-13,Cabot Corporation,17,22,1,40,0.025000
2025-09-13,Cadence,11,26,3,40,0.075000
2025-09-13,Caesars Entertainment,35,5,0,40,0.000000
2025-09-13,Cal-Maine Foods,28,10,2,40,0.050000
2025-09-13,Caleres inc,19,17,4,40,0.100000
2025-09-13,California Resources,16,21,3,40,0.075000
2025-09-13,Calumet,7,9,24,40,0.600000
2025-09-13,Campbell Soup,18,18,4,40,0.100000
2025-09-13,Camping World,15,20,5,40,0.125000
2025-09-13,Capital One,16,12,12,40,0.300000
2025-09-13,CarMax,8,29,3,40,0.075000
2025-09-13,Cardinal Health,20,12,8,40,0.200000
2025-09-13,Carlisle Companies,12,22,6,40,0.150000
2025-09-13,Carlyle Group,9,26,5,40,0.125000
2025-09-13,Carpenter Technology,19,19,2,40,0.050000
2025-09-13,Carrier Global,14,16,10,40,0.250000
2025-09-13,Carters inc,11,22,2,35,0.057143
2025-09-13,Carvana,20,17,3,40,0.075000
2025-09-13,Caseys General Stores,13,22,5,40,0.125000
2025-09-13,Catalent,10,25,5,40,0.125000
2025-09-13,Caterpillar,26,9,5,40,0.125000
2025-09-13,Cboe Global Markets,11,28,1,40,0.025000
2025-09-13,Celanese,15,15,10,40,0.250000
2025-09-13,Cencora,22,15,3,40,0.075000
2025-09-13,Centene,14,20,6,40,0.150000
2025-09-13,CenterPoint Energy,28,6,6,40,0.150000
2025-09-13,Central Garden & Pet,5,35,0,40,0.000000
2025-09-13,Century Communities,13,23,4,40,0.100000
2025-09-13,ChampionX,19,20,1,40,0.025000
2025-09-13,Charles River Laboratories International,17,16,7,40,0.175000
2025-09-13,Charles Schwab,16,20,4,40,0.100000
2025-09-13,Chart Industries,13,23,4,40,0.100000
2025-09-13,Charter Communications,12,22,6,40,0.150000
2025-09-13,Cheesecake Factory,14,18,8,40,0.200000
2025-09-13,Chefs Warehouse,19,18,3,40,0.075000
2025-09-13,Chemours,18,12,10,40,0.250000
2025-09-13,Cheniere Energy,39,1,0,40,0.000000
2025-09-13,Chevron,21,14,5,40,0.125000
2025-09-13,Chewy,14,17,9,40,0.225000
2025-09-13,Chipotle Mexican Grill,17,20,3,40,0.075000
2025-09-13,Chord Energy,38,0,2,40,0.050000
2025-09-13,Church & Dwight,17,22,1,40,0.025000
2025-09-13,Ciena,18,20,2,40,0.050000
2025-09-13,Cigna,15,20,5,40,0.125000
2025-09-13,Cincinnati Financial,16,19,5,40,0.125000
2025-09-13,Cinemark,12,22,6,40,0.150000
2025-09-13,Cintas,28,10,2,40,0.050000
2025-09-13,Cisco Systems,26,12,2,40,0.050000
2025-09-13,Citigroup,16,19,5,40,0.125000
2025-09-13,Citizens Financial Group,14,25,1,40,0.025000
2025-09-13,Civitas Resources,13,16,11,40,0.275000
2025-09-13,Clean Harbors,35,1,4,40,0.100000
2025-09-13,Clear Channel Outdoor Hldgs,8,0,2,10,0.200000
2025-09-13,Cleveland-Cliffs,16,16,8,40,0.200000
2025-09-13,Clorox,22,13,5,40,0.125000
2025-09-13,Cognizant Technology Solutions,40,0,0,40,0.000000
2025-09-13,Coherent,18,19,3,40,0.075000
2025-09-13,Coinbase Global,15,21,4,40,0.100000
2025-09-13,Colgate-Palmolive,13,17,10,40,0.250000
2025-09-13,Columbia Banking System,16,22,2,40,0.050000
2025-09-13,Columbia Sportswear,12,17,11,40,0.275000
2025-09-13,Comcast,23,12,5,40,0.125000
2025-09-13,Comerica,20,16,4,40,0.100000
2025-09-13,Comfort Systems USA,40,0,0,40,0.000000
2025-09-13,CommScope,16,23,1,40,0.025000
2025-09-13,Commercial Metals,14,17,9,40,0.225000
2025-09-13,Community Health Systems,17,18,5,40,0.125000
2025-09-13,Compass,10,28,2,40,0.050000
2025-09-13,Conagra Brands,16,23,1,40,0.025000
2025-09-13,Concentrix,19,16,5,40,0.125000
2025-09-13,Conduent,13,18,9,40,0.225000
2025-09-13,ConocoPhillips,15,17,8,40,0.200000
2025-09-13,Consol Energy,32,5,3,40,0.075000
2025-09-13,Consolidated Edison,12,22,6,40,0.150000
2025-09-13,Constellation Brands,10,12,18,40,0.450000
2025-09-13,Constellation Energy,32,4,4,40,0.100000
2025-09-13,Continental Resources,19,13,8,40,0.200000
2025-09-13,Cooper Cos,7,29,4,40,0.100000
2025-09-13,Cooper-Standard,9,30,1,40,0.025000
2025-09-13,Copart,20,19,1,40,0.025000
2025-09-13,Core & Main,13,16,11,40,0.275000
2025-09-13,Cornerstone Building Brands,16,19,5,40,0.125000
2025-09-13,Corning,16,22,2,40,0.050000
2025-09-13,Corpay,18,22,0,40,0.000000
2025-09-13,Corteva,11,28,1,40,0.025000
2025-09-13,Costco,22,12,6,40,0.150000
2025-09-13,Coterra Energy,38,1,1,40,0.025000
2025-09-13,Coty,11,18,11,40,0.275000
2025-09-13,Country Financial,13,25,2,40,0.050000
2025-09-13,Coupang,17,18,5,40,0.125000
2025-09-13,Cracker Barrel Old Country Store,3,30,7,40,0.175000
2025-09-13,Crocs,15,20,5,40,0.125000
2025-09-13,CrossAmerica Partners,12,26,2,40,0.050000
2025-09-13,CrowdStrike,20,11,9,40,0.225000
2025-09-13,Crown Castle,19,19,2,40,0.050000
2025-09-13,Crown Holdings,16,20,4,40,0.100000
2025-09-13,Cullen Frost Bankers,17,20,3,40,0.075000
2025-09-13,Cummins,15,16,9,40,0.225000
2025-09-13,Curtiss-Wright,24,15,1,40,0.025000
2025-09-13,DR Horton,25,13,2,40,0.050000
2025-09-13,DTE Energy,34,3,3,40,0.075000
2025-09-13,DXC Technology,20,19,1,40,0.025000
2025-09-13,DaVita,16,13,11,40,0.275000
2025-09-13,Dana Incorporated,21,14,5,40,0.125000
2025-09-13,Danaher,25,12,3,40,0.075000
2025-09-13,Darden Restaurants,18,16,6,40,0.150000
2025-09-13,Darling Ingredients,39,0,1,40,0.025000
2025-09-13,Deckers Outdoor,24,14,2,40,0.050000
2025-09-13,Deere,11,22,7,40,0.175000
2025-09-13,Delek US,20,16,4,40,0.100000
2025-09-13,Dell Technologies,13,21,6,40,0.150000
2025-09-13,Delta Air Lines,8,18,14,40,0.350000
2025-09-13,Dentsply Sirona,13,27,0,40,0.000000
2025-09-13,Designer Brands,12,24,4,40,0.100000
2025-09-13,Devon Energy,37,2,1,40,0.025000
2025-09-13,DexCom,17,21,2,40,0.050000
2025-09-13,Diamondback Energy,36,0,4,40,0.100000
2025-09-13,Dicks Sporting Goods,12,26,2,40,0.050000
2025-09-13,Diebold Nixdorf,15,24,1,40,0.025000
2025-09-13,Digital Realty Trust,38,2,0,40,0.000000
2025-09-13,Dillards,16,14,10,40,0.250000
2025-09-13,DocuSign,18,15,7,40,0.175000
2025-09-13,Dollar General,5,20,15,40,0.375000
2025-09-13,Dollar Tree,20,16,4,40,0.100000
2025-09-13,Dominion Energy,25,8,7,40,0.175000
2025-09-13,Dominos Pizza inc,17,13,6,36,0.166667
2025-09-13,Domtar,9,24,7,40,0.175000
2025-09-13,Donaldson Company,28,12,0,40,0.000000
2025-09-13,DoorDash,17,14,9,40,0.225000
2025-09-13,Dover Corporation,22,15,3,40,0.075000
2025-09-13,DraftKings,26,14,0,40,0.000000
2025-09-13,Dream Finders Homes,38,1,1,40,0.025000
2025-09-13,Dropbox,20,18,2,40,0.050000
2025-09-13,DuPont,15,15,10,40,0.250000
2025-09-13,Duke Energy,36,1,3,40,0.075000
2025-09-13,Dycom Industries,14,22,4,40,0.100000
2025-09-13,EMCOR Group,15,23,2,40,0.050000
2025-09-13,EOG Resources,22,18,0,40,0.000000
2025-09-13,EPAM Systems,19,18,3,40,0.075000
2025-09-13,EQT,19,19,2,40,0.050000
2025-09-13,ESAB,13,25,2,40,0.050000
2025-09-13,East West Bancorp,19,20,1,40,0.025000
2025-09-13,Eastman Chemical,14,18,8,40,0.200000
2025-09-13,Ebay,14,22,4,40,0.100000
2025-09-13,EchoStar,10,22,8,40,0.200000
2025-09-13,Ecolab,27,11,2,40,0.050000
2025-09-13,Edison International,11,20,9,40,0.225000
2025-09-13,Edward Jones,16,16,8,40,0.200000
2025-09-13,Edwards Lifesciences,13,15,12,40,0.300000
2025-09-13,Elanco Animal Health,16,22,2,40,0.050000
2025-09-13,Electronic Arts,12,23,5,40,0.125000
2025-09-13,Elevance Health,22,13,5,40,0.125000
2025-09-13,Eli Lilly,7,23,10,40,0.250000
2025-09-13,Emerson Electric,26,13,1,40,0.025000
2025-09-13,EnLink Midstream,17,19,4,40,0.100000
2025-09-13,Encompass Health,13,23,4,40,0.100000
2025-09-13,Endeavor Group,14,22,4,40,0.100000
2025-09-13,EnerSys,19,21,0,40,0.000000
2025-09-13,Energizer,38,1,1,40,0.025000
2025-09-13,Energy Transfer,32,1,7,40,0.175000
2025-09-13,Ensign Group,26,12,2,40,0.050000
2025-09-13,Entegris,21,16,3,40,0.075000
2025-09-13,Entergy,21,16,3,40,0.075000
2025-09-13,Enterprise Products Partners,21,15,4,40,0.100000
2025-09-13,Envista,16,21,3,40,0.075000
2025-09-13,Equifax,24,11,5,40,0.125000
2025-09-13,Equinix,29,8,3,40,0.075000
2025-09-13,Equitable,23,14,3,40,0.075000
2025-09-13,Equity Residential,23,16,1,40,0.025000
2025-09-13,Erie Insurance,18,13,9,40,0.225000
2025-09-13,Estée Lauder,18,16,6,40,0.150000
2025-09-13,Etsy,11,9,20,40,0.500000
2025-09-13,Euronet Worldwide,17,20,3,40,0.075000
2025-09-13,Evergy,25,12,3,40,0.075000
2025-09-13,Eversource Energy,31,5,4,40,0.100000
2025-09-13,Exact Sciences,16,15,9,40,0.225000
2025-09-13,Exelon,16,23,1,40,0.025000
2025-09-13,Expand Energy,40,0,0,40,0.000000
2025-09-13,Expedia,22,17,1,40,0.025000
2025-09-13,Expeditors International of Washington,20,19,1,40,0.025000
2025-09-13,Extra Space Storage,16,22,2,40,0.050000
2025-09-13,Exxon Mobil,13,24,3,40,0.075000
2025-09-13,F5,25,13,2,40,0.050000
2025-09-13,FM Global,16,15,9,40,0.225000
2025-09-13,FMC Corporation,18,22,0,40,0.000000
2025-09-13,FTI Consulting,12,20,8,40,0.200000
2025-09-13,Fannie Mae,8,30,2,40,0.050000
2025-09-13,Farmers Insurance Exchange,10,17,13,40,0.325000
2025-09-13,Fastenal,22,15,3,40,0.075000
2025-09-13,FedEx,13,21,6,40,0.150000
2025-09-13,Federated Mutual Insurance,12,11,1,24,0.041667
2025-09-13,Fidelity National Financial,14,20,6,40,0.150000
2025-09-13,Fidelity National Information Services,24,13,3,40,0.075000
2025-09-13,Fifth Third Bancorp,13,12,15,40,0.375000
2025-09-13,First American Financial,21,16,3,40,0.075000
2025-09-13,First Citizens BancShares,10,28,2,40,0.050000
2025-09-13,First Horizon,20,19,1,40,0.025000
2025-09-13,First National of Nebraska,18,21,1,40,0.025000
2025-09-13,First Solar,26,13,1,40,0.025000
2025-09-13,FirstCash,12,21,7,40,0.175000
2025-09-13,FirstEnergy,20,15,5,40,0.125000
2025-09-13,Fiserv,20,16,4,40,0.100000
2025-09-13,Five Below,18,20,2,40,0.050000
2025-09-13,Flagstar Financial,13,22,5,40,0.125000
2025-09-13,Floor & Decor,21,16,3,40,0.075000
2025-09-13,Flowers Foods,8,23,9,40,0.225000
2025-09-13,Flowserve,15,21,4,40,0.100000
2025-09-13,Fluor,18,16,6,40,0.150000
2025-09-13,Foot Locker,4,31,5,40,0.125000
2025-09-13,Ford Motor,11,21,8,40,0.200000
2025-09-13,Fortinet,19,14,7,40,0.175000
2025-09-13,Fortive,16,18,6,40,0.150000
2025-09-13,Fortune Brands Innovations,12,24,4,40,0.100000
2025-09-13,Franklin Resources,14,23,3,40,0.075000
2025-09-13,Freddie Mac,9,23,8,40,0.200000
2025-09-13,Freeport-McMoRan,17,16,7,40,0.175000
2025-09-13,Frontier Airlines,14,18,8,40,0.200000
2025-09-13,Frontier Communications,17,22,1,40,0.025000
2025-09-13,G-III Apparel Group,14,23,3,40,0.075000
2025-09-13,GE HealthCare Technologies,24,16,0,40,0.000000
2025-09-13,GMS,15,25,0,40,0.000000
2025-09-13,GXO Logistics,14,21,5,40,0.125000
2025-09-13,GameStop,19,15,6,40,0.150000
2025-09-13,Gannett,17,13,10,40,0.250000
2025-09-13,Garrett Motion inc,15,20,5,40,0.125000
2025-09-13,Gartner,18,20,2,40,0.050000
2025-09-13,Gen Digital,20,18,2,40,0.050000
2025-09-13,Generac,22,13,5,40,0.125000
2025-09-13,General Dynamics,36,3,1,40,0.025000
2025-09-13,General Electric,11,29,0,40,0.000000
2025-09-13,General Mills,19,20,1,40,0.025000
2025-09-13,General Motors,23,13,4,40,0.100000
2025-09-13,Genesis Energy,36,3,1,40,0.025000
2025-09-13,Genuine Parts,15,23,2,40,0.050000
2025-09-13,Genworth Financial,20,19,1,40,0.025000
2025-09-13,Gilead Sciences,17,19,4,40,0.100000
2025-09-13,Global Partners,18,18,4,40,0.100000
2025-09-13,Global Payments,17,19,4,40,0.100000
2025-09-13,Globe Life,17,17,6,40,0.150000
2025-09-13,GoDaddy,15,23,2,40,0.050000
2025-09-13,Goldman Sachs,14,22,4,40,0.100000
2025-09-13,Goodyear Tire & Rubber,14,23,3,40,0.075000
2025-09-13,Graham Holdings Company,22,16,2,40,0.050000
2025-09-13,Granite Construction,21,18,1,40,0.025000
2025-09-13,Graphic Packaging,12,21,7,40,0.175000
2025-09-13,Gray Television,14,20,6,40,0.150000
2025-09-13,Graybar Electric,12,22,6,40,0.150000
2025-09-13,Green Plains inc,18,18,4,40,0.100000
2025-09-13,Greenbrier,9,17,14,40,0.350000
2025-09-13,Greif,10,26,4,40,0.100000
2025-09-13,Griffon Corporation,16,22,2,40,0.050000
2025-09-13,Grocery Outlet Holding,16,23,1,40,0.025000
2025-09-13,Group 1 Automotive,14,21,5,40,0.125000
2025-09-13,Guardian Life insurance,19,21,0,40,0.000000
2025-09-13,Guess inc,14,24,2,40,0.050000
2025-09-13,H B Fuller,13,22,5,40,0.125000
2025-09-13,HCA Healthcare,25,14,1,40,0.025000
2025-09-13,HEICO,19,17,4,40,0.100000
2025-09-13,HF Sinclair,13,23,4,40,0.100000
2025-09-13,Halliburton,8,17,15,40,0.375000
2025-09-13,Hanesbrands,14,24,2,40,0.050000
2025-09-13,Hanover Insurance Group,15,23,2,40,0.050000
2025-09-13,Harley-Davidson,13,25,2,40,0.050000
2025-09-13,Hasbro,14,23,3,40,0.075000
2025-09-13,Hawaiian Airlines inc,13,26,1,40,0.025000
2025-09-13,Hawaiian Electric Industries,17,20,3,40,0.075000
2025-09-13,Helmerich & Payne,8,26,6,40,0.150000
2025-09-13,Henry Schein,21,18,1,40,0.025000
2025-09-13,Herc Rentals,18,16,6,40,0.150000
2025-09-13,Hershey,17,18,5,40,0.125000
2025-09-13,Hertz,26,12,2,40,0.050000
2025-09-13,Hewlett Packard,10,28,2,40,0.050000
2025-09-13,Hewlett Packard Enterprise,8,31,1,40,0.025000
2025-09-13,Hillenbrand,18,20,2,40,0.050000
2025-09-13,Hilton Grand Vacations,39,1,0,40,0.000000
2025-09-13,Hilton Worldwide,22,17,1,40,0.025000
2025-09-13,Hologic,12,23,5,40,0.125000
2025-09-13,Home Depot,17,13,10,40,0.250000
2025-09-13,Honeywell,19,17,4,40,0.100000
2025-09-13,Hormel Foods,11,27,2,40,0.050000
2025-09-13,Host Hotels & Resorts,14,25,1,40,0.025000
2025-09-13,Hovnanian Enterprises,12,22,6,40,0.150000
2025-09-13,Howmet Aerospace,23,17,0,40,0.000000
2025-09-13,Hub Group,12,19,9,40,0.225000
2025-09-13,Hubbell,25,10,5,40,0.125000
2025-09-13,Humana,20,14,6,40,0.150000
2025-09-13,Huntington Bancshares,17,22,1,40,0.025000
2025-09-13,Huntington Ingalls Industries,22,14,4,40,0.100000
2025-09-13,Huntsman,6,23,11,40,0.275000
2025-09-13,Hyatt Hotels,14,25,1,40,0.025000
2025-09-13,Hyster-Yale,15,21,4,40,0.100000
2025-09-13,IAC,13,22,5,40,0.125000
2025-09-13,IBM,17,17,6,40,0.150000
2025-09-13,IDEX,18,17,5,40,0.125000
2025-09-13,IDEXX Laboratories,21,16,3,40,0.075000
2025-09-13,IQVIA,25,13,2,40,0.050000
2025-09-13,ITT,12,21,7,40,0.175000
2025-09-13,Icahn Enterprises,10,16,14,40,0.350000
2025-09-13,Illinois Tool Works,23,15,2,40,0.050000
2025-09-13,Illumina inc,16,23,1,40,0.025000
2025-09-13,Incyte,20,18,2,40,0.050000
2025-09-13,Ingersoll Rand,20,15,5,40,0.125000
2025-09-13,Ingles Markets,10,22,8,40,0.200000
2025-09-13,Ingram Micro,12,14,14,40,0.350000
2025-09-13,Ingredion,24,15,1,40,0.025000
2025-09-13,Insight Enterprises,14,20,6,40,0.150000
2025-09-13,Insperity,18,17,5,40,0.125000
2025-09-13,Instacart,13,23,4,40,0.100000
2025-09-13,Installed Building Products,10,26,4,40,0.100000
2025-09-13,Intel,11,21,8,40,0.200000
2025-09-13,Interactive Brokers,14,21,5,40,0.125000
2025-09-13,Intercontinental Exchange,12,28,0,40,0.000000
2025-09-13,International Flavors & Fragrances,17,20,3,40,0.075000
2025-09-13,International Paper,11,25,4,40,0.100000
2025-09-13,Interpublic Group,24,14,2,40,0.050000
2025-09-13,Intuit,17,21,2,40,0.050000
2025-09-13,Intuitive Surgical,13,18,9,40,0.225000
2025-09-13,Iron Mountain,15,24,1,40,0.025000
2025-09-13,JB Hunt Transport Services,11,24,5,40,0.125000
2025-09-13,JELD-WEN Holding,11,24,5,40,0.125000
2025-09-13,JM Smucker,15,21,4,40,0.100000
2025-09-13,JPMorgan Chase,11,20,9,40,0.225000
2025-09-13,Jabil,17,22,1,40,0.025000
2025-09-13,Jackson Financial,20,18,2,40,0.050000
2025-09-13,Jacobs Solutions,35,1,4,40,0.100000
2025-09-13,Jefferies Financial,10,26,4,40,0.100000
2025-09-13,JetBlue Airways,12,25,3,40,0.075000
2025-09-13,Johnson & Johnson,19,17,4,40,0.100000
2025-09-13,Jones Lang LaSalle,20,16,4,40,0.100000
2025-09-13,Juniper Networks,13,24,3,40,0.075000
2025-09-13,KB Home,24,16,0,40,0.000000
2025-09-13,KBR,25,11,4,40,0.100000
2025-09-13,KKR & Co,26,14,0,40,0.000000
2025-09-13,KLA,21,14,5,40,0.125000
2025-09-13,Kaiser Aluminum,14,22,4,40,0.100000
2025-09-13,Kellanova,20,16,4,40,0.100000
2025-09-13,Kelly Services inc,15,20,5,40,0.125000
2025-09-13,Kemper,15,17,8,40,0.200000
2025-09-13,Keurig Dr Pepper,8,27,5,40,0.125000
2025-09-13,KeyCorp,16,21,3,40,0.075000
2025-09-13,Keysight Technologies,21,15,4,40,0.100000
2025-09-13,Kimberly-Clark,14,19,7,40,0.175000
2025-09-13,Kinder Morgan,40,0,0,40,0.000000
2025-09-13,Kirby Corporation,20,18,2,40,0.050000
2025-09-13,Knife River Corporation,22,15,3,40,0.075000
2025-09-13,Knight Swift Transportation,16,19,5,40,0.125000
2025-09-13,Kohls,12,19,9,40,0.225000
2025-09-13,Kontoor Brands,19,19,2,40,0.050000
2025-09-13,Korn Ferry,16,20,4,40,0.100000
2025-09-13,Kraft Heinz,16,14,10,40,0.250000
2025-09-13,Kroger,16,15,9,40,0.225000
2025-09-13,Kyndryl,15,23,2,40,0.050000
2025-09-13,L3Harris Technologies,21,17,2,40,0.050000
2025-09-13,LCI Industries,13,25,2,40,0.050000
2025-09-13,LKQ,11,28,1,40,0.025000
2025-09-13,LPL Financial,29,11,0,40,0.000000
2025-09-13,Labcorp Holdings,19,19,2,40,0.050000
2025-09-13,Lam Research,22,17,1,40,0.025000
2025-09-13,Lamb Weston,16,21,3,40,0.075000
2025-09-13,Land OLakes,11,19,10,40,0.250000
2025-09-13,Landstar System,13,19,8,40,0.200000
2025-09-13,Las Vegas Sands,14,25,1,40,0.025000
2025-09-13,Lear Corporation,25,13,2,40,0.050000
2025-09-13,Leggett & Platt,15,21,4,40,0.100000
2025-09-13,Leidos,21,16,3,40,0.075000
2025-09-13,Lennar,8,29,3,40,0.075000
2025-09-13,Lennox International,14,23,3,40,0.075000
2025-09-13,Levi Strauss,13,26,1,40,0.025000
2025-09-13,Liberty Energy,40,0,0,40,0.000000
2025-09-13,Liberty Media,37,3,0,40,0.000000
2025-09-13,Liberty Mutual Insurance,32,2,6,40,0.150000
2025-09-13,Light & Wonder,8,23,9,40,0.225000
2025-09-13,Lincoln Electric,16,23,1,40,0.025000
2025-09-13,Lincoln National,16,14,10,40,0.250000
2025-09-13,Lithia Motors,21,15,4,40,0.100000
2025-09-13,Live Nation Entertainment,36,2,2,40,0.050000
2025-09-13,Lockheed Martin,23,11,6,40,0.150000
2025-09-13,Loews,17,19,4,40,0.100000
2025-09-13,Louisiana-Pacific Corporation,22,15,3,40,0.075000
2025-09-13,Lowes,12,21,7,40,0.175000
2025-09-13,Lululemon athletica,7,23,10,40,0.250000
2025-09-13,Lumen Technologies,4,28,8,40,0.200000
2025-09-13,Lyft,12,21,7,40,0.175000
2025-09-13,M&T Bank,13,26,1,40,0.025000
2025-09-13,M/I Homes,14,20,6,40,0.150000
2025-09-13,MDU Resources Group,17,23,0,40,0.000000
2025-09-13,MGM Resorts International,17,21,2,40,0.050000
2025-09-13,MKS Instruments,17,22,1,40,0.025000
2025-09-13,MRC Global,18,22,0,40,0.000000
2025-09-13,MSC Industrial Direct,13,26,1,40,0.025000
2025-09-13,MSCI,19,16,5,40,0.125000
2025-09-13,MYR Group,16,23,1,40,0.025000
2025-09-13,Macys,12,22,6,40,0.150000
2025-09-13,ManpowerGroup,21,13,6,40,0.150000
2025-09-13,Marathon Oil,14,22,4,40,0.100000
2025-09-13,Marathon Petroleum,21,18,1,40,0.025000
2025-09-13,Markel Group,15,20,5,40,0.125000
2025-09-13,Marriott International,17,20,3,40,0.075000
2025-09-13,Marriott Vacations Worldwide,20,18,2,40,0.050000
2025-09-13,Marsh & McLennan,28,11,1,40,0.025000
2025-09-13,Martin Marietta Materials,15,17,8,40,0.200000
2025-09-13,Marvell Technology,19,19,2,40,0.050000
2025-09-13,MasTec,22,18,0,40,0.000000
2025-09-13,Masco,17,18,5,40,0.125000
2025-09-13,Mass Mutual,12,24,4,40,0.100000
2025-09-13,MasterBrand,9,29,2,40,0.050000
2025-09-13,Mastercard,16,24,0,40,0.000000
2025-09-13,Matador Resources,15,19,6,40,0.150000
2025-09-13,Match Group,8,21,11,40,0.275000
2025-09-13,Mativ,19,18,3,40,0.075000
2025-09-13,Matson inc,22,15,3,40,0.075000
2025-09-13,Mattel,17,19,4,40,0.100000
2025-09-13,Maximus,13,25,2,40,0.050000
2025-09-13,McCormick & Company,19,17,4,40,0.100000
2025-09-13,McDonalds,18,14,8,40,0.200000
2025-09-13,McKesson,24,14,2,40,0.050000
2025-09-13,Medical Mutual of Ohio,13,19,8,40,0.200000
2025-09-13,Merck,11,19,10,40,0.250000
2025-09-13,Mercury General,11,21,8,40,0.200000
2025-09-13,Meritage Homes,16,21,3,40,0.075000
2025-09-13,MetLife,15,23,2,40,0.050000
2025-09-13,Meta,14,18,8,40,0.200000
2025-09-13,Mettler-Toledo International,25,14,1,40,0.025000
2025-09-13,Microchip Technology,24,12,4,40,0.100000
2025-09-13,Micron Technology,14,20,6,40,0.150000
2025-09-13,Microsoft,18,16,6,40,0.150000
2025-09-13,Middleby,20,17,3,40,0.075000
2025-09-13,MillerKnoll,18,21,1,40,0.025000
2025-09-13,Moderna,12,20,8,40,0.200000
2025-09-13,ModivCare,8,24,8,40,0.200000
2025-09-13,Mohawk Industries,20,17,3,40,0.075000
2025-09-13,Molina Healthcare,18,14,8,40,0.200000
2025-09-13,Molson Coors Beverage,12,20,8,40,0.200000
2025-09-13,Mondelez,13,24,3,40,0.075000
2025-09-13,Monster Beverage,26,11,3,40,0.075000
2025-09-13,Moodys Corporation,3,12,2,17,0.117647
2025-09-13,Moog inc,18,18,4,40,0.100000
2025-09-13,Morgan Stanley,19,15,6,40,0.150000
2025-09-13,Mosaic,16,21,3,40,0.075000
2025-09-13,Motorola Solutions,37,0,3,40,0.075000
2025-09-13,Mueller Industries,22,16,2,40,0.050000
2025-09-13,Murphy Oil,16,22,2,40,0.050000
2025-09-13,Murphy USA,12,27,1,40,0.025000
2025-09-13,Mutual of Omaha,19,18,3,40,0.075000
2025-09-13,NCR Atleos,14,25,1,40,0.025000
2025-09-13,NCR Voyix,12,24,4,40,0.100000
2025-09-13,NGL Energy Partners,39,0,1,40,0.025000
2025-09-13,NLV Financial,4,4,2,10,0.200000
2025-09-13,NOV,15,20,5,40,0.125000
2025-09-13,NRG Energy,36,2,2,40,0.050000
2025-09-13,NVR,15,22,3,40,0.075000
2025-09-13,Nasdaq,21,15,4,40,0.100000
2025-09-13,Nationwide Insurance,9,19,12,40,0.300000
2025-09-13,Navient,17,16,7,40,0.175000
2025-09-13,NetApp,21,17,2,40,0.050000
2025-09-13,Netflix,11,17,12,40,0.300000
2025-09-13,NeueHealth,14,24,2,40,0.050000
2025-09-13,New York Life Insurance,15,23,2,40,0.050000
2025-09-13,NewMarket Corporation,19,18,3,40,0.075000
2025-09-13,Newell Brands,12,22,6,40,0.150000
2025-09-13,Newmont,16,22,2,40,0.050000
2025-09-13,News Corp,19,14,7,40,0.175000
2025-09-13,Nexstar Media Group,18,20,2,40,0.050000
2025-09-13,NextEra Energy,40,0,0,40,0.000000
2025-09-13,NiSource,16,13,11,40,0.275000
2025-09-13,Nike,15,21,4,40,0.100000
2025-09-13,Nordson,22,17,1,40,0.025000
2025-09-13,Nordstrom,19,17,4,40,0.100000
2025-09-13,Norfolk Southern,15,20,5,40,0.125000
2025-09-13,Northern Trust,38,2,0,40,0.000000
2025-09-13,Northrop Grumman,16,18,6,40,0.150000
2025-09-13,Northwestern Mutual,22,11,7,40,0.175000
2025-09-13,Nucor,17,20,3,40,0.075000
2025-09-13,Nvidia,17,16,7,40,0.175000
2025-09-13,O-I Glass,15,22,3,40,0.075000
2025-09-13,ODP Business Solutions,18,20,2,40,0.050000
2025-09-13,OGE Energy,38,0,2,40,0.050000
2025-09-13,ON Semiconductor,11,19,10,40,0.250000
2025-09-13,OReilly Automotive,6,13,9,28,0.321429
2025-09-13,Occidental Petroleum,9,26,5,40,0.125000
2025-09-13,Old Dominion Freight Line,16,17,7,40,0.175000
2025-09-13,Old National Bancorp,15,25,0,40,0.000000
2025-09-13,Old Republic International,23,14,3,40,0.075000
2025-09-13,Olin,16,12,12,40,0.300000
2025-09-13,Omnicom Group,28,10,2,40,0.050000
2025-09-13,OneMain,20,20,0,40,0.000000
2025-09-13,Oneok,30,10,0,40,0.000000
2025-09-13,Opendoor Technologies,10,21,9,40,0.225000
2025-09-13,Option Care Health,40,0,0,40,0.000000
2025-09-13,Oracle,14,17,9,40,0.225000
2025-09-13,Organon,18,16,6,40,0.150000
2025-09-13,Oscar Health,17,13,10,40,0.250000
2025-09-13,Oshkosh Corporation,19,16,5,40,0.125000
2025-09-13,Otis Worldwide,15,22,3,40,0.075000
2025-09-13,Ovintiv,22,10,8,40,0.200000
2025-09-13,Owens & Minor,9,26,5,40,0.125000
2025-09-13,Owens Corning,19,17,4,40,0.100000
2025-09-13,PACS Group,13,14,13,40,0.325000
2025-09-13,PBF Energy,36,0,4,40,0.100000
2025-09-13,PC Connection Inc,22,17,1,40,0.025000
2025-09-13,PENN Entertainment,36,4,0,40,0.000000
2025-09-13,PG&E,14,17,9,40,0.225000
2025-09-13,PNC Financial Services,15,22,3,40,0.075000
2025-09-13,PPG Industries,21,15,4,40,0.100000
2025-09-13,PPL,15,19,6,40,0.150000
2025-09-13,PVH,16,17,7,40,0.175000
2025-09-13,Paccar,16,19,5,40,0.125000
2025-09-13,Pacific Life,15,24,1,40,0.025000
2025-09-13,Packaging Corp of America,9,26,5,40,0.125000
2025-09-13,Palo Alto Networks,11,17,12,40,0.300000
2025-09-13,Par Pacific,16,23,1,40,0.025000
2025-09-13,Paramount Global,8,21,11,40,0.275000
2025-09-13,Park Hotels & Resorts,13,24,3,40,0.075000
2025-09-13,Parker-Hannifin,24,12,4,40,0.100000
2025-09-13,Parsons Corporation,23,16,1,40,0.025000
2025-09-13,Patrick Industries,16,22,2,40,0.050000
2025-09-13,Patterson Companies Inc,11,27,2,40,0.050000
2025-09-13,Patterson-UTI Energy,32,7,1,40,0.025000
2025-09-13,PayPal,15,15,10,40,0.250000
2025-09-13,Paychex,28,10,2,40,0.050000
2025-09-13,Peabody Energy,34,5,1,40,0.025000
2025-09-13,Peloton,26,12,2,40,0.050000
2025-09-13,Penn Mutual Life Insurance,19,17,4,40,0.100000
2025-09-13,PennyMac Financial Services,16,21,3,40,0.075000
2025-09-13,Penske Automotive,11,27,2,40,0.050000
2025-09-13,PepsiCo,22,15,3,40,0.075000
2025-09-13,Performance Food,13,23,4,40,0.100000
2025-09-13,Permian Resources,17,22,1,40,0.025000
2025-09-13,Petco Health and Wellness,36,3,1,40,0.025000
2025-09-13,Peter Kiewit Sons,5,20,15,40,0.375000
2025-09-13,Pfizer,21,12,7,40,0.175000
2025-09-13,Philip Morris,19,19,2,40,0.050000
2025-09-13,Phillips 66,22,18,0,40,0.000000
2025-09-13,Pinnacle West Capital,16,16,8,40,0.200000
2025-09-13,Pinterest,19,19,2,40,0.050000
2025-09-13,Pioneer Natural Resources,17,10,13,40,0.325000
2025-09-13,Pitney Bowes,19,21,0,40,0.000000
2025-09-13,Plains GP,15,13,12,40,0.300000
2025-09-13,Playtika Holding,13,18,9,40,0.225000
2025-09-13,Plexus,6,22,12,40,0.300000
2025-09-13,Polaris Inc,22,15,3,40,0.075000
2025-09-13,Pool Corporation,20,17,3,40,0.075000
2025-09-13,Popular inc,39,1,0,40,0.000000
2025-09-13,Portland General Electric,17,20,3,40,0.075000
2025-09-13,Post Holdings,9,30,1,40,0.025000
2025-09-13,PriceSmart,16,22,2,40,0.050000
2025-09-13,Primerica,18,18,4,40,0.100000
2025-09-13,Primoris Services,20,18,2,40,0.050000
2025-09-13,Principal Financial,20,16,4,40,0.100000
2025-09-13,ProFrac Holding,14,19,7,40,0.175000
2025-09-13,Procter & Gamble,17,15,8,40,0.200000
2025-09-13,Progressive Insurance,15,21,4,40,0.100000
2025-09-13,Prologis,24,16,0,40,0.000000
2025-09-13,Prudential Financial,18,17,5,40,0.125000
2025-09-13,Public Service Enterprise Group,23,15,2,40,0.050000
2025-09-13,Public Storage,16,16,8,40,0.200000
2025-09-13,Publix Super Markets,24,13,3,40,0.075000
2025-09-13,Puget Sound Energy,31,7,2,40,0.050000
2025-09-13,PulteGroup,21,16,3,40,0.075000
2025-09-13,Pure Storage,13,23,4,40,0.100000
2025-09-13,QVC,19,20,1,40,0.025000
2025-09-13,Qorvo,21,15,4,40,0.100000
2025-09-13,Quad/Graphics,13,23,4,40,0.100000
2025-09-13,Qualcomm,17,22,1,40,0.025000
2025-09-13,Quanta Services,24,15,1,40,0.025000
2025-09-13,Quest Diagnostics,17,22,1,40,0.025000
2025-09-13,QuidelOrtho,19,18,3,40,0.075000
2025-09-13,REV Group,17,19,4,40,0.100000
2025-09-13,RPM International,20,18,2,40,0.050000
2025-09-13,RTX,23,17,0,40,0.000000
2025-09-13,RXO inc,16,18,6,40,0.150000
2025-09-13,Rackspace Technology,14,22,4,40,0.100000
2025-09-13,Radius Recycling,4,22,14,40,0.350000
2025-09-13,Ralph Lauren,13,24,3,40,0.075000
2025-09-13,Range Resources,22,16,2,40,0.050000
2025-09-13,Raymond James Financial,20,15,5,40,0.125000
2025-09-13,Realty Income,23,13,4,40,0.100000
2025-09-13,Regal Rexnord,14,24,2,40,0.050000
2025-09-13,Regeneron Pharmaceuticals,23,14,3,40,0.075000
2025-09-13,Regions Financial,20,18,2,40,0.050000
2025-09-13,Reinsurance Group of America,21,19,0,40,0.000000
2025-09-13,Reliance Inc,21,16,3,40,0.075000
2025-09-13,Republic Services,18,15,7,40,0.175000
2025-09-13,ResMed,22,18,0,40,0.000000
2025-09-13,Resideo Technologies,19,18,3,40,0.075000
2025-09-13,Restoration Hardware,12,21,7,40,0.175000
2025-09-13,Revvity,18,16,6,40,0.150000
2025-09-13,Rite Aid,7,26,7,40,0.175000
2025-09-13,Rithm Capital,18,22,0,40,0.000000
2025-09-13,Rivian Automotive,13,20,7,40,0.175000
2025-09-13,Robert Half,17,22,1,40,0.025000
2025-09-13,Roblox,12,15,13,40,0.325000
2025-09-13,Rocket Companies,13,25,2,40,0.050000
2025-09-13,Rockwell Automation,16,21,3,40,0.075000
2025-09-13,Roku,21,18,1,40,0.025000
2025-09-13,Rollins inc,19,21,0,40,0.000000
2025-09-13,Roper Technologies,25,15,0,40,0.000000
2025-09-13,Ross Stores,18,20,2,40,0.050000
2025-09-13,Rush Enterprises,18,20,2,40,0.050000
2025-09-13,Ryder System,20,16,4,40,0.100000
2025-09-13,Ryerson Holding,15,17,8,40,0.200000
2025-09-13,S&P Global,15,21,4,40,0.100000
2025-09-13,SBA Communications,20,15,5,40,0.125000
2025-09-13,SS&C Technologies,24,14,2,40,0.050000
2025-09-13,Sabre Corporation,16,18,6,40,0.150000
2025-09-13,Saia inc,20,15,5,40,0.125000
2025-09-13,Salesforce,16,13,11,40,0.275000
2025-09-13,Sallie Mae,13,23,4,40,0.100000
2025-09-13,Sally Beauty,40,0,0,40,0.000000
2025-09-13,Sanmina,16,20,4,40,0.100000
2025-09-13,ScanSource,26,13,1,40,0.025000
2025-09-13,Schneider National,14,21,5,40,0.125000
2025-09-13,Science Applications International,19,18,3,40,0.075000
2025-09-13,Scotts Miracle-Gro,15,20,5,40,0.125000
2025-09-13,Seaboard,17,14,9,40,0.225000
2025-09-13,Sealed Air Corporation,18,21,1,40,0.025000
2025-09-13,Securian Financial,11,25,4,40,0.100000
2025-09-13,Select Medical,19,12,9,40,0.225000
2025-09-13,Selective Insurance Group,13,18,9,40,0.225000
2025-09-13,Sempra,30,10,0,40,0.000000
2025-09-13,Sentry Insurance Group,4,6,0,10,0.000000
2025-09-13,Service Corp International,8,12,6,26,0.230769
2025-09-13,ServiceNow,23,11,6,40,0.150000
2025-09-13,Sherwin-Williams,10,25,5,40,0.125000
2025-09-13,Shift4 Payments,11,21,8,40,0.200000
2025-09-13,Silgan,11,24,5,40,0.125000
2025-09-13,Simon Property Group,13,24,3,40,0.075000
2025-09-13,Sinclair,10,28,2,40,0.050000
2025-09-13,SiteOne Landscape Supply,12,19,9,40,0.225000
2025-09-13,Skechers USA,14,25,1,40,0.025000
2025-09-13,SkyWest,9,20,11,40,0.275000
2025-09-13,Skyline Champion,33,4,3,40,0.075000
2025-09-13,Skyworks Solutions,33,4,3,40,0.075000
2025-09-13,Smurfit Westrock,14,22,4,40,0.100000
2025-09-13,Snap Inc,12,13,15,40,0.375000
2025-09-13,Snap-on,9,28,3,40,0.075000
2025-09-13,Snowflake inc,29,11,0,40,0.000000
2025-09-13,Sonic Automotive,12,25,3,40,0.075000
2025-09-13,Sonoco Products,19,20,1,40,0.025000
2025-09-13,Southern Company,27,12,1,40,0.025000
2025-09-13,Southwest Airlines,10,26,4,40,0.100000
2025-09-13,Southwest Gas,17,21,2,40,0.050000
2025-09-13,Southwestern Energy,36,2,2,40,0.050000
2025-09-13,SpartanNash,14,25,1,40,0.025000
2025-09-13,Spectrum Brands,12,19,9,40,0.225000
2025-09-13,Spire inc,21,17,2,40,0.050000
2025-09-13,Spirit AeroSystems,31,2,7,40,0.175000
2025-09-13,Spirit Airlines,28,4,8,40,0.200000
2025-09-13,Splunk,19,19,2,40,0.050000
2025-09-13,Sprouts Farmers Market,11,26,3,40,0.075000
2025-09-13,Stagwell,9,23,8,40,0.200000
2025-09-13,Stanley Black & Decker,17,19,4,40,0.100000
2025-09-13,Starbucks,12,23,5,40,0.125000
2025-09-13,State Farm Insurance,14,18,8,40,0.200000
2025-09-13,State Street,17,14,9,40,0.225000
2025-09-13,Steel Dynamics,37,3,0,40,0.000000
2025-09-13,Steelcase,10,28,2,40,0.050000
2025-09-13,Stericycle,10,8,22,40,0.550000
2025-09-13,Stifel Financial,22,16,2,40,0.050000
2025-09-13,StoneX,16,23,1,40,0.025000
2025-09-13,Stryker,23,13,4,40,0.100000
2025-09-13,Summit Materials,12,25,3,40,0.075000
2025-09-13,Sun Communities,21,18,1,40,0.025000
2025-09-13,Super Micro Computer,39,1,0,40,0.000000
2025-09-13,Surgery Partners,12,24,4,40,0.100000
2025-09-13,Sylvamo,12,20,8,40,0.200000
2025-09-13,Synchrony Financial,25,13,2,40,0.050000
2025-09-13,Synopsys,10,11,19,40,0.475000
2025-09-13,Synovus Financial,15,23,2,40,0.050000
2025-09-13,Sysco,23,15,2,40,0.050000
2025-09-13,T Rowe Price,18,21,1,40,0.025000
2025-09-13,TD Synnex,27,13,0,40,0.000000
2025-09-13,TEGNA,10,27,3,40,0.075000
2025-09-13,TIAA,13,24,3,40,0.075000
2025-09-13,TJX,29,9,2,40,0.050000
2025-09-13,Take-Two Interactive Software,20,17,3,40,0.075000
2025-09-13,Talen Energy,39,0,1,40,0.025000
2025-09-13,Tapestry,18,20,2,40,0.050000
2025-09-13,Targa Resources,28,12,0,40,0.000000
2025-09-13,Target,10,20,10,40,0.250000
2025-09-13,Taylor Morrison Home,20,19,1,40,0.025000
2025-09-13,Teladoc Health,19,17,4,40,0.100000
2025-09-13,Teledyne Technologies,24,16,0,40,0.000000
2025-09-13,Teleflex,12,24,4,40,0.100000
2025-09-13,Telephone & Data Systems,12,25,3,40,0.075000
2025-09-13,TelevisaUnivision,12,16,12,40,0.300000
2025-09-13,Tempur Sealy International,11,25,4,40,0.100000
2025-09-13,Tenet Healthcare,19,18,3,40,0.075000
2025-09-13,Teradyne,24,15,1,40,0.025000
2025-09-13,Terex,19,19,2,40,0.050000
2025-09-13,Tesla,10,20,10,40,0.250000
2025-09-13,Tetra Tech,24,12,4,40,0.100000
2025-09-13,Texas Instruments,15,19,6,40,0.150000
2025-09-13,Texas Roadhouse,8,22,10,40,0.250000
2025-09-13,Textron,20,18,2,40,0.050000
2025-09-13,The Andersons Inc,17,22,1,40,0.025000
2025-09-13,The Coca-Cola Company,13,23,4,40,0.100000
2025-09-13,The Hartford,15,18,7,40,0.175000
2025-09-13,Thermo Fisher Scientific,16,18,6,40,0.150000
2025-09-13,Thor Industries,17,16,7,40,0.175000
2025-09-13,Thrivent Financial for Lutherans,14,20,6,40,0.150000
2025-09-13,Timken,12,25,3,40,0.075000
2025-09-13,Titan Machinery,8,25,7,40,0.175000
2025-09-13,Toast inc,15,19,6,40,0.150000
2025-09-13,Toll Brothers,11,27,2,40,0.050000
2025-09-13,TopBuild,20,20,0,40,0.000000
2025-09-13,Topgolf Callaway Brands,12,22,6,40,0.150000
2025-09-13,Toro Company,14,26,0,40,0.000000
2025-09-13,Tractor Supply,24,14,2,40,0.050000
2025-09-13,TransDigm,23,12,5,40,0.125000
2025-09-13,TransUnion,17,15,8,40,0.200000
2025-09-13,Travelers Insurance,12,18,10,40,0.250000
2025-09-13,TreeHouse Foods,13,21,6,40,0.150000
2025-09-13,Tri Pointe Homes,14,24,2,40,0.050000
2025-09-13,TriNet Group,21,16,3,40,0.075000
2025-09-13,Trimble,11,22,7,40,0.175000
2025-09-13,Trinity Industries,16,17,7,40,0.175000
2025-09-13,TruStage,27,11,2,40,0.050000
2025-09-13,Truist Financial,21,16,3,40,0.075000
2025-09-13,Tutor Perini Corporation,26,10,4,40,0.100000
2025-09-13,Twilio,23,14,3,40,0.075000
2025-09-13,Tyson Foods,14,16,10,40,0.250000
2025-09-13,U-Haul,6,6,28,40,0.700000
2025-09-13,UFP Industries,14,24,2,40,0.050000
2025-09-13,UGI Utilities Inc,20,12,8,40,0.200000
2025-09-13,UL Solutions,34,2,4,40,0.100000
2025-09-13,UPS,15,13,12,40,0.300000
2025-09-13,US Bancorp,21,19,0,40,0.000000
2025-09-13,US Foods,22,17,1,40,0.025000
2025-09-13,USAA,19,15,6,40,0.150000
2025-09-13,Uber,13,17,10,40,0.250000
2025-09-13,Ulta Beauty,36,3,1,40,0.025000
2025-09-13,Under Armour,11,26,3,40,0.075000
2025-09-13,Union Pacific,13,23,4,40,0.100000
2025-09-13,United Airlines,27,5,8,40,0.200000
2025-09-13,United Natural Foods,38,2,0,40,0.000000
2025-09-13,United Rentals,39,1,0,40,0.000000
2025-09-13,United States Steel,25,11,4,40,0.100000
2025-09-13,UnitedHealth,15,22,3,40,0.075000
2025-09-13,Universal Corporation,16,23,1,40,0.025000
2025-09-13,Universal Health Services,20,15,5,40,0.125000
2025-09-13,Unum Group,13,23,4,40,0.100000
2025-09-13,Upbound Group,31,9,0,40,0.000000
2025-09-13,Urban Outfitters,17,21,2,40,0.050000
2025-09-13,V2X,23,15,2,40,0.050000
2025-09-13,VF Corporation,13,22,5,40,0.125000
2025-09-13,VICI Properties,15,23,2,40,0.050000
2025-09-13,Vail Resorts,11,14,15,40,0.375000
2025-09-13,Valero Energy,34,3,3,40,0.075000
2025-09-13,Valley National Bancorp,8,24,8,40,0.200000
2025-09-13,Valmont Industries,24,14,2,40,0.050000
2025-09-13,Valvoline inc,15,24,1,40,0.025000
2025-09-13,Ventas inc,22,17,1,40,0.025000
2025-09-13,Verisk Analytics,21,15,4,40,0.100000
2025-09-13,Verizon,16,17,7,40,0.175000
2025-09-13,Vertex Pharmaceuticals,24,14,2,40,0.050000
2025-09-13,Vertiv,24,14,2,40,0.050000
2025-09-13,Viasat,18,17,5,40,0.125000
2025-09-13,Viatris,12,19,9,40,0.225000
2025-09-13,Victorias Secret,14,16,10,40,0.250000
2025-09-13,Visa,11,16,13,40,0.325000
2025-09-13,Vishay Intertechnology,12,22,6,40,0.150000
2025-09-13,Vista Outdoor,15,21,4,40,0.100000
2025-09-13,Visteon,17,21,2,40,0.050000
2025-09-13,Vistra,23,15,2,40,0.050000
2025-09-13,Vontier,18,19,3,40,0.075000
2025-09-13,Voya Financial,22,15,3,40,0.075000
2025-09-13,Vulcan Materials,9,23,8,40,0.200000
2025-09-13,WEC Energy,39,0,1,40,0.025000
2025-09-13,WESCO International,20,19,1,40,0.025000
2025-09-13,WEX,18,17,5,40,0.125000
2025-09-13,WR Berkley,18,22,0,40,0.000000
2025-09-13,WW Grainger,20,17,3,40,0.075000
2025-09-13,Wabash National,14,14,12,40,0.300000
2025-09-13,Walgreens,11,22,7,40,0.175000
2025-09-13,Walmart,11,12,17,40,0.425000
2025-09-13,Walt Disney,17,18,5,40,0.125000
2025-09-13,Warner Bros Discovery,7,27,6,40,0.150000
2025-09-13,Warner Music Group,11,28,1,40,0.025000
2025-09-13,Waters Corporation,19,19,2,40,0.050000
2025-09-13,Watsco,18,17,5,40,0.125000
2025-09-13,Wayfair,22,16,2,40,0.050000
2025-09-13,Webster Financial,14,23,3,40,0.075000
2025-09-13,Weis Markets,11,25,4,40,0.100000
2025-09-13,Wells Fargo,37,0,3,40,0.075000
2025-09-13,Welltower,34,6,0,40,0.000000
2025-09-13,Werner Enterprises,17,14,9,40,0.225000
2025-09-13,West Pharmaceutical Services,16,22,2,40,0.050000
2025-09-13,Western & Southern Financial,13,23,4,40,0.100000
2025-09-13,Western Alliance Bancorp,14,16,10,40,0.250000
2025-09-13,Western Digital,16,18,6,40,0.150000
2025-09-13,Western Midstream Partners,21,19,0,40,0.000000
2025-09-13,Western Union,17,21,2,40,0.050000
2025-09-13,Westinghouse Air Brake Technologies,16,19,5,40,0.125000
2025-09-13,Westlake Corporation,8,26,6,40,0.150000
2025-09-13,Weyerhaeuser,12,24,4,40,0.100000
2025-09-13,Whirlpool,15,17,8,40,0.200000
2025-09-13,Williams,11,16,13,40,0.325000
2025-09-13,Williams-Sonoma,14,20,6,40,0.150000
2025-09-13,Winnebago Industries,14,23,3,40,0.075000
2025-09-13,Wintrust Financial,17,18,5,40,0.125000
2025-09-13,Woodward inc,22,17,1,40,0.025000
2025-09-13,Workday,16,16,8,40,0.200000
2025-09-13,World Kinect,18,19,3,40,0.075000
2025-09-13,Worthington Enterprises,17,22,1,40,0.025000
2025-09-13,Wynn Resorts,14,16,10,40,0.250000
2025-09-13,XPO,17,20,3,40,0.075000
2025-09-13,Xcel Energy,34,3,3,40,0.075000
2025-09-13,Xerox,17,17,6,40,0.150000
2025-09-13,Xylem Inc,21,18,1,40,0.025000
2025-09-13,Yum Brands,12,27,1,40,0.025000
2025-09-13,Yum China,18,18,4,40,0.100000
2025-09-13,Zebra Technologies,17,20,3,40,0.075000
2025-09-13,Zimmer Biomet,18,20,2,40,0.050000
2025-09-13,Zions Bancorp,18,18,4,40,0.100000
2025-09-13,Zoetis,30,10,0,40,0.000000
2025-09-13,Zoom Video Communications,14,20,6,40,0.150000
2025-09-13,eXp World,17,19,4,40,0.100000
2025-09-13,iHeartMedia,14,24,2,40,0.050000
2025-09-14,3M,22,15,3,40,0.075000
2025-09-14,A O Smith,18,21,1,40,0.025000
2025-09-14,A-Mark Precious Metals,37,3,0,40,0.000000
2025-09-14,ABM Industries,8,22,10,40,0.250000
2025-09-14,ADT,14,20,6,40,0.150000
2025-09-14,AECOM,24,14,2,40,0.050000
2025-09-14,AES,15,20,5,40,0.125000
2025-09-14,AGCO,17,20,3,40,0.075000
2025-09-14,AGNC Investment,17,17,6,40,0.150000
2025-09-14,AMC Entertainment,33,3,4,40,0.100000
2025-09-14,AMC Networks,13,20,7,40,0.175000
2025-09-14,AMN Healthcare Services,9,22,9,40,0.225000
2025-09-14,APA,17,16,7,40,0.175000
2025-09-14,APi Group,20,17,3,40,0.075000
2025-09-14,ARKO,8,30,2,40,0.050000
2025-09-14,ASGN,13,18,9,40,0.225000
2025-09-14,AT&T,20,15,5,40,0.125000
2025-09-14,ATI inc,17,22,1,40,0.025000
2025-09-14,AbbVie,24,11,5,40,0.125000
2025-09-14,Abbott Laboratories,28,9,3,40,0.075000
2025-09-14,Abercrombie & Fitch,15,24,1,40,0.025000
2025-09-14,Academy Sports and Outdoors,15,21,4,40,0.100000
2025-09-14,Acadia Healthcare,11,19,10,40,0.250000
2025-09-14,Acuity Inc,23,16,1,40,0.025000
2025-09-14,Adams Resources & Energy,20,7,1,28,0.035714
2025-09-14,AdaptHealth,17,20,3,40,0.075000
2025-09-14,Adobe,16,15,9,40,0.225000
2025-09-14,Advance Auto Parts,8,22,10,40,0.250000
2025-09-14,Advanced Drainage Systems,36,2,2,40,0.050000
2025-09-14,Advanced Micro Devices,28,5,7,40,0.175000
2025-09-14,Advantage Solutions,37,0,3,40,0.075000
2025-09-14,Aflac,14,13,13,40,0.325000
2025-09-14,Agilent Technologies,19,20,1,40,0.025000
2025-09-14,Agilon Health,11,22,7,40,0.175000
2025-09-14,Air Lease,8,31,1,40,0.025000
2025-09-14,Air Products & Chemicals,14,21,5,40,0.125000
2025-09-14,Airbnb,14,20,6,40,0.150000
2025-09-14,Akamai Technologies,17,19,4,40,0.100000
2025-09-14,Alaska Air,9,30,1,40,0.025000
2025-09-14,Albemarle Corporation,15,20,5,40,0.125000
2025-09-14,Albertsons,14,23,3,40,0.075000
2025-09-14,Alcoa Corporation,7,27,6,40,0.150000
2025-09-14,Alexandria Real Estate Equities,18,18,4,40,0.100000
2025-09-14,Alight Solutions,16,20,4,40,0.100000
2025-09-14,Align Technology,9,20,11,40,0.275000
2025-09-14,Allegiant Travel Company,12,27,1,40,0.025000
2025-09-14,Alliance Resource Partners,11,19,10,40,0.250000
2025-09-14,Alliant Energy,34,4,2,40,0.050000
2025-09-14,Allison Transmission,13,20,7,40,0.175000
2025-09-14,Allstate,12,23,5,40,0.125000
2025-09-14,Ally Financial,17,22,1,40,0.025000
2025-09-14,Alpha Metallurgical Resources,19,14,7,40,0.175000
2025-09-14,Alphabet,19,19,2,40,0.050000
2025-09-14,Altice,14,21,5,40,0.125000
2025-09-14,Altria Group,23,16,1,40,0.025000
2025-09-14,Amazon,32,5,3,40,0.075000
2025-09-14,Ameren,19,15,6,40,0.150000
2025-09-14,American Airlines,13,17,10,40,0.250000
2025-09-14,American Axle & Manufacturing,15,23,2,40,0.050000
2025-09-14,American Eagle Outfitters,15,21,4,40,0.100000
2025-09-14,American Electric Power,19,17,4,40,0.100000
2025-09-14,American Express,22,12,6,40,0.150000
2025-09-14,American Family Insurance,23,14,3,40,0.075000
2025-09-14,American Financial,15,21,4,40,0.100000
2025-09-14,American International Group,21,19,0,40,0.000000
2025-09-14,American Tower,21,15,4,40,0.100000
2025-09-14,American Water Works,24,13,3,40,0.075000
2025-09-14,Americold Realty Trust,37,2,1,40,0.025000
2025-09-14,Ameriprise Financial,25,13,2,40,0.050000
2025-09-14,Ametek,28,12,0,40,0.000000
2025-09-14,Amgen,16,22,2,40,0.050000
2025-09-14,Amica Mutual Insurance,12,26,2,40,0.050000
2025-09-14,Amkor Technology,14,24,2,40,0.050000
2025-09-14,Amphenol,24,15,1,40,0.025000
2025-09-14,Analog Devices,16,22,2,40,0.050000
2025-09-14,Antero Resources,18,21,1,40,0.025000
2025-09-14,Anywhere Real Estate Inc,18,19,3,40,0.075000
2025-09-14,Apollo Global Management,12,24,4,40,0.100000
2025-09-14,AppLovin,15,24,1,40,0.025000
2025-09-14,Apple,14,18,8,40,0.200000
2025-09-14,Applied Industrial Technologies,16,23,1,40,0.025000
2025-09-14,Applied Materials,7,16,17,40,0.425000
2025-09-14,AptarGroup,16,22,2,40,0.050000
2025-09-14,Aramark,20,19,1,40,0.025000
2025-09-14,ArcBest,14,20,6,40,0.150000
2025-09-14,Arch Resources,30,7,3,40,0.075000
2025-09-14,Archer Daniels Midland,21,16,3,40,0.075000
2025-09-14,Ares Management,19,18,3,40,0.075000
2025-09-14,Arista Networks,13,24,3,40,0.075000
2025-09-14,Arrow Electronics,21,13,6,40,0.150000
2025-09-14,Arthur J Gallagher,20,20,0,40,0.000000
2025-09-14,Asbury Automotive Group,11,25,4,40,0.100000
2025-09-14,Assurant,25,11,4,40,0.100000
2025-09-14,Atkore,21,17,2,40,0.050000
2025-09-14,Atlassian,17,16,7,40,0.175000
2025-09-14,Atmos Energy,37,2,1,40,0.025000
2025-09-14,Auto-Owners Insurance,16,19,5,40,0.125000
2025-09-14,AutoNation,21,12,7,40,0.175000
2025-09-14,AutoZone,18,19,3,40,0.075000
2025-09-14,Autodesk,18,20,2,40,0.050000
2025-09-14,Autoliv,27,10,3,40,0.075000
2025-09-14,Automatic Data Processing,30,9,1,40,0.025000
2025-09-14,AvalonBay Communities,18,18,4,40,0.100000
2025-09-14,Avantor,15,17,8,40,0.200000
2025-09-14,Avery Dennison,16,24,0,40,0.000000
2025-09-14,Avient,11,25,4,40,0.100000
2025-09-14,Avis Budget,9,24,7,40,0.175000
2025-09-14,Avnet,13,26,1,40,0.025000
2025-09-14,BJs Wholesale Club,14,22,4,40,0.100000
2025-09-14,BOK Financial,24,12,4,40,0.100000
2025-09-14,BWX Technologies,23,17,0,40,0.000000
2025-09-14,Baker Hughes,16,23,1,40,0.025000
2025-09-14,Ball,16,16,8,40,0.200000
2025-09-14,Bank of America,19,20,1,40,0.025000
2025-09-14,Bank of New York Mellon,24,14,2,40,0.050000
2025-09-14,Bath & Body Works,19,13,8,40,0.200000
2025-09-14,Baxter International,11,23,6,40,0.150000
2025-09-14,Beacon Roofing Supply,9,23,8,40,0.200000
2025-09-14,Becton Dickinson,28,11,1,40,0.025000
2025-09-14,Belden,12,25,3,40,0.075000
2025-09-14,Benchmark Electronics,19,17,4,40,0.100000
2025-09-14,Berkshire Hathaway,9,18,13,40,0.325000
2025-09-14,Best Buy,35,1,4,40,0.100000
2025-09-14,Big Lots,6,32,2,40,0.050000
2025-09-14,Bio-Rad Laboratories,15,21,4,40,0.100000
2025-09-14,Biogen,19,21,0,40,0.000000
2025-09-14,BlackRock,11,28,1,40,0.025000
2025-09-14,Blackstone,20,16,4,40,0.100000
2025-09-14,Bloomin Brands,6,27,7,40,0.175000
2025-09-14,BlueLinx,14,20,6,40,0.150000
2025-09-14,Boeing,12,10,18,40,0.450000
2025-09-14,Boise Cascade,10,20,10,40,0.250000
2025-09-14,Booking Holdings,30,10,0,40,0.000000
2025-09-14,Booz Allen Hamilton,22,15,3,40,0.075000
2025-09-14,BorgWarner,23,13,4,40,0.100000
2025-09-14,Boston Properties,9,22,9,40,0.225000
2025-09-14,Boston Scientific,14,23,3,40,0.075000
2025-09-14,Boyd Gaming,17,21,2,40,0.050000
2025-09-14,Bread Financial,26,11,3,40,0.075000
2025-09-14,BrightSpring Health Services,18,17,5,40,0.125000
2025-09-14,BrightView Holdings,20,18,2,40,0.050000
2025-09-14,Brighthouse Financial,16,22,2,40,0.050000
2025-09-14,Brinker International,16,23,1,40,0.025000
2025-09-14,Brinks Company,11,4,6,21,0.285714
2025-09-14,Bristol-Myers Squibb,9,23,8,40,0.200000
2025-09-14,Broadcom,15,21,4,40,0.100000
2025-09-14,Broadridge Financial Solutions,37,3,0,40,0.000000
2025-09-14,Brookdale Senior Living,13,20,7,40,0.175000
2025-09-14,Brown & Brown,14,20,6,40,0.150000
2025-09-14,Brown-Forman,11,21,8,40,0.200000
2025-09-14,Bruker,16,19,5,40,0.125000
2025-09-14,Brunswick,7,25,8,40,0.200000
2025-09-14,Builders FirstSource,25,13,2,40,0.050000
2025-09-14,Burlington Stores,19,18,3,40,0.075000
2025-09-14,CACI International,25,13,2,40,0.050000
2025-09-14,CBRE Group,18,22,0,40,0.000000
2025-09-14,CDW,21,16,3,40,0.075000
2025-09-14,CF Industries,26,14,0,40,0.000000
2025-09-14,CH Robinson Worldwide,22,15,3,40,0.075000
2025-09-14,CHS,11,27,2,40,0.050000
2025-09-14,CME Group,20,16,4,40,0.100000
2025-09-14,CMS Energy,36,4,0,40,0.000000
2025-09-14,CNO Financial Group,16,22,2,40,0.050000
2025-09-14,CNX Resources,20,18,2,40,0.050000
2025-09-14,CSX,18,16,6,40,0.150000
2025-09-14,CVS Health,22,15,3,40,0.075000
2025-09-14,Cabot Corporation,19,20,1,40,0.025000
2025-09-14,Cadence,12,25,3,40,0.075000
2025-09-14,Caesars Entertainment,35,4,1,40,0.025000
2025-09-14,Cal-Maine Foods,27,11,2,40,0.050000
2025-09-14,Caleres inc,21,15,4,40,0.100000
2025-09-14,California Resources,17,20,3,40,0.075000
2025-09-14,Calumet,8,11,21,40,0.525000
2025-09-14,Campbell Soup,16,20,4,40,0.100000
2025-09-14,Camping World,14,20,6,40,0.150000
2025-09-14,Capital One,19,13,8,40,0.200000
2025-09-14,CarMax,10,26,4,40,0.100000
2025-09-14,Cardinal Health,22,13,5,40,0.125000
2025-09-14,Carlisle Companies,12,21,7,40,0.175000
2025-09-14,Carlyle Group,13,23,4,40,0.100000
2025-09-14,Carpenter Technology,20,19,1,40,0.025000
2025-09-14,Carrier Global,17,14,9,40,0.225000
2025-09-14,Carters inc,11,22,2,35,0.057143
2025-09-14,Carvana,22,16,2,40,0.050000
2025-09-14,Caseys General Stores,13,22,5,40,0.125000
2025-09-14,Catalent,9,26,5,40,0.125000
2025-09-14,Caterpillar,25,13,2,40,0.050000
2025-09-14,Cboe Global Markets,13,27,0,40,0.000000
2025-09-14,Celanese,15,15,10,40,0.250000
2025-09-14,Cencora,21,13,6,40,0.150000
2025-09-14,Centene,18,19,3,40,0.075000
2025-09-14,CenterPoint Energy,27,5,8,40,0.200000
2025-09-14,Central Garden & Pet,6,34,0,40,0.000000
2025-09-14,Century Communities,15,22,3,40,0.075000
2025-09-14,ChampionX,18,21,1,40,0.025000
2025-09-14,Charles River Laboratories International,17,18,5,40,0.125000
2025-09-14,Charles Schwab,12,26,2,40,0.050000
2025-09-14,Chart Industries,14,22,4,40,0.100000
2025-09-14,Charter Communications,13,18,9,40,0.225000
2025-09-14,Cheesecake Factory,12,19,9,40,0.225000
2025-09-14,Chefs Warehouse,17,19,4,40,0.100000
2025-09-14,Chemours,15,14,11,40,0.275000
2025-09-14,Cheniere Energy,38,2,0,40,0.000000
2025-09-14,Chevron,19,18,3,40,0.075000
2025-09-14,Chewy,17,13,10,40,0.250000
2025-09-14,Chipotle Mexican Grill,13,25,2,40,0.050000
2025-09-14,Chord Energy,39,0,1,40,0.025000
2025-09-14,Church & Dwight,19,21,0,40,0.000000
2025-09-14,Ciena,22,17,1,40,0.025000
2025-09-14,Cigna,17,19,4,40,0.100000
2025-09-14,Cincinnati Financial,16,20,4,40,0.100000
2025-09-14,Cinemark,14,20,6,40,0.150000
2025-09-14,Cintas,24,14,2,40,0.050000
2025-09-14,Cisco Systems,28,12,0,40,0.000000
2025-09-14,Citigroup,18,19,3,40,0.075000
2025-09-14,Citizens Financial Group,13,25,2,40,0.050000
2025-09-14,Civitas Resources,15,15,10,40,0.250000
2025-09-14,Clean Harbors,34,2,4,40,0.100000
2025-09-14,Clear Channel Outdoor Hldgs,8,0,2,10,0.200000
2025-09-14,Cleveland-Cliffs,14,16,10,40,0.250000
2025-09-14,Clorox,23,13,4,40,0.100000
2025-09-14,Cognizant Technology Solutions,40,0,0,40,0.000000
2025-09-14,Coherent,19,18,3,40,0.075000
2025-09-14,Coinbase Global,13,21,6,40,0.150000
2025-09-14,Colgate-Palmolive,14,18,8,40,0.200000
2025-09-14,Columbia Banking System,15,23,2,40,0.050000
2025-09-14,Columbia Sportswear,10,19,11,40,0.275000
2025-09-14,Comcast,26,9,5,40,0.125000
2025-09-14,Comerica,16,20,4,40,0.100000
2025-09-14,Comfort Systems USA,40,0,0,40,0.000000
2025-09-14,CommScope,16,22,2,40,0.050000
2025-09-14,Commercial Metals,15,17,8,40,0.200000
2025-09-14,Community Health Systems,17,18,5,40,0.125000
2025-09-14,Compass,12,26,2,40,0.050000
2025-09-14,Conagra Brands,18,21,1,40,0.025000
2025-09-14,Concentrix,19,16,5,40,0.125000
2025-09-14,Conduent,13,18,9,40,0.225000
2025-09-14,ConocoPhillips,15,14,11,40,0.275000
2025-09-14,Consol Energy,32,6,2,40,0.050000
2025-09-14,Consolidated Edison,10,24,6,40,0.150000
2025-09-14,Constellation Brands,9,13,18,40,0.450000
2025-09-14,Constellation Energy,33,3,4,40,0.100000
2025-09-14,Continental Resources,19,13,8,40,0.200000
2025-09-14,Cooper Cos,7,29,4,40,0.100000
2025-09-14,Cooper-Standard,10,29,1,40,0.025000
2025-09-14,Copart,18,22,0,40,0.000000
2025-09-14,Core & Main,13,16,11,40,0.275000
2025-09-14,Cornerstone Building Brands,15,20,5,40,0.125000
2025-09-14,Corning,19,17,4,40,0.100000
2025-09-14,Corpay,19,21,0,40,0.000000
2025-09-14,Corteva,16,24,0,40,0.000000
2025-09-14,Costco,22,12,6,40,0.150000
2025-09-14,Coterra Energy,38,1,1,40,0.025000
2025-09-14,Coty,12,18,10,40,0.250000
2025-09-14,Country Financial,12,26,2,40,0.050000
2025-09-14,Coupang,21,15,4,40,0.100000
2025-09-14,Cracker Barrel Old Country Store,5,28,7,40,0.175000
2025-09-14,Crocs,15,19,6,40,0.150000
2025-09-14,CrossAmerica Partners,12,26,2,40,0.050000
2025-09-14,CrowdStrike,22,12,6,40,0.150000
2025-09-14,Crown Castle,19,20,1,40,0.025000
2025-09-14,Crown Holdings,15,22,3,40,0.075000
2025-09-14,Cullen Frost Bankers,17,21,2,40,0.050000
2025-09-14,Cummins,19,12,9,40,0.225000
2025-09-14,Curtiss-Wright,23,16,1,40,0.025000
2025-09-14,DR Horton,25,14,1,40,0.025000
2025-09-14,DTE Energy,35,2,3,40,0.075000
2025-09-14,DXC Technology,21,18,1,40,0.025000
2025-09-14,DaVita,18,8,14,40,0.350000
2025-09-14,Dana Incorporated,21,14,5,40,0.125000
2025-09-14,Danaher,21,18,1,40,0.025000
2025-09-14,Darden Restaurants,18,17,5,40,0.125000
2025-09-14,Darling Ingredients,39,0,1,40,0.025000
2025-09-14,Deckers Outdoor,22,17,1,40,0.025000
2025-09-14,Deere,12,19,9,40,0.225000
2025-09-14,Delek US,18,19,3,40,0.075000
2025-09-14,Dell Technologies,14,21,5,40,0.125000
2025-09-14,Delta Air Lines,8,17,15,40,0.375000
2025-09-14,Dentsply Sirona,14,26,0,40,0.000000
2025-09-14,Designer Brands,11,24,5,40,0.125000
2025-09-14,Devon Energy,36,3,1,40,0.025000
2025-09-14,DexCom,19,17,4,40,0.100000
2025-09-14,Diamondback Energy,36,1,3,40,0.075000
2025-09-14,Dicks Sporting Goods,12,27,1,40,0.025000
2025-09-14,Diebold Nixdorf,15,24,1,40,0.025000
2025-09-14,Digital Realty Trust,39,1,0,40,0.000000
2025-09-14,Dillards,13,16,11,40,0.275000
2025-09-14,DocuSign,16,18,6,40,0.150000
2025-09-14,Dollar General,5,20,15,40,0.375000
2025-09-14,Dollar Tree,19,17,4,40,0.100000
2025-09-14,Dominion Energy,26,8,6,40,0.150000
2025-09-14,Dominos Pizza inc,17,13,6,36,0.166667
2025-09-14,Domtar,9,24,7,40,0.175000
2025-09-14,Donaldson Company,27,12,1,40,0.025000
2025-09-14,DoorDash,20,15,5,40,0.125000
2025-09-14,Dover Corporation,20,19,1,40,0.025000
2025-09-14,DraftKings,27,12,1,40,0.025000
2025-09-14,Dream Finders Homes,38,1,1,40,0.025000
2025-09-14,Dropbox,21,17,2,40,0.050000
2025-09-14,DuPont,16,15,9,40,0.225000
2025-09-14,Duke Energy,35,2,3,40,0.075000
2025-09-14,Dycom Industries,18,18,4,40,0.100000
2025-09-14,EMCOR Group,14,24,2,40,0.050000
2025-09-14,EOG Resources,22,18,0,40,0.000000
2025-09-14,EPAM Systems,21,17,2,40,0.050000
2025-09-14,EQT,19,20,1,40,0.025000
2025-09-14,ESAB,14,25,1,40,0.025000
2025-09-14,East West Bancorp,22,16,2,40,0.050000
2025-09-14,Eastman Chemical,15,16,9,40,0.225000
2025-09-14,Ebay,11,22,7,40,0.175000
2025-09-14,EchoStar,9,22,9,40,0.225000
2025-09-14,Ecolab,25,11,4,40,0.100000
2025-09-14,Edison International,9,23,8,40,0.200000
2025-09-14,Edward Jones,17,15,8,40,0.200000
2025-09-14,Edwards Lifesciences,20,13,7,40,0.175000
2025-09-14,Elanco Animal Health,14,24,2,40,0.050000
2025-09-14,Electronic Arts,13,21,6,40,0.150000
2025-09-14,Elevance Health,26,10,4,40,0.100000
2025-09-14,Eli Lilly,6,22,12,40,0.300000
2025-09-14,Emerson Electric,24,16,0,40,0.000000
2025-09-14,EnLink Midstream,17,18,5,40,0.125000
2025-09-14,Encompass Health,11,26,3,40,0.075000
2025-09-14,Endeavor Group,13,23,4,40,0.100000
2025-09-14,EnerSys,18,21,1,40,0.025000
2025-09-14,Energizer,39,1,0,40,0.000000
2025-09-14,Energy Transfer,32,1,7,40,0.175000
2025-09-14,Ensign Group,24,14,2,40,0.050000
2025-09-14,Entegris,21,18,1,40,0.025000
2025-09-14,Entergy,26,11,3,40,0.075000
2025-09-14,Enterprise Products Partners,22,13,5,40,0.125000
2025-09-14,Envista,17,20,3,40,0.075000
2025-09-14,Equifax,25,12,3,40,0.075000
2025-09-14,Equinix,27,10,3,40,0.075000
2025-09-14,Equitable,22,13,5,40,0.125000
2025-09-14,Equity Residential,20,19,1,40,0.025000
2025-09-14,Erie Insurance,18,13,9,40,0.225000
2025-09-14,Estée Lauder,17,16,7,40,0.175000
2025-09-14,Etsy,12,9,19,40,0.475000
2025-09-14,Euronet Worldwide,14,23,3,40,0.075000
2025-09-14,Evergy,25,11,4,40,0.100000
2025-09-14,Eversource Energy,31,4,5,40,0.125000
2025-09-14,Exact Sciences,10,18,12,40,0.300000
2025-09-14,Exelon,22,15,3,40,0.075000
2025-09-14,Expand Energy,40,0,0,40,0.000000
2025-09-14,Expedia,22,17,1,40,0.025000
2025-09-14,Expeditors International of Washington,21,17,2,40,0.050000
2025-09-14,Extra Space Storage,18,21,1,40,0.025000
2025-09-14,Exxon Mobil,20,19,1,40,0.025000
2025-09-14,F5,25,15,0,40,0.000000
2025-09-14,FM Global,17,15,8,40,0.200000
2025-09-14,FMC Corporation,17,22,1,40,0.025000
2025-09-14,FTI Consulting,15,17,8,40,0.200000
2025-09-14,Fannie Mae,7,32,1,40,0.025000
2025-09-14,Farmers Insurance Exchange,11,16,13,40,0.325000
2025-09-14,Fastenal,22,15,3,40,0.075000
2025-09-14,FedEx,19,13,8,40,0.200000
2025-09-14,Federated Mutual Insurance,15,19,6,40,0.150000
2025-09-14,Fidelity National Financial,15,20,5,40,0.125000
2025-09-14,Fidelity National Information Services,23,13,4,40,0.100000
2025-09-14,Fifth Third Bancorp,13,14,13,40,0.325000
2025-09-14,First American Financial,19,18,3,40,0.075000
2025-09-14,First Citizens BancShares,14,24,2,40,0.050000
2025-09-14,First Horizon,19,21,0,40,0.000000
2025-09-14,First National of Nebraska,17,23,0,40,0.000000
2025-09-14,First Solar,23,15,2,40,0.050000
2025-09-14,FirstCash,13,22,5,40,0.125000
2025-09-14,FirstEnergy,18,15,7,40,0.175000
2025-09-14,Fiserv,23,14,3,40,0.075000
2025-09-14,Five Below,19,19,2,40,0.050000
2025-09-14,Flagstar Financial,14,22,4,40,0.100000
2025-09-14,Floor & Decor,20,16,4,40,0.100000
2025-09-14,Flowers Foods,9,21,10,40,0.250000
2025-09-14,Flowserve,15,22,3,40,0.075000
2025-09-14,Fluor,20,14,6,40,0.150000
2025-09-14,Foot Locker,4,30,6,40,0.150000
2025-09-14,Ford Motor,18,16,6,40,0.150000
2025-09-14,Fortinet,23,12,5,40,0.125000
2025-09-14,Fortive,16,20,4,40,0.100000
2025-09-14,Fortune Brands Innovations,12,24,4,40,0.100000
2025-09-14,Franklin Resources,18,18,4,40,0.100000
2025-09-14,Freddie Mac,13,20,7,40,0.175000
2025-09-14,Freeport-McMoRan,22,10,8,40,0.200000
2025-09-14,Frontier Airlines,16,18,6,40,0.150000
2025-09-14,Frontier Communications,16,22,2,40,0.050000
2025-09-14,G-III Apparel Group,12,24,4,40,0.100000
2025-09-14,GE HealthCare Technologies,25,14,1,40,0.025000
2025-09-14,GMS,14,26,0,40,0.000000
2025-09-14,GXO Logistics,17,17,6,40,0.150000
2025-09-14,GameStop,21,11,8,40,0.200000
2025-09-14,Gannett,16,15,9,40,0.225000
2025-09-14,Garrett Motion inc,18,17,5,40,0.125000
2025-09-14,Gartner,14,23,3,40,0.075000
2025-09-14,Gen Digital,19,18,3,40,0.075000
2025-09-14,Generac,21,14,5,40,0.125000
2025-09-14,General Dynamics,38,0,2,40,0.050000
2025-09-14,General Electric,12,28,0,40,0.000000
2025-09-14,General Mills,21,18,1,40,0.025000
2025-09-14,General Motors,24,13,3,40,0.075000
2025-09-14,Genesis Energy,36,3,1,40,0.025000
2025-09-14,Genuine Parts,16,22,2,40,0.050000
2025-09-14,Genworth Financial,19,20,1,40,0.025000
2025-09-14,Gilead Sciences,17,19,4,40,0.100000
2025-09-14,Global Partners,19,18,3,40,0.075000
2025-09-14,Global Payments,15,22,3,40,0.075000
2025-09-14,Globe Life,18,17,5,40,0.125000
2025-09-14,GoDaddy,14,24,2,40,0.050000
2025-09-14,Goldman Sachs,20,13,7,40,0.175000
2025-09-14,Goodyear Tire & Rubber,13,23,4,40,0.100000
2025-09-14,Graham Holdings Company,20,18,2,40,0.050000
2025-09-14,Granite Construction,21,18,1,40,0.025000
2025-09-14,Graphic Packaging,12,21,7,40,0.175000
2025-09-14,Gray Television,14,21,5,40,0.125000
2025-09-14,Graybar Electric,13,21,6,40,0.150000
2025-09-14,Green Plains inc,18,17,5,40,0.125000
2025-09-14,Greenbrier,7,18,15,40,0.375000
2025-09-14,Greif,11,27,2,40,0.050000
2025-09-14,Griffon Corporation,17,21,2,40,0.050000
2025-09-14,Grocery Outlet Holding,17,22,1,40,0.025000
2025-09-14,Group 1 Automotive,14,22,4,40,0.100000
2025-09-14,Guardian Life insurance,19,21,0,40,0.000000
2025-09-14,Guess inc,12,26,2,40,0.050000
2025-09-14,H B Fuller,12,24,4,40,0.100000
2025-09-14,HCA Healthcare,26,13,1,40,0.025000
2025-09-14,HEICO,17,19,4,40,0.100000
2025-09-14,HF Sinclair,15,21,4,40,0.100000
2025-09-14,Halliburton,10,18,12,40,0.300000
2025-09-14,Hanesbrands,16,22,2,40,0.050000
2025-09-14,Hanover Insurance Group,18,20,2,40,0.050000
2025-09-14,Harley-Davidson,13,24,3,40,0.075000
2025-09-14,Hasbro,10,28,2,40,0.050000
2025-09-14,Hawaiian Airlines inc,14,26,0,40,0.000000
2025-09-14,Hawaiian Electric Industries,17,21,2,40,0.050000
2025-09-14,Helmerich & Payne,9,27,4,40,0.100000
2025-09-14,Henry Schein,20,19,1,40,0.025000
2025-09-14,Herc Rentals,17,17,6,40,0.150000
2025-09-14,Hershey,19,16,5,40,0.125000
2025-09-14,Hertz,28,8,4,40,0.100000
2025-09-14,Hewlett Packard,10,28,2,40,0.050000
2025-09-14,Hewlett Packard Enterprise,9,30,1,40,0.025000
2025-09-14,Hillenbrand,19,19,2,40,0.050000
2025-09-14,Hilton Grand Vacations,39,1,0,40,0.000000
2025-09-14,Hilton Worldwide,19,19,2,40,0.050000
2025-09-14,Hologic,12,24,4,40,0.100000
2025-09-14,Home Depot,22,14,4,40,0.100000
2025-09-14,Honeywell,15,21,4,40,0.100000
2025-09-14,Hormel Foods,11,27,2,40,0.050000
2025-09-14,Host Hotels & Resorts,14,25,1,40,0.025000
2025-09-14,Hovnanian Enterprises,10,24,6,40,0.150000
2025-09-14,Howmet Aerospace,16,20,4,40,0.100000
2025-09-14,Hub Group,13,19,8,40,0.200000
2025-09-14,Hubbell,21,12,7,40,0.175000
2025-09-14,Humana,20,16,4,40,0.100000
2025-09-14,Huntington Bancshares,21,17,2,40,0.050000
2025-09-14,Huntington Ingalls Industries,24,11,5,40,0.125000
2025-09-14,Huntsman,6,22,12,40,0.300000
2025-09-14,Hyatt Hotels,13,26,1,40,0.025000
2025-09-14,Hyster-Yale,15,21,4,40,0.100000
2025-09-14,IAC,12,23,5,40,0.125000
2025-09-14,IBM,20,16,4,40,0.100000
2025-09-14,IDEX,20,15,5,40,0.125000
2025-09-14,IDEXX Laboratories,21,16,3,40,0.075000
2025-09-14,IQVIA,25,14,1,40,0.025000
2025-09-14,ITT,14,19,7,40,0.175000
2025-09-14,Icahn Enterprises,10,18,12,40,0.300000
2025-09-14,Illinois Tool Works,26,12,2,40,0.050000
2025-09-14,Illumina inc,20,18,2,40,0.050000
2025-09-14,Incyte,22,15,3,40,0.075000
2025-09-14,Ingersoll Rand,20,16,4,40,0.100000
2025-09-14,Ingles Markets,10,22,8,40,0.200000
2025-09-14,Ingram Micro,12,13,15,40,0.375000
2025-09-14,Ingredion,23,15,2,40,0.050000
2025-09-14,Insight Enterprises,14,21,5,40,0.125000
2025-09-14,Insperity,17,20,3,40,0.075000
2025-09-14,Instacart,12,24,4,40,0.100000
2025-09-14,Installed Building Products,10,27,3,40,0.075000
2025-09-14,Intel,14,19,7,40,0.175000
2025-09-14,Interactive Brokers,15,24,1,40,0.025000
2025-09-14,Intercontinental Exchange,13,27,0,40,0.000000
2025-09-14,International Flavors & Fragrances,18,20,2,40,0.050000
2025-09-14,International Paper,13,24,3,40,0.075000
2025-09-14,Interpublic Group,22,17,1,40,0.025000
2025-09-14,Intuit,22,15,3,40,0.075000
2025-09-14,Intuitive Surgical,15,16,9,40,0.225000
2025-09-14,Iron Mountain,13,24,3,40,0.075000
2025-09-14,JB Hunt Transport Services,13,22,5,40,0.125000
2025-09-14,JELD-WEN Holding,11,23,6,40,0.150000
2025-09-14,JM Smucker,19,19,2,40,0.050000
2025-09-14,JPMorgan Chase,19,16,5,40,0.125000
2025-09-14,Jabil,11,28,1,40,0.025000
2025-09-14,Jackson Financial,19,18,3,40,0.075000
2025-09-14,Jacobs Solutions,34,1,5,40,0.125000
2025-09-14,Jefferies Financial,4,28,8,40,0.200000
2025-09-14,JetBlue Airways,12,25,3,40,0.075000
2025-09-14,Johnson & Johnson,18,19,3,40,0.075000
2025-09-14,Jones Lang LaSalle,19,18,3,40,0.075000
2025-09-14,Juniper Networks,14,23,3,40,0.075000
2025-09-14,KB Home,26,14,0,40,0.000000
2025-09-14,KBR,25,13,2,40,0.050000
2025-09-14,KKR & Co,23,15,2,40,0.050000
2025-09-14,KLA,23,13,4,40,0.100000
2025-09-14,Kaiser Aluminum,15,22,3,40,0.075000
2025-09-14,Kellanova,19,18,3,40,0.075000
2025-09-14,Kelly Services inc,17,17,6,40,0.150000
2025-09-14,Kemper,11,18,11,40,0.275000
2025-09-14,Keurig Dr Pepper,9,26,5,40,0.125000
2025-09-14,KeyCorp,20,19,1,40,0.025000
2025-09-14,Keysight Technologies,22,17,1,40,0.025000
2025-09-14,Kimberly-Clark,14,22,4,40,0.100000
2025-09-14,Kinder Morgan,40,0,0,40,0.000000
2025-09-14,Kirby Corporation,21,17,2,40,0.050000
2025-09-14,Knife River Corporation,21,15,4,40,0.100000
2025-09-14,Knight Swift Transportation,14,20,6,40,0.150000
2025-09-14,Kohls,15,18,7,40,0.175000
2025-09-14,Kontoor Brands,18,20,2,40,0.050000
2025-09-14,Korn Ferry,17,18,5,40,0.125000
2025-09-14,Kraft Heinz,11,20,9,40,0.225000
2025-09-14,Kroger,17,14,9,40,0.225000
2025-09-14,Kyndryl,17,21,2,40,0.050000
2025-09-14,L3Harris Technologies,16,23,1,40,0.025000
2025-09-14,LCI Industries,17,21,2,40,0.050000
2025-09-14,LKQ,12,27,1,40,0.025000
2025-09-14,LPL Financial,28,12,0,40,0.000000
2025-09-14,Labcorp Holdings,23,15,2,40,0.050000
2025-09-14,Lam Research,28,10,2,40,0.050000
2025-09-14,Lamb Weston,11,25,4,40,0.100000
2025-09-14,Land OLakes,11,20,9,40,0.225000
2025-09-14,Landstar System,14,18,8,40,0.200000
2025-09-14,Las Vegas Sands,15,23,2,40,0.050000
2025-09-14,Lear Corporation,24,14,2,40,0.050000
2025-09-14,Leggett & Platt,15,21,4,40,0.100000
2025-09-14,Leidos,22,13,5,40,0.125000
2025-09-14,Lennar,8,29,3,40,0.075000
2025-09-14,Lennox International,16,21,3,40,0.075000
2025-09-14,Levi Strauss,12,27,1,40,0.025000
2025-09-14,Liberty Energy,39,1,0,40,0.000000
2025-09-14,Liberty Media,38,2,0,40,0.000000
2025-09-14,Liberty Mutual Insurance,33,1,6,40,0.150000
2025-09-14,Light & Wonder,7,22,11,40,0.275000
2025-09-14,Lincoln Electric,17,21,2,40,0.050000
2025-09-14,Lincoln National,12,16,12,40,0.300000
2025-09-14,Lithia Motors,20,16,4,40,0.100000
2025-09-14,Live Nation Entertainment,36,3,1,40,0.025000
2025-09-14,Lockheed Martin,21,15,4,40,0.100000
2025-09-14,Loews,18,20,2,40,0.050000
2025-09-14,Louisiana-Pacific Corporation,20,17,3,40,0.075000
2025-09-14,Lowes,15,18,7,40,0.175000
2025-09-14,Lululemon athletica,5,21,14,40,0.350000
2025-09-14,Lumen Technologies,4,27,9,40,0.225000
2025-09-14,Lyft,14,18,8,40,0.200000
2025-09-14,M&T Bank,14,26,0,40,0.000000
2025-09-14,M/I Homes,14,21,5,40,0.125000
2025-09-14,MDU Resources Group,18,22,0,40,0.000000
2025-09-14,MGM Resorts International,18,20,2,40,0.050000
2025-09-14,MKS Instruments,17,23,0,40,0.000000
2025-09-14,MRC Global,19,21,0,40,0.000000
2025-09-14,MSC Industrial Direct,13,24,3,40,0.075000
2025-09-14,MSCI,16,19,5,40,0.125000
2025-09-14,MYR Group,15,23,2,40,0.050000
2025-09-14,Macys,17,18,5,40,0.125000
2025-09-14,ManpowerGroup,19,15,6,40,0.150000
2025-09-14,Marathon Oil,14,22,4,40,0.100000
2025-09-14,Marathon Petroleum,22,14,4,40,0.100000
2025-09-14,Markel Group,16,20,4,40,0.100000
2025-09-14,Marriott International,17,19,4,40,0.100000
2025-09-14,Marriott Vacations Worldwide,19,19,2,40,0.050000
2025-09-14,Marsh & McLennan,28,11,1,40,0.025000
2025-09-14,Martin Marietta Materials,16,15,9,40,0.225000
2025-09-14,Marvell Technology,17,20,3,40,0.075000
2025-09-14,MasTec,21,19,0,40,0.000000
2025-09-14,Masco,14,22,4,40,0.100000
2025-09-14,Mass Mutual,13,22,5,40,0.125000
2025-09-14,MasterBrand,10,28,2,40,0.050000
2025-09-14,Mastercard,17,19,4,40,0.100000
2025-09-14,Matador Resources,12,21,7,40,0.175000
2025-09-14,Match Group,11,19,10,40,0.250000
2025-09-14,Mativ,20,17,3,40,0.075000
2025-09-14,Matson inc,23,14,3,40,0.075000
2025-09-14,Mattel,16,19,5,40,0.125000
2025-09-14,Maximus,13,25,2,40,0.050000
2025-09-14,McCormick & Company,17,19,4,40,0.100000
2025-09-14,McDonalds,16,16,8,40,0.200000
2025-09-14,McKesson,24,12,4,40,0.100000
2025-09-14,Medical Mutual of Ohio,14,20,6,40,0.150000
2025-09-14,Merck,13,17,10,40,0.250000
2025-09-14,Mercury General,12,19,9,40,0.225000
2025-09-14,Meritage Homes,16,21,3,40,0.075000
2025-09-14,MetLife,16,20,4,40,0.100000
2025-09-14,Meta,19,11,10,40,0.250000
2025-09-14,Mettler-Toledo International,26,13,1,40,0.025000
2025-09-14,Microchip Technology,23,14,3,40,0.075000
2025-09-14,Micron Technology,19,17,4,40,0.100000
2025-09-14,Microsoft,20,15,5,40,0.125000
2025-09-14,Middleby,17,19,4,40,0.100000
2025-09-14,MillerKnoll,18,19,3,40,0.075000
2025-09-14,Moderna,10,21,9,40,0.225000
2025-09-14,ModivCare,11,21,8,40,0.200000
2025-09-14,Mohawk Industries,24,13,3,40,0.075000
2025-09-14,Molina Healthcare,20,11,9,40,0.225000
2025-09-14,Molson Coors Beverage,13,18,9,40,0.225000
2025-09-14,Mondelez,13,24,3,40,0.075000
2025-09-14,Monster Beverage,22,15,3,40,0.075000
2025-09-14,Moodys Corporation,3,10,2,15,0.133333
2025-09-14,Moog inc,20,16,4,40,0.100000
2025-09-14,Morgan Stanley,16,16,8,40,0.200000
2025-09-14,Mosaic,15,23,2,40,0.050000
2025-09-14,Motorola Solutions,38,0,2,40,0.050000
2025-09-14,Mueller Industries,22,16,2,40,0.050000
2025-09-14,Murphy Oil,14,24,2,40,0.050000
2025-09-14,Murphy USA,15,24,1,40,0.025000
2025-09-14,Mutual of Omaha,19,17,4,40,0.100000
2025-09-14,NCR Atleos,14,25,1,40,0.025000
2025-09-14,NCR Voyix,10,26,4,40,0.100000
2025-09-14,NGL Energy Partners,39,0,1,40,0.025000
2025-09-14,NLV Financial,4,4,2,10,0.200000
2025-09-14,NOV,14,19,7,40,0.175000
2025-09-14,NRG Energy,36,2,2,40,0.050000
2025-09-14,NVR,18,19,3,40,0.075000
2025-09-14,Nasdaq,19,17,4,40,0.100000
2025-09-14,Nationwide Insurance,10,19,11,40,0.275000
2025-09-14,Navient,17,17,6,40,0.150000
2025-09-14,NetApp,20,17,3,40,0.075000
2025-09-14,Netflix,13,11,16,40,0.400000
2025-09-14,NeueHealth,12,26,2,40,0.050000
2025-09-14,New York Life Insurance,15,23,2,40,0.050000
2025-09-14,NewMarket Corporation,20,17,3,40,0.075000
2025-09-14,Newell Brands,15,21,4,40,0.100000
2025-09-14,Newmont,19,18,3,40,0.075000
2025-09-14,News Corp,18,13,9,40,0.225000
2025-09-14,Nexstar Media Group,18,19,3,40,0.075000
2025-09-14,NextEra Energy,40,0,0,40,0.000000
2025-09-14,NiSource,15,14,11,40,0.275000
2025-09-14,Nike,17,21,2,40,0.050000
2025-09-14,Nordson,21,18,1,40,0.025000
2025-09-14,Nordstrom,16,18,6,40,0.150000
2025-09-14,Norfolk Southern,14,20,6,40,0.150000
2025-09-14,Northern Trust,38,2,0,40,0.000000
2025-09-14,Northrop Grumman,16,19,5,40,0.125000
2025-09-14,Northwestern Mutual,20,14,6,40,0.150000
2025-09-14,Nucor,16,21,3,40,0.075000
2025-09-14,Nvidia,19,15,6,40,0.150000
2025-09-14,O-I Glass,16,22,2,40,0.050000
2025-09-14,ODP Business Solutions,20,18,2,40,0.050000
2025-09-14,OGE Energy,38,0,2,40,0.050000
2025-09-14,ON Semiconductor,15,16,9,40,0.225000
2025-09-14,OReilly Automotive,5,14,9,28,0.321429
2025-09-14,Occidental Petroleum,9,25,6,40,0.150000
2025-09-14,Old Dominion Freight Line,17,19,4,40,0.100000
2025-09-14,Old National Bancorp,13,27,0,40,0.000000
2025-09-14,Old Republic International,23,14,3,40,0.075000
2025-09-14,Olin,17,13,10,40,0.250000
2025-09-14,Omnicom Group,25,14,1,40,0.025000
2025-09-14,OneMain,20,20,0,40,0.000000
2025-09-14,Oneok,25,15,0,40,0.000000
2025-09-14,Opendoor Technologies,14,20,6,40,0.150000
2025-09-14,Option Care Health,40,0,0,40,0.000000
2025-09-14,Oracle,20,15,5,40,0.125000
2025-09-14,Organon,18,16,6,40,0.150000
2025-09-14,Oscar Health,15,15,10,40,0.250000
2025-09-14,Oshkosh Corporation,15,20,5,40,0.125000
2025-09-14,Otis Worldwide,18,18,4,40,0.100000
2025-09-14,Ovintiv,22,12,6,40,0.150000
2025-09-14,Owens & Minor,9,26,5,40,0.125000
2025-09-14,Owens Corning,19,19,2,40,0.050000
2025-09-14,PACS Group,14,13,13,40,0.325000
2025-09-14,PBF Energy,37,0,3,40,0.075000
2025-09-14,PC Connection Inc,20,19,1,40,0.025000
2025-09-14,PENN Entertainment,34,6,0,40,0.000000
2025-09-14,PG&E,16,15,9,40,0.225000
2025-09-14,PNC Financial Services,15,22,3,40,0.075000
2025-09-14,PPG Industries,21,15,4,40,0.100000
2025-09-14,PPL,14,20,6,40,0.150000
2025-09-14,PVH,16,17,7,40,0.175000
2025-09-14,Paccar,20,16,4,40,0.100000
2025-09-14,Pacific Life,15,24,1,40,0.025000
2025-09-14,Packaging Corp of America,8,27,5,40,0.125000
2025-09-14,Palo Alto Networks,12,18,10,40,0.250000
2025-09-14,Par Pacific,14,23,3,40,0.075000
2025-09-14,Paramount Global,7,24,9,40,0.225000
2025-09-14,Park Hotels & Resorts,15,22,3,40,0.075000
2025-09-14,Parker-Hannifin,25,13,2,40,0.050000
2025-09-14,Parsons Corporation,23,16,1,40,0.025000
2025-09-14,Patrick Industries,17,20,3,40,0.075000
2025-09-14,Patterson Companies Inc,11,27,2,40,0.050000
2025-09-14,Patterson-UTI Energy,33,6,1,40,0.025000
2025-09-14,PayPal,21,8,11,40,0.275000
2025-09-14,Paychex,26,11,3,40,0.075000
2025-09-14,Peabody Energy,34,5,1,40,0.025000
2025-09-14,Peloton,26,11,3,40,0.075000
2025-09-14,Penn Mutual Life Insurance,18,18,4,40,0.100000
2025-09-14,PennyMac Financial Services,18,19,3,40,0.075000
2025-09-14,Penske Automotive,13,25,2,40,0.050000
2025-09-14,PepsiCo,23,14,3,40,0.075000
2025-09-14,Performance Food,13,22,5,40,0.125000
2025-09-14,Permian Resources,18,21,1,40,0.025000
2025-09-14,Petco Health and Wellness,35,3,2,40,0.050000
2025-09-14,Peter Kiewit Sons,6,19,15,40,0.375000
2025-09-14,Pfizer,21,15,4,40,0.100000
2025-09-14,Philip Morris,17,21,2,40,0.050000
2025-09-14,Phillips 66,19,20,1,40,0.025000
2025-09-14,Pinnacle West Capital,15,16,9,40,0.225000
2025-09-14,Pinterest,14,24,2,40,0.050000
2025-09-14,Pioneer Natural Resources,18,10,12,40,0.300000
2025-09-14,Pitney Bowes,18,22,0,40,0.000000
2025-09-14,Plains GP,16,12,12,40,0.300000
2025-09-14,Playtika Holding,10,21,9,40,0.225000
2025-09-14,Plexus,7,21,12,40,0.300000
2025-09-14,Polaris Inc,21,17,2,40,0.050000
2025-09-14,Pool Corporation,18,19,3,40,0.075000
2025-09-14,Popular inc,39,1,0,40,0.000000
2025-09-14,Portland General Electric,17,20,3,40,0.075000
2025-09-14,Post Holdings,12,27,1,40,0.025000
2025-09-14,PriceSmart,16,22,2,40,0.050000
2025-09-14,Primerica,17,17,6,40,0.150000
2025-09-14,Primoris Services,20,18,2,40,0.050000
2025-09-14,Principal Financial,22,15,3,40,0.075000
2025-09-14,ProFrac Holding,16,18,6,40,0.150000
2025-09-14,Procter & Gamble,16,16,8,40,0.200000
2025-09-14,Progressive Insurance,16,22,2,40,0.050000
2025-09-14,Prologis,27,11,2,40,0.050000
2025-09-14,Prudential Financial,26,11,3,40,0.075000
2025-09-14,Public Service Enterprise Group,21,18,1,40,0.025000
2025-09-14,Public Storage,17,17,6,40,0.150000
2025-09-14,Publix Super Markets,24,13,3,40,0.075000
2025-09-14,Puget Sound Energy,31,7,2,40,0.050000
2025-09-14,PulteGroup,21,15,4,40,0.100000
2025-09-14,Pure Storage,10,26,4,40,0.100000
2025-09-14,QVC,16,20,4,40,0.100000
2025-09-14,Qorvo,20,17,3,40,0.075000
2025-09-14,Quad/Graphics,14,22,4,40,0.100000
2025-09-14,Qualcomm,20,19,1,40,0.025000
2025-09-14,Quanta Services,25,13,2,40,0.050000
2025-09-14,Quest Diagnostics,13,26,1,40,0.025000
2025-09-14,QuidelOrtho,17,20,3,40,0.075000
2025-09-14,REV Group,21,15,4,40,0.100000
2025-09-14,RPM International,16,22,2,40,0.050000
2025-09-14,RTX,20,17,3,40,0.075000
2025-09-14,RXO inc,15,20,5,40,0.125000
2025-09-14,Rackspace Technology,15,21,4,40,0.100000
2025-09-14,Radius Recycling,3,23,14,40,0.350000
2025-09-14,Ralph Lauren,11,27,2,40,0.050000
2025-09-14,Range Resources,22,15,3,40,0.075000
2025-09-14,Raymond James Financial,19,18,3,40,0.075000
2025-09-14,Realty Income,18,18,4,40,0.100000
2025-09-14,Regal Rexnord,16,22,2,40,0.050000
2025-09-14,Regeneron Pharmaceuticals,27,10,3,40,0.075000
2025-09-14,Regions Financial,21,19,0,40,0.000000
2025-09-14,Reinsurance Group of America,22,17,1,40,0.025000
2025-09-14,Reliance Inc,23,14,3,40,0.075000
2025-09-14,Republic Services,18,17,5,40,0.125000
2025-09-14,ResMed,22,18,0,40,0.000000
2025-09-14,Resideo Technologies,22,15,3,40,0.075000
2025-09-14,Restoration Hardware,12,20,8,40,0.200000
2025-09-14,Revvity,18,18,4,40,0.100000
2025-09-14,Rite Aid,6,27,7,40,0.175000
2025-09-14,Rithm Capital,17,23,0,40,0.000000
2025-09-14,Rivian Automotive,13,19,8,40,0.200000
2025-09-14,Robert Half,19,20,1,40,0.025000
2025-09-14,Roblox,12,10,18,40,0.450000
2025-09-14,Rocket Companies,15,22,3,40,0.075000
2025-09-14,Rockwell Automation,16,21,3,40,0.075000
2025-09-14,Roku,21,15,4,40,0.100000
2025-09-14,Rollins inc,15,25,0,40,0.000000
2025-09-14,Roper Technologies,12,28,0,40,0.000000
2025-09-14,Ross Stores,21,16,3,40,0.075000
2025-09-14,Rush Enterprises,21,17,2,40,0.050000
2025-09-14,Ryder System,20,15,5,40,0.125000
2025-09-14,Ryerson Holding,14,17,9,40,0.225000
2025-09-14,S&P Global,10,27,3,40,0.075000
2025-09-14,SBA Communications,21,15,4,40,0.100000
2025-09-14,SS&C Technologies,24,15,1,40,0.025000
2025-09-14,Sabre Corporation,16,18,6,40,0.150000
2025-09-14,Saia inc,20,15,5,40,0.125000
2025-09-14,Salesforce,17,10,13,40,0.325000
2025-09-14,Sallie Mae,14,22,4,40,0.100000
2025-09-14,Sally Beauty,40,0,0,40,0.000000
2025-09-14,Sanmina,15,21,4,40,0.100000
2025-09-14,ScanSource,25,13,2,40,0.050000
2025-09-14,Schneider National,15,21,4,40,0.100000
2025-09-14,Science Applications International,17,19,4,40,0.100000
2025-09-14,Scotts Miracle-Gro,17,18,5,40,0.125000
2025-09-14,Seaboard,16,14,10,40,0.250000
2025-09-14,Sealed Air Corporation,16,22,2,40,0.050000
2025-09-14,Securian Financial,11,26,3,40,0.075000
2025-09-14,Select Medical,17,14,9,40,0.225000
2025-09-14,Selective Insurance Group,13,16,11,40,0.275000
2025-09-14,Sempra,30,10,0,40,0.000000
2025-09-14,Sentry Insurance Group,4,6,0,10,0.000000
2025-09-14,Service Corp International,8,12,5,25,0.200000
2025-09-14,ServiceNow,24,14,2,40,0.050000
2025-09-14,Sherwin-Williams,9,26,5,40,0.125000
2025-09-14,Shift4 Payments,14,21,5,40,0.125000
2025-09-14,Silgan,11,24,5,40,0.125000
2025-09-14,Simon Property Group,17,22,1,40,0.025000
2025-09-14,Sinclair,7,28,5,40,0.125000
2025-09-14,SiteOne Landscape Supply,12,19,9,40,0.225000
2025-09-14,Skechers USA,15,24,1,40,0.025000
2025-09-14,SkyWest,13,17,10,40,0.250000
2025-09-14,Skyline Champion,33,4,3,40,0.075000
2025-09-14,Skyworks Solutions,33,4,3,40,0.075000
2025-09-14,Smurfit Westrock,12,22,6,40,0.150000
2025-09-14,Snap Inc,11,13,16,40,0.400000
2025-09-14,Snap-on,5,31,4,40,0.100000
2025-09-14,Snowflake inc,26,13,1,40,0.025000
2025-09-14,Sonic Automotive,12,25,3,40,0.075000
2025-09-14,Sonoco Products,20,18,2,40,0.050000
2025-09-14,Southern Company,25,14,1,40,0.025000
2025-09-14,Southwest Airlines,7,27,6,40,0.150000
2025-09-14,Southwest Gas,16,21,3,40,0.075000
2025-09-14,Southwestern Energy,36,2,2,40,0.050000
2025-09-14,SpartanNash,14,25,1,40,0.025000
2025-09-14,Spectrum Brands,14,17,9,40,0.225000
2025-09-14,Spire inc,22,17,1,40,0.025000
2025-09-14,Spirit AeroSystems,31,2,7,40,0.175000
2025-09-14,Spirit Airlines,27,6,7,40,0.175000
2025-09-14,Splunk,20,18,2,40,0.050000
2025-09-14,Sprouts Farmers Market,10,27,3,40,0.075000
2025-09-14,Stagwell,11,21,8,40,0.200000
2025-09-14,Stanley Black & Decker,17,17,6,40,0.150000
2025-09-14,Starbucks,14,21,5,40,0.125000
2025-09-14,State Farm Insurance,12,20,8,40,0.200000
2025-09-14,State Street,15,20,5,40,0.125000
2025-09-14,Steel Dynamics,37,3,0,40,0.000000
2025-09-14,Steelcase,10,29,1,40,0.025000
2025-09-14,Stericycle,9,7,24,40,0.600000
2025-09-14,Stifel Financial,21,17,2,40,0.050000
2025-09-14,StoneX,18,20,2,40,0.050000
2025-09-14,Stryker,21,15,4,40,0.100000
2025-09-14,Summit Materials,12,24,4,40,0.100000
2025-09-14,Sun Communities,20,19,1,40,0.025000
2025-09-14,Super Micro Computer,40,0,0,40,0.000000
2025-09-14,Surgery Partners,15,21,4,40,0.100000
2025-09-14,Sylvamo,12,21,7,40,0.175000
2025-09-14,Synchrony Financial,22,15,3,40,0.075000
2025-09-14,Synopsys,9,14,17,40,0.425000
2025-09-14,Synovus Financial,16,21,3,40,0.075000
2025-09-14,Sysco,24,14,2,40,0.050000
2025-09-14,T Rowe Price,18,21,1,40,0.025000
2025-09-14,TD Synnex,25,15,0,40,0.000000
2025-09-14,TEGNA,11,26,3,40,0.075000
2025-09-14,TIAA,13,24,3,40,0.075000
2025-09-14,TJX,25,13,2,40,0.050000
2025-09-14,Take-Two Interactive Software,15,22,3,40,0.075000
2025-09-14,Talen Energy,39,0,1,40,0.025000
2025-09-14,Tapestry,14,26,0,40,0.000000
2025-09-14,Targa Resources,27,12,1,40,0.025000
2025-09-14,Target,8,21,11,40,0.275000
2025-09-14,Taylor Morrison Home,23,15,2,40,0.050000
2025-09-14,Teladoc Health,19,15,6,40,0.150000
2025-09-14,Teledyne Technologies,22,18,0,40,0.000000
2025-09-14,Teleflex,14,21,5,40,0.125000
2025-09-14,Telephone & Data Systems,14,22,3,39,0.076923
2025-09-14,TelevisaUnivision,10,18,12,40,0.300000
2025-09-14,Tempur Sealy International,10,25,5,40,0.125000
2025-09-14,Tenet Healthcare,19,18,3,40,0.075000
2025-09-14,Teradyne,24,15,1,40,0.025000
2025-09-14,Terex,16,21,3,40,0.075000
2025-09-14,Tesla,8,22,10,40,0.250000
2025-09-14,Tetra Tech,19,17,4,40,0.100000
2025-09-14,Texas Instruments,10,24,6,40,0.150000
2025-09-14,Texas Roadhouse,8,21,11,40,0.275000
2025-09-14,Textron,18,19,3,40,0.075000
2025-09-14,The Andersons Inc,16,23,1,40,0.025000
2025-09-14,The Coca-Cola Company,12,24,4,40,0.100000
2025-09-14,The Hartford,14,17,9,40,0.225000
2025-09-14,Thermo Fisher Scientific,19,14,7,40,0.175000
2025-09-14,Thor Industries,17,16,7,40,0.175000
2025-09-14,Thrivent Financial for Lutherans,15,19,6,40,0.150000
2025-09-14,Timken,11,25,4,40,0.100000
2025-09-14,Titan Machinery,8,26,6,40,0.150000
2025-09-14,Toast inc,17,17,6,40,0.150000
2025-09-14,Toll Brothers,14,24,2,40,0.050000
2025-09-14,TopBuild,22,18,0,40,0.000000
2025-09-14,Topgolf Callaway Brands,9,24,7,40,0.175000
2025-09-14,Toro Company,14,23,3,40,0.075000
2025-09-14,Tractor Supply,23,15,2,40,0.050000
2025-09-14,TransDigm,23,14,3,40,0.075000
2025-09-14,TransUnion,19,13,8,40,0.200000
2025-09-14,Travelers Insurance,12,16,12,40,0.300000
2025-09-14,TreeHouse Foods,14,18,8,40,0.200000
2025-09-14,Tri Pointe Homes,16,22,2,40,0.050000
2025-09-14,TriNet Group,21,16,3,40,0.075000
2025-09-14,Trimble,13,22,5,40,0.125000
2025-09-14,Trinity Industries,15,16,9,40,0.225000
2025-09-14,TruStage,27,11,2,40,0.050000
2025-09-14,Truist Financial,19,18,3,40,0.075000
2025-09-14,Tutor Perini Corporation,27,10,3,40,0.075000
2025-09-14,Twilio,22,17,1,40,0.025000
2025-09-14,Tyson Foods,17,15,8,40,0.200000
2025-09-14,U-Haul,8,4,28,40,0.700000
2025-09-14,UFP Industries,16,22,2,40,0.050000
2025-09-14,UGI Utilities Inc,19,14,7,40,0.175000
2025-09-14,UL Solutions,36,1,3,40,0.075000
2025-09-14,UPS,12,19,9,40,0.225000
2025-09-14,US Bancorp,26,14,0,40,0.000000
2025-09-14,US Foods,22,17,1,40,0.025000
2025-09-14,USAA,19,14,7,40,0.175000
2025-09-14,Uber,13,16,11,40,0.275000
2025-09-14,Ulta Beauty,34,4,2,40,0.050000
2025-09-14,Under Armour,8,29,3,40,0.075000
2025-09-14,Union Pacific,12,22,6,40,0.150000
2025-09-14,United Airlines,28,6,6,40,0.150000
2025-09-14,United Natural Foods,35,3,2,40,0.050000
2025-09-14,United Rentals,39,1,0,40,0.000000
2025-09-14,United States Steel,24,11,5,40,0.125000
2025-09-14,UnitedHealth,16,22,2,40,0.050000
2025-09-14,Universal Corporation,16,23,1,40,0.025000
2025-09-14,Universal Health Services,18,16,6,40,0.150000
2025-09-14,Unum Group,10,26,4,40,0.100000
2025-09-14,Upbound Group,28,12,0,40,0.000000
2025-09-14,Urban Outfitters,17,22,1,40,0.025000
2025-09-14,V2X,22,16,2,40,0.050000
2025-09-14,VF Corporation,13,21,6,40,0.150000
2025-09-14,VICI Properties,17,20,3,40,0.075000
2025-09-14,Vail Resorts,15,13,12,40,0.300000
2025-09-14,Valero Energy,34,3,3,40,0.075000
2025-09-14,Valley National Bancorp,10,22,8,40,0.200000
2025-09-14,Valmont Industries,26,12,2,40,0.050000
2025-09-14,Valvoline inc,17,22,1,40,0.025000
2025-09-14,Ventas inc,22,17,1,40,0.025000
2025-09-14,Verisk Analytics,22,14,4,40,0.100000
2025-09-14,Verizon,17,15,8,40,0.200000
2025-09-14,Vertex Pharmaceuticals,17,14,9,40,0.225000
2025-09-14,Vertiv,23,14,3,40,0.075000
2025-09-14,Viasat,20,16,4,40,0.100000
2025-09-14,Viatris,12,20,8,40,0.200000
2025-09-14,Victorias Secret,14,16,10,40,0.250000
2025-09-14,Visa,16,10,14,40,0.350000
2025-09-14,Vishay Intertechnology,12,22,6,40,0.150000
2025-09-14,Vista Outdoor,13,22,5,40,0.125000
2025-09-14,Visteon,22,17,1,40,0.025000
2025-09-14,Vistra,23,15,2,40,0.050000
2025-09-14,Vontier,18,19,3,40,0.075000
2025-09-14,Voya Financial,22,15,3,40,0.075000
2025-09-14,Vulcan Materials,11,21,8,40,0.200000
2025-09-14,WEC Energy,38,0,2,40,0.050000
2025-09-14,WESCO International,21,18,1,40,0.025000
2025-09-14,WEX,19,17,4,40,0.100000
2025-09-14,WR Berkley,17,23,0,40,0.000000
2025-09-14,WW Grainger,22,15,3,40,0.075000
2025-09-14,Wabash National,16,14,10,40,0.250000
2025-09-14,Walgreens,11,21,8,40,0.200000
2025-09-14,Walmart,13,15,12,40,0.300000
2025-09-14,Walt Disney,17,16,7,40,0.175000
2025-09-14,Warner Bros Discovery,7,26,7,40,0.175000
2025-09-14,Warner Music Group,10,29,1,40,0.025000
2025-09-14,Waters Corporation,18,19,3,40,0.075000
2025-09-14,Watsco,15,20,5,40,0.125000
2025-09-14,Wayfair,22,16,2,40,0.050000
2025-09-14,Webster Financial,14,23,3,40,0.075000
2025-09-14,Weis Markets,10,24,6,40,0.150000
2025-09-14,Wells Fargo,38,0,2,40,0.050000
2025-09-14,Welltower,32,8,0,40,0.000000
2025-09-14,Werner Enterprises,16,15,9,40,0.225000
2025-09-14,West Pharmaceutical Services,16,21,3,40,0.075000
2025-09-14,Western & Southern Financial,14,22,4,40,0.100000
2025-09-14,Western Alliance Bancorp,14,15,11,40,0.275000
2025-09-14,Western Digital,15,20,5,40,0.125000
2025-09-14,Western Midstream Partners,21,17,2,40,0.050000
2025-09-14,Western Union,15,24,1,40,0.025000
2025-09-14,Westinghouse Air Brake Technologies,17,19,4,40,0.100000
2025-09-14,Westlake Corporation,7,24,9,40,0.225000
2025-09-14,Weyerhaeuser,15,22,3,40,0.075000
2025-09-14,Whirlpool,15,15,10,40,0.250000
2025-09-14,Williams,12,18,10,40,0.250000
2025-09-14,Williams-Sonoma,16,18,6,40,0.150000
2025-09-14,Winnebago Industries,12,23,5,40,0.125000
2025-09-14,Wintrust Financial,20,17,3,40,0.075000
2025-09-14,Woodward inc,21,18,1,40,0.025000
2025-09-14,Workday,14,19,7,40,0.175000
2025-09-14,World Kinect,18,20,2,40,0.050000
2025-09-14,Worthington Enterprises,15,24,1,40,0.025000
2025-09-14,Wynn Resorts,16,14,10,40,0.250000
2025-09-14,XPO,16,20,4,40,0.100000
2025-09-14,Xcel Energy,35,2,3,40,0.075000
2025-09-14,Xerox,14,22,4,40,0.100000
2025-09-14,Xylem Inc,24,15,1,40,0.025000
2025-09-14,Yum Brands,12,27,1,40,0.025000
2025-09-14,Yum China,20,16,4,40,0.100000
2025-09-14,Zebra Technologies,19,18,3,40,0.075000
2025-09-14,Zimmer Biomet,14,23,3,40,0.075000
2025-09-14,Zions Bancorp,17,19,4,40,0.100000
2025-09-14,Zoetis,22,16,2,40,0.050000
2025-09-14,Zoom Video Communications,16,19,5,40,0.125000
2025-09-14,eXp World,19,17,4,40,0.100000
2025-09-14,iHeartMedia,13,24,3,40,0.075000
2025-09-15,3M,43,52,5,100,0.050000
2025-09-15,A O Smith,35,62,3,100,0.030000
2025-09-15,A-Mark Precious Metals,86,14,0,100,0.000000
2025-09-15,ABM Industries,30,51,19,100,0.190000
2025-09-15,ADT,44,37,19,100,0.190000
2025-09-15,AECOM,48,43,9,100,0.090000
2025-09-15,AES,44,42,14,100,0.140000
2025-09-15,AGCO,43,47,10,100,0.100000
2025-09-15,AGNC Investment,35,40,25,100,0.250000
2025-09-15,AIG,28,54,18,100,0.180000
2025-09-15,AMC Entertainment,84,9,7,100,0.070000
2025-09-15,AMC Networks,40,43,17,100,0.170000
2025-09-15,AMN Healthcare Services,24,58,18,100,0.180000
2025-09-15,APA,46,42,12,100,0.120000
2025-09-15,APi Group,41,50,9,100,0.090000
2025-09-15,ARKO,24,65,11,100,0.110000
2025-09-15,ASGN,30,52,18,100,0.180000
2025-09-15,AT&T,39,50,11,100,0.110000
2025-09-15,ATI Inc,55,40,5,100,0.050000
2025-09-15,AbbVie,43,43,14,100,0.140000
2025-09-15,Abbott Laboratories,55,35,10,100,0.100000
2025-09-15,Abercrombie & Fitch,33,58,9,100,0.090000
2025-09-15,Academy Sports and Outdoors,31,55,14,100,0.140000
2025-09-15,Acadia Healthcare,26,47,27,100,0.270000
2025-09-15,Ace Hardware,41,47,12,100,0.120000
2025-09-15,Acuity Inc,50,41,6,97,0.061856
2025-09-15,Adams Resources & Energy,18,6,1,25,0.040000
2025-09-15,AdaptHealth,41,45,14,100,0.140000
2025-09-15,Adobe,42,46,12,100,0.120000
2025-09-15,Advance Auto Parts,22,53,25,100,0.250000
2025-09-15,Advanced Drainage Systems,81,13,6,100,0.060000
2025-09-15,Advanced Micro Devices,87,5,8,100,0.080000
2025-09-15,Advantage Solutions,88,6,6,100,0.060000
2025-09-15,Aflac,39,31,30,100,0.300000
2025-09-15,Agilent Technologies,59,37,4,100,0.040000
2025-09-15,Agilon Health,34,47,19,100,0.190000
2025-09-15,Air Lease,29,63,8,100,0.080000
2025-09-15,Air Products & Chemicals,34,54,12,100,0.120000
2025-09-15,Airbnb,43,47,10,100,0.100000
2025-09-15,Akamai Technologies,39,50,11,100,0.110000
2025-09-15,Alaska Air,38,49,13,100,0.130000
2025-09-15,Albemarle Corporation,40,52,8,100,0.080000
2025-09-15,Albertsons,30,54,16,100,0.160000
2025-09-15,Alcoa Corporation,26,51,23,100,0.230000
2025-09-15,Alexandria Real Estate Equities,39,51,10,100,0.100000
2025-09-15,Alight Solutions,46,46,8,100,0.080000
2025-09-15,Align Technology,33,49,18,100,0.180000
2025-09-15,Allegiant Travel Company,37,57,6,100,0.060000
2025-09-15,Alliance Resource Partners,36,45,19,100,0.190000
2025-09-15,Alliant Energy,84,11,5,100,0.050000
2025-09-15,Allison Transmission,34,52,14,100,0.140000
2025-09-15,Allstate,53,32,15,100,0.150000
2025-09-15,Ally Financial,41,54,5,100,0.050000
2025-09-15,Alpha Metallurgical Resources,40,41,19,100,0.190000
2025-09-15,Alphabet,34,51,7,92,0.076087
2025-09-15,Altice USA,40,47,13,100,0.130000
2025-09-15,Altria,51,39,10,100,0.100000
2025-09-15,Amazon,80,5,15,100,0.150000
2025-09-15,Ameren,40,47,13,100,0.130000
2025-09-15,American Airlines,35,38,27,100,0.270000
2025-09-15,American Axle & Manufacturing,29,61,10,100,0.100000
2025-09-15,American Eagle Outfitters,37,49,14,100,0.140000
2025-09-15,American Electric Power,48,43,9,100,0.090000
2025-09-15,American Express,43,48,9,100,0.090000
2025-09-15,American Family Insurance,53,38,9,100,0.090000
2025-09-15,American Financial Group,36,54,10,100,0.100000
2025-09-15,American Tower,44,43,13,100,0.130000
2025-09-15,American Water Works,50,43,7,100,0.070000
2025-09-15,Americold Realty Trust,73,20,7,100,0.070000
2025-09-15,Ameriprise Financial,56,35,9,100,0.090000
2025-09-15,Ametek,51,43,5,99,0.050505
2025-09-15,Amgen,44,47,9,100,0.090000
2025-09-15,Amica Mutual Insurance,29,55,4,88,0.045455
2025-09-15,Amkor Technology,38,57,5,100,0.050000
2025-09-15,Amphenol,48,49,3,100,0.030000
2025-09-15,Analog Devices,47,47,6,100,0.060000
2025-09-15,Antero Resources,45,47,8,100,0.080000
2025-09-15,Anywhere Real Estate Inc,39,48,13,100,0.130000
2025-09-15,Apollo Global Management,32,57,11,100,0.110000
2025-09-15,AppLovin,31,60,9,100,0.090000
2025-09-15,Apple,42,48,10,100,0.100000
2025-09-15,Applied Industrial Technologies,35,61,4,100,0.040000
2025-09-15,Applied Materials,24,45,31,100,0.310000
2025-09-15,AptarGroup,41,54,5,100,0.050000
2025-09-15,Aramark,50,45,5,100,0.050000
2025-09-15,ArcBest,24,62,14,100,0.140000
2025-09-15,Arch Resources,65,27,8,100,0.080000
2025-09-15,Archer Daniels Midland,38,45,17,100,0.170000
2025-09-15,Ares Management,46,49,5,100,0.050000
2025-09-15,Arista Networks,39,58,3,100,0.030000
2025-09-15,Arrow Electronics,45,45,10,100,0.100000
2025-09-15,Arthur J Gallagher,38,56,6,100,0.060000
2025-09-15,Asbury Automotive Group,31,59,10,100,0.100000
2025-09-15,Assurant,55,35,10,100,0.100000
2025-09-15,Atkore,37,48,15,100,0.150000
2025-09-15,Atlassian,35,43,22,100,0.220000
2025-09-15,Atmos Energy,92,4,4,100,0.040000
2025-09-15,Auto-Owners Insurance,42,48,10,100,0.100000
2025-09-15,AutoNation,38,46,16,100,0.160000
2025-09-15,AutoZone,18,51,31,100,0.310000
2025-09-15,Autodesk,47,49,4,100,0.040000
2025-09-15,Autoliv,49,44,7,100,0.070000
2025-09-15,Automatic Data Processing,50,46,4,100,0.040000
2025-09-15,AvalonBay Communities,40,55,5,100,0.050000
2025-09-15,Avantor,32,50,18,100,0.180000
2025-09-15,Avery Dennison,35,60,5,100,0.050000
2025-09-15,Avient,31,59,10,100,0.100000
2025-09-15,Avis Budget,21,62,17,100,0.170000
2025-09-15,Avnet,35,57,8,100,0.080000
2025-09-15,BJ's Wholesale Club,35,47,18,100,0.180000
2025-09-15,BOK Financial,46,42,12,100,0.120000
2025-09-15,BWX Technologies,57,43,0,100,0.000000
2025-09-15,Baker Hughes,54,42,4,100,0.040000
2025-09-15,Ball Corporation,39,55,6,100,0.060000
2025-09-15,Bank of America,37,55,8,100,0.080000
2025-09-15,Bank of New York Mellon,44,51,5,100,0.050000
2025-09-15,Bath & Body Works,37,44,19,100,0.190000
2025-09-15,Baxter International,28,56,16,100,0.160000
2025-09-15,Becton Dickinson,54,39,7,100,0.070000
2025-09-15,Belden,38,53,9,100,0.090000
2025-09-15,Benchmark Electronics,42,46,12,100,0.120000
2025-09-15,Berkshire Hathaway,32,43,25,100,0.250000
2025-09-15,Berry Global,30,52,18,100,0.180000
2025-09-15,Best Buy,92,1,7,100,0.070000
2025-09-15,Bio-Rad Laboratories,40,51,9,100,0.090000
2025-09-15,Biogen,41,57,2,100,0.020000
2025-09-15,BlackRock,42,53,5,100,0.050000
2025-09-15,Blackstone,42,53,5,100,0.050000
2025-09-15,Bloomin Brands,16,64,20,100,0.200000
2025-09-15,BlueLinx,32,55,13,100,0.130000
2025-09-15,Boeing,32,34,32,98,0.326531
2025-09-15,Boise Cascade,27,41,32,100,0.320000
2025-09-15,Booking Holdings,47,44,9,100,0.090000
2025-09-15,Booz Allen Hamilton,46,37,17,100,0.170000
2025-09-15,BorgWarner,56,37,7,100,0.070000
2025-09-15,Boston Properties,24,65,11,100,0.110000
2025-09-15,Boston Scientific,42,49,9,100,0.090000
2025-09-15,Boyd Gaming,38,58,4,100,0.040000
2025-09-15,Bread Financial,47,48,5,100,0.050000
2025-09-15,BrightSpring Health Services,38,51,11,100,0.110000
2025-09-15,BrightView Holdings,35,58,7,100,0.070000
2025-09-15,Brighthouse Financial,32,54,14,100,0.140000
2025-09-15,Brinker International,45,51,4,100,0.040000
2025-09-15,Brinks Company,10,3,6,19,0.315789
2025-09-15,Bristol-Myers Squibb,36,48,16,100,0.160000
2025-09-15,Broadcom,45,46,9,100,0.090000
2025-09-15,Broadridge Financial Solutions,86,12,2,100,0.020000
2025-09-15,Brookdale Senior Living,31,52,17,100,0.170000
2025-09-15,Brown & Brown,42,47,11,100,0.110000
2025-09-15,Brown-Forman,22,56,22,100,0.220000
2025-09-15,Bruker,28,51,21,100,0.210000
2025-09-15,Brunswick Corporation,50,37,13,100,0.130000
2025-09-15,Builders FirstSource,44,48,8,100,0.080000
2025-09-15,Burlington Stores,35,57,8,100,0.080000
2025-09-15,CACI International,57,35,8,100,0.080000
2025-09-15,CBRE Group,46,52,2,100,0.020000
2025-09-15,CDW,49,47,4,100,0.040000
2025-09-15,CF Industries,56,40,4,100,0.040000
2025-09-15,CH Robinson Worldwide,45,43,12,100,0.120000
2025-09-15,CHS,51,39,10,100,0.100000
2025-09-15,CIncinnati Financial,37,54,9,100,0.090000
2025-09-15,CME Group,33,61,6,100,0.060000
2025-09-15,CMS Energy,90,8,2,100,0.020000
2025-09-15,CNO Financial Group,37,55,8,100,0.080000
2025-09-15,CNX Resources,53,37,10,100,0.100000
2025-09-15,CSX,46,37,17,100,0.170000
2025-09-15,CVS Health,50,35,15,100,0.150000
2025-09-15,Cabot Corporation,42,50,8,100,0.080000
2025-09-15,Cadence,31,51,18,100,0.180000
2025-09-15,Caesars Entertainment,85,12,3,100,0.030000
2025-09-15,Cal-Maine Foods,62,33,5,100,0.050000
2025-09-15,Caleres Inc,34,50,16,100,0.160000
2025-09-15,California Resources,43,49,8,100,0.080000
2025-09-15,Calumet Inc,39,45,14,98,0.142857
2025-09-15,Campbell Soup,39,48,13,100,0.130000
2025-09-15,Camping World,34,45,21,100,0.210000
2025-09-15,Capital One,48,36,16,100,0.160000
2025-09-15,CarMax,27,57,16,100,0.160000
2025-09-15,Cardinal Health,48,38,14,100,0.140000
2025-09-15,Carlisle Companies,38,51,11,100,0.110000
2025-09-15,Carlyle Group,42,49,9,100,0.090000
2025-09-15,Carpenter Technology,46,50,4,100,0.040000
2025-09-15,Carrier Global,38,45,17,100,0.170000
2025-09-15,Carters Inc,11,22,2,35,0.057143
2025-09-15,Carvana,55,40,5,100,0.050000
2025-09-15,Caseys General Stores,32,57,11,100,0.110000
2025-09-15,Catalent,32,58,10,100,0.100000
2025-09-15,Caterpillar,49,43,8,100,0.080000
2025-09-15,Cboe Global Markets,39,59,2,100,0.020000
2025-09-15,Celanese,32,38,30,100,0.300000
2025-09-15,Cencora,52,41,7,100,0.070000
2025-09-15,Centene,38,44,18,100,0.180000
2025-09-15,CenterPoint Energy,77,9,14,100,0.140000
2025-09-15,Central Garden & Pet,22,76,2,100,0.020000
2025-09-15,Century Communities,36,59,5,100,0.050000
2025-09-15,ChampionX,49,49,2,100,0.020000
2025-09-15,Charles River Laboratories International,28,56,16,100,0.160000
2025-09-15,Charles Schwab,41,48,11,100,0.110000
2025-09-15,Chart Industries,42,52,6,100,0.060000
2025-09-15,Charter Communications,29,55,16,100,0.160000
2025-09-15,Cheesecake Factory,30,51,19,100,0.190000
2025-09-15,Chefs Warehouse,44,48,8,100,0.080000
2025-09-15,Chemours,33,46,21,100,0.210000
2025-09-15,Cheniere Energy,91,8,1,100,0.010000
2025-09-15,Chevron,51,35,14,100,0.140000
2025-09-15,Chewy,38,35,27,100,0.270000
2025-09-15,Chipotle Mexican Grill,28,58,14,100,0.140000
2025-09-15,Chord Energy,88,6,6,100,0.060000
2025-09-15,Church & Dwight,39,55,6,100,0.060000
2025-09-15,Ciena,42,53,5,100,0.050000
2025-09-15,Cigna,53,37,10,100,0.100000
2025-09-15,Cinemark,27,56,17,100,0.170000
2025-09-15,Cintas,50,40,10,100,0.100000
2025-09-15,Cisco Systems,50,45,5,100,0.050000
2025-09-15,Citigroup,43,49,8,100,0.080000
2025-09-15,Citizens Financial Group,34,63,3,100,0.030000
2025-09-15,Civitas Resources,36,35,29,100,0.290000
2025-09-15,Clean Harbors,86,5,9,100,0.090000
2025-09-15,Clear Channel Outdoor Hldgs,8,0,2,10,0.200000
2025-09-15,Cleveland-Cliffs,31,45,24,100,0.240000
2025-09-15,Clorox,48,38,14,100,0.140000
2025-09-15,Cognizant Technology Solutions,83,11,6,100,0.060000
2025-09-15,Coherent,36,56,8,100,0.080000
2025-09-15,Coinbase Global,32,55,13,100,0.130000
2025-09-15,Colgate-Palmolive,32,45,23,100,0.230000
2025-09-15,Columbia Banking System,45,51,4,100,0.040000
2025-09-15,Columbia Sportswear,27,50,23,100,0.230000
2025-09-15,Comcast,51,35,14,100,0.140000
2025-09-15,Comerica,44,46,10,100,0.100000
2025-09-15,Comfort Systems USA,99,0,1,100,0.010000
2025-09-15,CommScope,44,53,3,100,0.030000
2025-09-15,Commercial Metals,36,46,18,100,0.180000
2025-09-15,Community Health Systems,27,53,20,100,0.200000
2025-09-15,Compass Group,33,50,17,100,0.170000
2025-09-15,Conagra Brands,34,55,11,100,0.110000
2025-09-15,Concentrix,45,47,8,100,0.080000
2025-09-15,Conduent,33,45,22,100,0.220000
2025-09-15,ConocoPhillips,40,38,22,100,0.220000
2025-09-15,Consol Energy,78,12,10,100,0.100000
2025-09-15,Consolidated Edison,36,52,12,100,0.120000
2025-09-15,Constellation Brands,24,40,36,100,0.360000
2025-09-15,Constellation Energy,86,7,7,100,0.070000
2025-09-15,Continental Resources,46,40,14,100,0.140000
2025-09-15,Cooper Cos,7,29,6,42,0.142857
2025-09-15,Cooper-Standard,35,58,7,100,0.070000
2025-09-15,Copart,41,54,5,100,0.050000
2025-09-15,Core & Main,31,39,30,100,0.300000
2025-09-15,Corebridge Financial,45,47,8,100,0.080000
2025-09-15,Cornerstone Building Brands,34,58,8,100,0.080000
2025-09-15,Corning,43,48,9,100,0.090000
2025-09-15,Corpay,36,64,0,100,0.000000
2025-09-15,Corteva,34,56,10,100,0.100000
2025-09-15,Costco,55,36,9,100,0.090000
2025-09-15,Coterra Energy,91,4,5,100,0.050000
2025-09-15,Coty,29,42,29,100,0.290000
2025-09-15,Country Financial,27,54,19,100,0.190000
2025-09-15,Coupang,42,42,16,100,0.160000
2025-09-15,Cracker Barrel Old Country Store,21,62,17,100,0.170000
2025-09-15,Crocs,42,48,10,100,0.100000
2025-09-15,CrossAmerica Partners,29,60,11,100,0.110000
2025-09-15,CrowdStrike,46,32,22,100,0.220000
2025-09-15,Crown Castle,40,58,2,100,0.020000
2025-09-15,Crown Holdings,45,48,7,100,0.070000
2025-09-15,Cullen Frost Bankers,52,41,7,100,0.070000
2025-09-15,Cummins Inc,57,38,5,100,0.050000
2025-09-15,Curtiss-Wright,51,46,3,100,0.030000
2025-09-15,DR Horton,52,40,8,100,0.080000
2025-09-15,DTE Energy,83,9,8,100,0.080000
2025-09-15,DXC Technology,42,54,4,100,0.040000
2025-09-15,DaVita,41,34,25,100,0.250000
2025-09-15,Dana Incorporated,37,54,9,100,0.090000
2025-09-15,Danaher,50,45,5,100,0.050000
2025-09-15,Darden Restaurants,40,52,8,100,0.080000
2025-09-15,Darling Ingredients,93,4,3,100,0.030000
2025-09-15,Deckers Outdoor,54,40,6,100,0.060000
2025-09-15,Deere,40,47,13,100,0.130000
2025-09-15,Delek US,49,39,12,100,0.120000
2025-09-15,Dell Technologies,42,51,7,100,0.070000
2025-09-15,Delta Air Lines,19,46,35,100,0.350000
2025-09-15,Dentsply Sirona,35,60,5,100,0.050000
2025-09-15,Designer Brands,29,58,13,100,0.130000
2025-09-15,Devon Energy,94,3,3,100,0.030000
2025-09-15,DexCom,38,51,11,100,0.110000
2025-09-15,Diamondback Energy,89,5,6,100,0.060000
2025-09-15,Dicks Sporting Goods,36,59,5,100,0.050000
2025-09-15,Diebold Nixdorf,43,52,5,100,0.050000
2025-09-15,Digital Realty Trust,88,12,0,100,0.000000
2025-09-15,Dillards,31,45,24,100,0.240000
2025-09-15,Discover Financial,41,45,14,100,0.140000
2025-09-15,DocuSign,42,44,14,100,0.140000
2025-09-15,Dollar General,18,56,26,100,0.260000
2025-09-15,Dollar Tree,42,46,12,100,0.120000
2025-09-15,Dominion Energy,73,14,13,100,0.130000
2025-09-15,Dominos Pizza Inc,19,13,6,38,0.157895
2025-09-15,Domtar,31,56,13,100,0.130000
2025-09-15,Donaldson Company,48,46,6,100,0.060000
2025-09-15,DoorDash,52,30,18,100,0.180000
2025-09-15,Dover Corporation,47,51,2,100,0.020000
2025-09-15,DraftKings,64,32,4,100,0.040000
2025-09-15,Dream Finders Homes,87,8,5,100,0.050000
2025-09-15,Dropbox,42,54,4,100,0.040000
2025-09-15,DuPont,40,42,18,100,0.180000
2025-09-15,Duke Energy,94,3,3,100,0.030000
2025-09-15,Dycom Industries,41,54,5,100,0.050000
2025-09-15,EMCOR Group,41,55,4,100,0.040000
2025-09-15,EOG Resources,51,46,3,100,0.030000
2025-09-15,EPAM Systems,48,44,8,100,0.080000
2025-09-15,EQT,45,52,3,100,0.030000
2025-09-15,ESAB,35,53,12,100,0.120000
2025-09-15,East West Bancorp,47,48,5,100,0.050000
2025-09-15,Eastman Chemical,24,44,32,100,0.320000
2025-09-15,Ebay,33,50,17,100,0.170000
2025-09-15,EchoStar,26,58,16,100,0.160000
2025-09-15,Ecolab,44,51,5,100,0.050000
2025-09-15,Edison International,27,51,22,100,0.220000
2025-09-15,Edward Jones,36,47,17,100,0.170000
2025-09-15,Edwards Lifesciences,47,35,18,100,0.180000
2025-09-15,Elanco Animal Health,43,53,4,100,0.040000
2025-09-15,Electronic Arts,28,57,15,100,0.150000
2025-09-15,Elevance Health,51,32,17,100,0.170000
2025-09-15,Eli Lilly,29,43,28,100,0.280000
2025-09-15,Emerson Electric,48,43,9,100,0.090000
2025-09-15,EnLink Midstream,45,47,8,100,0.080000
2025-09-15,Encompass Health,32,60,8,100,0.080000
2025-09-15,Endeavor Group,28,62,10,100,0.100000
2025-09-15,Endeavor Group Holdings,30,60,10,100,0.100000
2025-09-15,EnerSys,36,52,12,100,0.120000
2025-09-15,Energizer Holdings,94,3,3,100,0.030000
2025-09-15,Energy Transfer,80,6,14,100,0.140000
2025-09-15,Ensign Group,51,43,6,100,0.060000
2025-09-15,Entegris,53,39,8,100,0.080000
2025-09-15,Entergy,55,41,4,100,0.040000
2025-09-15,Enterprise Products Partners,50,32,18,100,0.180000
2025-09-15,Envista,36,57,7,100,0.070000
2025-09-15,Equifax,52,31,17,100,0.170000
2025-09-15,Equinix,55,39,6,100,0.060000
2025-09-15,Equitable Holdings,37,48,15,100,0.150000
2025-09-15,Equity Residential,45,47,8,100,0.080000
2025-09-15,Erie Insurance,37,44,19,100,0.190000
2025-09-15,Estée Lauder,45,45,10,100,0.100000
2025-09-15,Etsy,32,30,38,100,0.380000
2025-09-15,Euronet Worldwide,35,56,9,100,0.090000
2025-09-15,Evergy,50,40,10,100,0.100000
2025-09-15,Eversource Energy,83,9,8,100,0.080000
2025-09-15,Exact Sciences,23,54,23,100,0.230000
2025-09-15,Exelon,51,43,6,100,0.060000
2025-09-15,Expand Energy Corporation,98,0,2,100,0.020000
2025-09-15,Expedia,51,41,8,100,0.080000
2025-09-15,Expeditors International of Washington,44,53,3,100,0.030000
2025-09-15,Extra Space Storage,35,57,8,100,0.080000
2025-09-15,Exxon Mobil,42,50,8,100,0.080000
2025-09-15,F5,46,45,9,100,0.090000
2025-09-15,FM Global,38,36,26,100,0.260000
2025-09-15,FMC Corporation,38,44,18,100,0.180000
2025-09-15,FTI Consulting,39,44,17,100,0.170000
2025-09-15,Fannie Mae,24,64,12,100,0.120000
2025-09-15,Farmers Insurance Exchange,25,44,26,95,0.273684
2025-09-15,Fastenal,39,56,5,100,0.050000
2025-09-15,FedEx,44,42,14,100,0.140000
2025-09-15,Federated Mutual Insurance,16,24,3,43,0.069767
2025-09-15,Ferguson Enterprises,32,56,12,100,0.120000
2025-09-15,Fidelity National Financial,45,44,11,100,0.110000
2025-09-15,Fidelity National Information Services,56,36,8,100,0.080000
2025-09-15,Fifth Third Bancorp,47,35,18,100,0.180000
2025-09-15,First American Financial,37,52,11,100,0.110000
2025-09-15,First Citizens BancShares,43,49,8,100,0.080000
2025-09-15,First Horizon,44,53,3,100,0.030000
2025-09-15,First National of Nebraska,20,27,2,49,0.040816
2025-09-15,First Solar,46,44,10,100,0.100000
2025-09-15,FirstCash,40,45,15,100,0.150000
2025-09-15,FirstEnergy,47,35,18,100,0.180000
2025-09-15,Fiserv,43,50,7,100,0.070000
2025-09-15,Five Below,42,50,8,100,0.080000
2025-09-15,Flagstar Financial,41,47,12,100,0.120000
2025-09-15,Floor & Decor,42,51,7,100,0.070000
2025-09-15,Flowers Foods,30,51,19,100,0.190000
2025-09-15,Flowserve,39,54,7,100,0.070000
2025-09-15,Fluor,45,38,17,100,0.170000
2025-09-15,Foot Locker,13,68,19,100,0.190000
2025-09-15,Ford Motor,35,52,5,92,0.054348
2025-09-15,Fortinet,45,27,28,100,0.280000
2025-09-15,Fortive,35,52,13,100,0.130000
2025-09-15,Fortune Brands Innovations,27,64,9,100,0.090000
2025-09-15,Franklin Resources,38,52,10,100,0.100000
2025-09-15,Freddie Mac,30,54,16,100,0.160000
2025-09-15,Freeport-McMoRan,43,40,17,100,0.170000
2025-09-15,Frontier Airlines,33,52,15,100,0.150000
2025-09-15,Frontier Communications,48,43,9,100,0.090000
2025-09-15,G-III Apparel Group,31,55,14,100,0.140000
2025-09-15,GE HealthCare Technologies,45,52,3,100,0.030000
2025-09-15,GE Vernova,42,46,12,100,0.120000
2025-09-15,GMS,30,61,9,100,0.090000
2025-09-15,GXO Logistics,38,50,12,100,0.120000
2025-09-15,GameStop,47,41,12,100,0.120000
2025-09-15,Gannett,42,44,14,100,0.140000
2025-09-15,Garrett Motion Inc,44,49,7,100,0.070000
2025-09-15,Gartner,27,60,13,100,0.130000
2025-09-15,Generac,42,44,14,100,0.140000
2025-09-15,General Dynamics,94,2,4,100,0.040000
2025-09-15,General Mills,38,49,13,100,0.130000
2025-09-15,General Motors,49,41,10,100,0.100000
2025-09-15,Genesis Energy,86,12,2,100,0.020000
2025-09-15,Genuine Parts,48,45,7,100,0.070000
2025-09-15,Genworth Financial,56,37,7,100,0.070000
2025-09-15,Gilead Sciences,42,48,10,100,0.100000
2025-09-15,Global Partners,45,41,14,100,0.140000
2025-09-15,Global Payments,43,49,8,100,0.080000
2025-09-15,Globe Life,46,44,10,100,0.100000
2025-09-15,GoDaddy,43,48,9,100,0.090000
2025-09-15,Goldman Sachs,40,39,21,100,0.210000
2025-09-15,Goodyear Tire & Rubber,28,59,13,100,0.130000
2025-09-15,Graham Holdings Company,33,60,7,100,0.070000
2025-09-15,Granite Construction,47,49,4,100,0.040000
2025-09-15,Graphic Packaging,34,49,17,100,0.170000
2025-09-15,Gray Television,35,51,14,100,0.140000
2025-09-15,Graybar Electric,14,24,6,44,0.136364
2025-09-15,Green Plains Inc,38,40,22,100,0.220000
2025-09-15,Greenbrier,28,49,23,100,0.230000
2025-09-15,Greif,25,70,5,100,0.050000
2025-09-15,Griffon Corporation,45,47,8,100,0.080000
2025-09-15,Grocery Outlet Holding,30,58,12,100,0.120000
2025-09-15,Group 1 Automotive,36,58,6,100,0.060000
2025-09-15,Guardian Life insurance,50,48,2,100,0.020000
2025-09-15,Guess Inc,33,59,8,100,0.080000
2025-09-15,GuideWell Mutual,25,20,1,46,0.021739
2025-09-15,HB Fuller,32,61,7,100,0.070000
2025-09-15,HCA Healthcare,58,35,7,100,0.070000
2025-09-15,HEICO,37,53,10,100,0.100000
2025-09-15,HF SInclair,36,52,12,100,0.120000
2025-09-15,HP,34,55,11,100,0.110000
2025-09-15,Halliburton,31,46,23,100,0.230000
2025-09-15,Hanesbrands,29,64,7,100,0.070000
2025-09-15,Hanover Insurance Group,42,53,5,100,0.050000
2025-09-15,Harley-Davidson,27,61,12,100,0.120000
2025-09-15,Hasbro,37,52,11,100,0.110000
2025-09-15,Hawaiian Airlines Inc,36,62,2,100,0.020000
2025-09-15,Hawaiian Electric Industries,36,52,12,100,0.120000
2025-09-15,Helmerich & Payne,28,56,16,100,0.160000
2025-09-15,Henry Schein,42,51,7,100,0.070000
2025-09-15,Herc Rentals,43,43,14,100,0.140000
2025-09-15,Hershey,37,55,8,100,0.080000
2025-09-15,Hertz,50,28,22,100,0.220000
2025-09-15,Hewlett Packard Enterprise,26,70,4,100,0.040000
2025-09-15,Hillenbrand,29,59,12,100,0.120000
2025-09-15,Hilton Grand Vacations,94,5,1,100,0.010000
2025-09-15,Hilton Worldwide,54,39,7,100,0.070000
2025-09-15,Hologic,43,50,7,100,0.070000
2025-09-15,Home Depot,29,45,26,100,0.260000
2025-09-15,Honeywell,53,42,5,100,0.050000
2025-09-15,Hormel Foods,34,55,11,100,0.110000
2025-09-15,Host Hotels & Resorts,33,63,4,100,0.040000
2025-09-15,Hovnanian Enterprises,38,45,17,100,0.170000
2025-09-15,Howmet Aerospace,39,56,5,100,0.050000
2025-09-15,Hub Group,35,49,16,100,0.160000
2025-09-15,Hubbell,35,50,15,100,0.150000
2025-09-15,Humana,60,28,12,100,0.120000
2025-09-15,Huntington Bancshares,36,57,7,100,0.070000
2025-09-15,Huntington Ingalls Industries,47,39,14,100,0.140000
2025-09-15,Huntsman,18,52,30,100,0.300000
2025-09-15,Hyatt Hotels,40,54,6,100,0.060000
2025-09-15,Hyster-Yale,31,61,8,100,0.080000
2025-09-15,IAC,36,51,13,100,0.130000
2025-09-15,IBM,41,47,12,100,0.120000
2025-09-15,IDEX,50,42,8,100,0.080000
2025-09-15,IDEXX Laboratories,50,43,7,100,0.070000
2025-09-15,IQVIA,49,42,9,100,0.090000
2025-09-15,ITT,34,55,11,100,0.110000
2025-09-15,Icahn Enterprises,29,45,26,100,0.260000
2025-09-15,Illinois Tool Works,48,43,9,100,0.090000
2025-09-15,Illumina Inc,35,57,8,100,0.080000
2025-09-15,Incyte,44,42,14,100,0.140000
2025-09-15,Ingersoll Rand,52,40,8,100,0.080000
2025-09-15,Ingles Markets,28,45,27,100,0.270000
2025-09-15,Ingram Micro,26,32,42,100,0.420000
2025-09-15,Ingredion,49,46,5,100,0.050000
2025-09-15,Insight Enterprises,38,49,13,100,0.130000
2025-09-15,Insperity,51,34,15,100,0.150000
2025-09-15,Instacart,33,55,12,100,0.120000
2025-09-15,Installed Building Products,31,60,9,100,0.090000
2025-09-15,Intel,24,57,19,100,0.190000
2025-09-15,Interactive Brokers,39,49,12,100,0.120000
2025-09-15,Intercontinental Exchange,37,59,4,100,0.040000
2025-09-15,International Flavors & Fragrances,36,53,11,100,0.110000
2025-09-15,International Paper,22,66,12,100,0.120000
2025-09-15,Interpublic Group,47,49,4,100,0.040000
2025-09-15,Intuit,47,45,8,100,0.080000
2025-09-15,Intuitive Surgical,38,44,18,100,0.180000
2025-09-15,Iron Mountain,29,50,21,100,0.210000
2025-09-15,JB Hunt Transport Services,31,57,12,100,0.120000
2025-09-15,JELD-WEN Holding,27,61,12,100,0.120000
2025-09-15,JM Smucker,42,43,15,100,0.150000
2025-09-15,JPMorgan Chase,55,29,16,100,0.160000
2025-09-15,Jabil,36,61,3,100,0.030000
2025-09-15,Jackson Financial,37,55,8,100,0.080000
2025-09-15,Jacobs Solutions,87,4,9,100,0.090000
2025-09-15,Jefferies Financial,24,51,25,100,0.250000
2025-09-15,JetBlue Airways,38,50,12,100,0.120000
2025-09-15,Johnson & Johnson,50,41,9,100,0.090000
2025-09-15,Jones Lang LaSalle,43,55,2,100,0.020000
2025-09-15,Juniper Networks,35,56,9,100,0.090000
2025-09-15,KB Home,46,41,13,100,0.130000
2025-09-15,KBR,64,28,8,100,0.080000
2025-09-15,KKR & Co,54,41,5,100,0.050000
2025-09-15,KLA,54,29,17,100,0.170000
2025-09-15,Kaiser Aluminum,35,53,12,100,0.120000
2025-09-15,Kellanova,49,41,10,100,0.100000
2025-09-15,Kelly Services Inc,41,51,8,100,0.080000
2025-09-15,Kemper Corporation,42,43,15,100,0.150000
2025-09-15,Kenvue,34,49,17,100,0.170000
2025-09-15,Keurig Dr Pepper,25,64,11,100,0.110000
2025-09-15,KeyCorp,45,51,4,100,0.040000
2025-09-15,Keysight Technologies,38,54,8,100,0.080000
2025-09-15,Kimberly-Clark,36,51,13,100,0.130000
2025-09-15,Kinder Morgan,97,0,3,100,0.030000
2025-09-15,Kirby Corporation,26,63,11,100,0.110000
2025-09-15,Knife River Corporation,37,36,10,83,0.120482
2025-09-15,Knight Swift Transportation,35,48,17,100,0.170000
2025-09-15,Kohl's,36,46,18,100,0.180000
2025-09-15,Kontoor Brands,42,52,6,100,0.060000
2025-09-15,Korn Ferry,52,35,13,100,0.130000
2025-09-15,Kraft Heinz,30,52,18,100,0.180000
2025-09-15,Kroger,54,37,9,100,0.090000
2025-09-15,Kyndryl,44,51,5,100,0.050000
2025-09-15,L3Harris Technologies,49,44,7,100,0.070000
2025-09-15,LCI Industries,42,53,5,100,0.050000
2025-09-15,LKQ,34,57,9,100,0.090000
2025-09-15,LPL Financial,67,33,0,100,0.000000
2025-09-15,Labcorp Holdings,48,45,7,100,0.070000
2025-09-15,Lam Research,50,45,5,100,0.050000
2025-09-15,Lamb Weston,38,52,10,100,0.100000
2025-09-15,Land O'Lakes,33,53,14,100,0.140000
2025-09-15,Landstar System,25,44,31,100,0.310000
2025-09-15,Las Vegas Sands,43,50,7,100,0.070000
2025-09-15,Lear Corporation,43,45,12,100,0.120000
2025-09-15,Leggett & Platt,36,55,9,100,0.090000
2025-09-15,Leidos,50,43,7,100,0.070000
2025-09-15,Lennar,27,66,7,100,0.070000
2025-09-15,Lennox International,38,57,5,100,0.050000
2025-09-15,Levi Strauss,32,62,6,100,0.060000
2025-09-15,Liberty Energy,97,2,1,100,0.010000
2025-09-15,Liberty Media,97,2,1,100,0.010000
2025-09-15,Liberty Mutual Insurance,88,2,10,100,0.100000
2025-09-15,Light & Wonder,27,55,18,100,0.180000
2025-09-15,Lincoln Electric,39,56,5,100,0.050000
2025-09-15,Lincoln National,41,45,14,100,0.140000
2025-09-15,Lithia Motors,41,53,6,100,0.060000
2025-09-15,Live Nation Entertainment,68,25,7,100,0.070000
2025-09-15,Lockheed Martin,53,39,8,100,0.080000
2025-09-15,Loews,44,50,6,100,0.060000
2025-09-15,Louisiana-Pacific Corporation,53,36,11,100,0.110000
2025-09-15,Lowe's,49,36,15,100,0.150000
2025-09-15,Lululemon athletica,23,43,34,100,0.340000
2025-09-15,Lumen Technologies,18,64,18,100,0.180000
2025-09-15,Lyft,33,49,18,100,0.180000
2025-09-15,M&T Bank,39,54,7,100,0.070000
2025-09-15,M/I Homes,32,58,10,100,0.100000
2025-09-15,MDU Resources Group,43,49,8,100,0.080000
2025-09-15,MGM Resorts International,48,44,8,100,0.080000
2025-09-15,MKS Instruments,44,48,8,100,0.080000
2025-09-15,MRC Global,38,57,5,100,0.050000
2025-09-15,MSC Industrial Direct,24,63,13,100,0.130000
2025-09-15,MSCI,36,57,7,100,0.070000
2025-09-15,MYR Group,34,58,8,100,0.080000
2025-09-15,Macys,39,49,12,100,0.120000
2025-09-15,ManpowerGroup,39,43,18,100,0.180000
2025-09-15,Marathon Oil,35,48,17,100,0.170000
2025-09-15,Marathon Petroleum,40,55,5,100,0.050000
2025-09-15,Markel Group,43,45,12,100,0.120000
2025-09-15,Marriott International,43,50,7,100,0.070000
2025-09-15,Marriott Vacations Worldwide,39,51,10,100,0.100000
2025-09-15,Marsh & McLennan,31,60,9,100,0.090000
2025-09-15,Martin Marietta Materials,37,44,19,100,0.190000
2025-09-15,Marvell Technology,43,47,10,100,0.100000
2025-09-15,MasTec,48,47,5,100,0.050000
2025-09-15,Masco,45,46,9,100,0.090000
2025-09-15,Mass Mutual,29,59,7,95,0.073684
2025-09-15,MasterBrand,40,52,8,100,0.080000
2025-09-15,Mastercard,43,49,8,100,0.080000
2025-09-15,Matador Resources,33,50,17,100,0.170000
2025-09-15,Match Group,29,42,29,100,0.290000
2025-09-15,Mativ,34,55,11,100,0.110000
2025-09-15,Matson Inc,45,42,13,100,0.130000
2025-09-15,Mattel,34,52,14,100,0.140000
2025-09-15,Maximus,34,57,9,100,0.090000
2025-09-15,McCormick & Company,40,45,15,100,0.150000
2025-09-15,McDonalds,44,42,14,100,0.140000
2025-09-15,McKesson,46,49,5,100,0.050000
2025-09-15,Medical Mutual of Ohio,29,58,13,100,0.130000
2025-09-15,Merck,36,42,22,100,0.220000
2025-09-15,Mercury General,33,48,19,100,0.190000
2025-09-15,Meritage Homes,30,53,17,100,0.170000
2025-09-15,MetLife,33,58,9,100,0.090000
2025-09-15,Meta Platforms,57,39,4,100,0.040000
2025-09-15,Mettler-Toledo International,45,52,3,100,0.030000
2025-09-15,Microchip Technology,42,51,7,100,0.070000
2025-09-15,Micron Technology,49,43,8,100,0.080000
2025-09-15,Microsoft,34,52,14,100,0.140000
2025-09-15,Middleby,40,52,8,100,0.080000
2025-09-15,MillerKnoll,40,49,11,100,0.110000
2025-09-15,Moderna,32,44,24,100,0.240000
2025-09-15,ModivCare,31,47,22,100,0.220000
2025-09-15,Mohawk Industries,42,47,11,100,0.110000
2025-09-15,Molina Healthcare,44,35,21,100,0.210000
2025-09-15,Molson Coors Beverage,39,42,19,100,0.190000
2025-09-15,Mondelez,33,48,19,100,0.190000
2025-09-15,Monster Beverage,52,38,10,100,0.100000
2025-09-15,Moodys Corporation,4,11,2,17,0.117647
2025-09-15,Moog Inc,45,46,9,100,0.090000
2025-09-15,Morgan Stanley,33,51,16,100,0.160000
2025-09-15,Motorola Solutions,96,1,3,100,0.030000
2025-09-15,Mueller Industries,58,37,5,100,0.050000
2025-09-15,Murphy Oil,36,49,15,100,0.150000
2025-09-15,Murphy USA,37,53,10,100,0.100000
2025-09-15,Mutual of Omaha,46,48,6,100,0.060000
2025-09-15,NCR Atleos,47,51,2,100,0.020000
2025-09-15,NCR Voyix,35,55,10,100,0.100000
2025-09-15,NGL Energy Partners,90,2,8,100,0.080000
2025-09-15,NLV Financial,4,4,2,10,0.200000
2025-09-15,NOV,26,65,9,100,0.090000
2025-09-15,NRG Energy,87,7,6,100,0.060000
2025-09-15,NVR Inc,34,51,15,100,0.150000
2025-09-15,Nasdaq Inc,55,41,4,100,0.040000
2025-09-15,Nationwide Insurance,27,53,20,100,0.200000
2025-09-15,Navient,42,41,17,100,0.170000
2025-09-15,NetApp,44,47,9,100,0.090000
2025-09-15,Netflix,37,35,28,100,0.280000
2025-09-15,NeueHealth,53,37,6,96,0.062500
2025-09-15,New York Life Insurance,40,51,9,100,0.090000
2025-09-15,NewMarket Corporation,31,39,6,76,0.078947
2025-09-15,Newell Brands,29,57,14,100,0.140000
2025-09-15,Newmont,29,59,12,100,0.120000
2025-09-15,News Corp,34,46,20,100,0.200000
2025-09-15,Nexstar Media Group,50,46,4,100,0.040000
2025-09-15,NextEra Energy,94,4,2,100,0.020000
2025-09-15,NiSource,42,43,15,100,0.150000
2025-09-15,Nike,42,43,15,100,0.150000
2025-09-15,Nordson,50,44,6,100,0.060000
2025-09-15,Nordstrom,37,49,14,100,0.140000
2025-09-15,Norfolk Southern,37,55,8,100,0.080000
2025-09-15,Northern Trust,95,3,2,100,0.020000
2025-09-15,Northrop Grumman,32,56,4,92,0.043478
2025-09-15,Northwestern Mutual,42,40,18,100,0.180000
2025-09-15,Nucor,34,52,14,100,0.140000
2025-09-15,Nvidia,21,32,47,100,0.470000
2025-09-15,O'Reilly Automotive,33,46,21,100,0.210000
2025-09-15,O-I Glass,41,46,13,100,0.130000
2025-09-15,ODP Business Solutions,25,32,2,59,0.033898
2025-09-15,OGE Energy,95,2,3,100,0.030000
2025-09-15,ON Semiconductor,26,55,19,100,0.190000
2025-09-15,Occidental Petroleum,31,57,12,100,0.120000
2025-09-15,Old Dominion Freight Line,45,42,13,100,0.130000
2025-09-15,Old National Bancorp,42,58,0,100,0.000000
2025-09-15,Old Republic International,54,42,4,100,0.040000
2025-09-15,Olin,29,48,23,100,0.230000
2025-09-15,Omnicom Group,53,38,9,100,0.090000
2025-09-15,OneMain,52,45,3,100,0.030000
2025-09-15,Oneok,62,34,4,100,0.040000
2025-09-15,Opendoor Technologies,25,51,24,100,0.240000
2025-09-15,Option Care Health,97,3,0,100,0.000000
2025-09-15,Oracle,41,45,13,99,0.131313
2025-09-15,Organon,35,47,18,100,0.180000
2025-09-15,Oscar Health,34,48,18,100,0.180000
2025-09-15,Oshkosh Corporation,44,48,8,100,0.080000
2025-09-15,Otis Worldwide,41,43,16,100,0.160000
2025-09-15,Ovintiv,57,34,9,100,0.090000
2025-09-15,Owens & Minor,32,47,21,100,0.210000
2025-09-15,Owens Corning,39,56,5,100,0.050000
2025-09-15,PACS Group,36,32,32,100,0.320000
2025-09-15,PBF Energy,81,4,15,100,0.150000
2025-09-15,PC Connection Inc,37,36,5,78,0.064103
2025-09-15,PENN Entertainment,90,8,2,100,0.020000
2025-09-15,PG&E,53,29,18,100,0.180000
2025-09-15,PNC Financial Services,41,53,6,100,0.060000
2025-09-15,PPG Industries,40,49,11,100,0.110000
2025-09-15,PPL Corporation,48,44,8,100,0.080000
2025-09-15,PVH,31,43,26,100,0.260000
2025-09-15,Paccar,45,38,17,100,0.170000
2025-09-15,Pacific Life,35,59,6,100,0.060000
2025-09-15,Packaging Corp of America,20,61,19,100,0.190000
2025-09-15,Palo Alto Networks,38,44,18,100,0.180000
2025-09-15,Par Pacific,41,50,9,100,0.090000
2025-09-15,Paramount Global,22,59,19,100,0.190000
2025-09-15,Park Hotels & Resorts,30,56,14,100,0.140000
2025-09-15,Parker-Hannifin,45,49,6,100,0.060000
2025-09-15,Parsons Corporation,53,34,13,100,0.130000
2025-09-15,Patrick Industries,35,58,7,100,0.070000
2025-09-15,Patterson Companies Inc,19,56,3,78,0.038462
2025-09-15,Patterson-UTI Energy,64,26,10,100,0.100000
2025-09-15,PayPal,35,44,13,92,0.141304
2025-09-15,Paychex,49,44,7,100,0.070000
2025-09-15,Peabody Energy,77,14,9,100,0.090000
2025-09-15,Peloton Interactive,47,40,13,100,0.130000
2025-09-15,Penn Mutual Life Insurance,38,58,4,100,0.040000
2025-09-15,PennyMac Financial Services,46,47,7,100,0.070000
2025-09-15,Penske Automotive,42,53,5,100,0.050000
2025-09-15,PepsiCo,54,38,8,100,0.080000
2025-09-15,Performance Food,35,55,10,100,0.100000
2025-09-15,Permian Resources,51,42,7,100,0.070000
2025-09-15,Petco Health and Wellness,84,12,4,100,0.040000
2025-09-15,Peter Kiewit Sons',7,23,15,45,0.333333
2025-09-15,Pfizer,47,31,22,100,0.220000
2025-09-15,Philip Morris International,41,49,10,100,0.100000
2025-09-15,Phillips 66,42,51,7,100,0.070000
2025-09-15,Pinnacle West Capital,37,44,19,100,0.190000
2025-09-15,Pinterest,46,49,5,100,0.050000
2025-09-15,Pioneer Natural Resources,50,31,19,100,0.190000
2025-09-15,Pitney Bowes,41,54,5,100,0.050000
2025-09-15,Plains GP,45,36,19,100,0.190000
2025-09-15,Playtika Holding,37,45,18,100,0.180000
2025-09-15,Plexus Corp,39,53,8,100,0.080000
2025-09-15,Polaris Inc,46,47,7,100,0.070000
2025-09-15,Pool Corporation,43,45,12,100,0.120000
2025-09-15,Popular Inc,97,2,1,100,0.010000
2025-09-15,Portland General Electric,40,48,12,100,0.120000
2025-09-15,Post Holdings,28,63,9,100,0.090000
2025-09-15,PrIncipal Financial,43,47,10,100,0.100000
2025-09-15,PriceSmart,47,43,10,100,0.100000
2025-09-15,Primerica,46,47,7,100,0.070000
2025-09-15,Primoris Services,46,52,2,100,0.020000
2025-09-15,ProFrac Holding,33,50,17,100,0.170000
2025-09-15,Procter & Gamble,39,37,24,100,0.240000
2025-09-15,Progressive Insurance,34,53,13,100,0.130000
2025-09-15,Prologis,42,52,6,100,0.060000
2025-09-15,Prudential Financial,46,44,10,100,0.100000
2025-09-15,Public Service Enterprise Group,48,44,8,100,0.080000
2025-09-15,Public Storage,42,40,18,100,0.180000
2025-09-15,Publix Super Markets,40,52,8,100,0.080000
2025-09-15,Puget Sound Energy,61,25,14,100,0.140000
2025-09-15,PulteGroup,53,38,9,100,0.090000
2025-09-15,Pure Storage,35,52,13,100,0.130000
2025-09-15,QVC Group,22,66,12,100,0.120000
2025-09-15,QXO Building Products,1,6,3,10,0.300000
2025-09-15,Qorvo,46,45,9,100,0.090000
2025-09-15,Qualcomm,47,48,5,100,0.050000
2025-09-15,Quanta Services,45,52,3,100,0.030000
2025-09-15,Quest Diagnostics,33,57,10,100,0.100000
2025-09-15,QuidelOrtho,36,54,10,100,0.100000
2025-09-15,REV Group,48,44,8,100,0.080000
2025-09-15,RPM International,39,55,6,100,0.060000
2025-09-15,RTX,43,47,10,100,0.100000
2025-09-15,RXO Inc,40,41,19,100,0.190000
2025-09-15,Rackspace Technology,32,54,14,100,0.140000
2025-09-15,Radius Recycling,23,50,27,100,0.270000
2025-09-15,Ralph Lauren,36,63,1,100,0.010000
2025-09-15,Range Resources,51,44,5,100,0.050000
2025-09-15,Raymond James Financial,44,51,5,100,0.050000
2025-09-15,Realty Income,52,39,9,100,0.090000
2025-09-15,Regal Rexnord,38,56,6,100,0.060000
2025-09-15,Regeneron Pharmaceuticals,44,47,9,100,0.090000
2025-09-15,Regions Financial,54,41,5,100,0.050000
2025-09-15,Reinsurance Group of America,41,52,7,100,0.070000
2025-09-15,Reliance Inc,51,41,8,100,0.080000
2025-09-15,Republic Services,37,26,37,100,0.370000
2025-09-15,ResMed,40,57,3,100,0.030000
2025-09-15,Resideo Technologies,48,44,8,100,0.080000
2025-09-15,Restoration Hardware,34,48,18,100,0.180000
2025-09-15,Revvity,40,46,14,100,0.140000
2025-09-15,Rithm Capital,41,50,9,100,0.090000
2025-09-15,Rivian Automotive,28,57,15,100,0.150000
2025-09-15,Robert Half,40,40,20,100,0.200000
2025-09-15,Roblox,34,27,39,100,0.390000
2025-09-15,Rocket Companies,35,57,8,100,0.080000
2025-09-15,Rockwell Automation,40,54,6,100,0.060000
2025-09-15,Roku,45,42,13,100,0.130000
2025-09-15,Rollins Inc,35,62,3,100,0.030000
2025-09-15,Roper Technologies,38,61,1,100,0.010000
2025-09-15,Ross Stores,43,46,11,100,0.110000
2025-09-15,Rush Enterprises,42,48,10,100,0.100000
2025-09-15,Ryder System,49,47,4,100,0.040000
2025-09-15,Ryerson Holding,35,55,10,100,0.100000
2025-09-15,S&P Global,31,61,8,100,0.080000
2025-09-15,SBA Communications,44,49,7,100,0.070000
2025-09-15,SS&C Technologies,47,46,7,100,0.070000
2025-09-15,Sabre Corporation,40,43,17,100,0.170000
2025-09-15,Saia Inc,38,47,15,100,0.150000
2025-09-15,Salesforce,46,29,25,100,0.250000
2025-09-15,Sallie Mae,41,48,11,100,0.110000
2025-09-15,Sally Beauty,95,5,0,100,0.000000
2025-09-15,Sanmina,37,59,4,100,0.040000
2025-09-15,ScanSource,47,45,8,100,0.080000
2025-09-15,Schneider National,40,48,12,100,0.120000
2025-09-15,Science Applications International,37,43,20,100,0.200000
2025-09-15,Scotts Miracle-Gro,39,43,18,100,0.180000
2025-09-15,Seaboard,28,50,22,100,0.220000
2025-09-15,Sealed Air Corporation,40,49,11,100,0.110000
2025-09-15,Securian Financial,36,57,7,100,0.070000
2025-09-15,Select Medical Holdings,34,49,17,100,0.170000
2025-09-15,Selective Insurance Group,42,39,19,100,0.190000
2025-09-15,Sempra,65,33,2,100,0.020000
2025-09-15,Sentry Insurance Group,4,6,0,10,0.000000
2025-09-15,Service Corp International,7,12,5,24,0.208333
2025-09-15,ServiceNow,38,49,13,100,0.130000
2025-09-15,Sherwin-Williams,28,54,18,100,0.180000
2025-09-15,Shift4 Payments,36,48,16,100,0.160000
2025-09-15,Silgan,25,49,26,100,0.260000
2025-09-15,Simon Property Group,41,48,11,100,0.110000
2025-09-15,Sinclair,28,58,14,100,0.140000
2025-09-15,Sirius XM,27,68,5,100,0.050000
2025-09-15,SiteOne Landscape Supply,32,53,15,100,0.150000
2025-09-15,Skechers USA,30,62,8,100,0.080000
2025-09-15,SkyWest,30,40,30,100,0.300000
2025-09-15,Skyline Champion,38,9,3,50,0.060000
2025-09-15,Skyworks Solutions,71,17,12,100,0.120000
2025-09-15,Smurfit Westrock,26,60,14,100,0.140000
2025-09-15,Snap Inc,37,43,20,100,0.200000
2025-09-15,Snap-on,18,64,18,100,0.180000
2025-09-15,Snowflake Inc,59,41,0,100,0.000000
2025-09-15,Solventum,31,58,11,100,0.110000
2025-09-15,Sonic Automotive,27,65,8,100,0.080000
2025-09-15,Sonoco Products,37,50,13,100,0.130000
2025-09-15,Southern Company,54,42,4,100,0.040000
2025-09-15,Southwest Airlines,27,58,15,100,0.150000
2025-09-15,Southwest Gas Holdings,43,50,7,100,0.070000
2025-09-15,SpartanNash,31,65,4,100,0.040000
2025-09-15,Spectrum Brands,36,45,19,100,0.190000
2025-09-15,Spire Inc,55,40,5,100,0.050000
2025-09-15,Spirit AeroSystems,80,7,13,100,0.130000
2025-09-15,Spirit Airlines,70,6,24,100,0.240000
2025-09-15,Splunk,37,44,19,100,0.190000
2025-09-15,Sprouts Farmers Market,32,63,5,100,0.050000
2025-09-15,Stagwell,33,56,11,100,0.110000
2025-09-15,Stanley Black & Decker,30,48,22,100,0.220000
2025-09-15,Starbucks,41,46,13,100,0.130000
2025-09-15,State Farm Insurance,28,44,28,100,0.280000
2025-09-15,State Street,38,42,20,100,0.200000
2025-09-15,Steel Dynamics,91,5,4,100,0.040000
2025-09-15,Steelcase,40,59,1,100,0.010000
2025-09-15,Stericycle,22,20,58,100,0.580000
2025-09-15,Stifel Financial,53,40,7,100,0.070000
2025-09-15,StoneX Group,46,51,3,100,0.030000
2025-09-15,Stryker,42,46,12,100,0.120000
2025-09-15,Summit Materials,25,63,12,100,0.120000
2025-09-15,Sun Communities,41,44,15,100,0.150000
2025-09-15,Super Micro Computer,92,6,2,100,0.020000
2025-09-15,Surgery Partners,34,52,14,100,0.140000
2025-09-15,Sylvamo,25,52,23,100,0.230000
2025-09-15,Synchrony Financial,61,33,6,100,0.060000
2025-09-15,Synopsys,28,41,31,100,0.310000
2025-09-15,Synovus Financial,43,50,7,100,0.070000
2025-09-15,Sysco,42,41,17,100,0.170000
2025-09-15,T Rowe Price,58,40,2,100,0.020000
2025-09-15,TD Synnex,59,40,1,100,0.010000
2025-09-15,TEGNA,31,63,6,100,0.060000
2025-09-15,THOR Industries,29,55,16,100,0.160000
2025-09-15,TIAA,31,54,15,100,0.150000
2025-09-15,TJX,49,44,7,100,0.070000
2025-09-15,Take-Two Interactive Software,40,48,12,100,0.120000
2025-09-15,Talen Energy,96,3,1,100,0.010000
2025-09-15,Tapestry,42,49,9,100,0.090000
2025-09-15,Targa Resources,53,38,9,100,0.090000
2025-09-15,Target Corporation,32,54,14,100,0.140000
2025-09-15,Taylor Morrison Home,42,51,7,100,0.070000
2025-09-15,Teladoc Health,43,47,10,100,0.100000
2025-09-15,Teledyne Technologies,49,47,4,100,0.040000
2025-09-15,Teleflex,33,57,10,100,0.100000
2025-09-15,Telephone & Data Systems,13,21,3,37,0.081081
2025-09-15,TelevisaUnivision,33,46,21,100,0.210000
2025-09-15,Tempur Sealy International,28,47,22,97,0.226804
2025-09-15,Tenet Healthcare,50,39,11,100,0.110000
2025-09-15,Teradyne,44,48,8,100,0.080000
2025-09-15,Terex,35,53,12,100,0.120000
2025-09-15,Tesla,43,43,14,100,0.140000
2025-09-15,Tetra Tech,55,38,7,100,0.070000
2025-09-15,Texas Instruments,28,60,12,100,0.120000
2025-09-15,Texas Roadhouse,27,58,15,100,0.150000
2025-09-15,Textron,43,48,9,100,0.090000
2025-09-15,The Andersons Inc,24,72,4,100,0.040000
2025-09-15,The Coca-Cola Company,36,58,6,100,0.060000
2025-09-15,The Hartford,35,43,22,100,0.220000
2025-09-15,The Mosaic Company,39,41,20,100,0.200000
2025-09-15,Thermo Fisher Scientific,49,42,9,100,0.090000
2025-09-15,Thrivent Financial for Lutherans,34,46,9,89,0.101124
2025-09-15,Timken,33,53,14,100,0.140000
2025-09-15,Titan Machinery,27,59,14,100,0.140000
2025-09-15,Toast Inc,49,45,6,100,0.060000
2025-09-15,Toll Brothers,31,63,6,100,0.060000
2025-09-15,TopBuild,38,61,1,100,0.010000
2025-09-15,Topgolf Callaway Brands,25,54,21,100,0.210000
2025-09-15,Toro Company,36,56,8,100,0.080000
2025-09-15,Tractor Supply,35,61,4,100,0.040000
2025-09-15,TransDigm,52,38,10,100,0.100000
2025-09-15,TransUnion,55,26,19,100,0.190000
2025-09-15,Travelers Insurance,34,40,26,100,0.260000
2025-09-15,TreeHouse Foods,22,52,26,100,0.260000
2025-09-15,Tri Pointe Homes,34,63,3,100,0.030000
2025-09-15,TriNet Group,37,53,10,100,0.100000
2025-09-15,Trimble Inc,44,47,9,100,0.090000
2025-09-15,Trinity Industries,31,46,23,100,0.230000
2025-09-15,TruStage,57,35,8,100,0.080000
2025-09-15,Truist Financial,33,61,6,100,0.060000
2025-09-15,Tutor Perini Corporation,59,36,5,100,0.050000
2025-09-15,Twilio,46,45,9,100,0.090000
2025-09-15,Tyson Foods,28,50,21,99,0.212121
2025-09-15,U-Haul,11,30,59,100,0.590000
2025-09-15,UFP Industries,33,57,10,100,0.100000
2025-09-15,UGI Utilities Inc,29,30,16,75,0.213333
2025-09-15,UL Solutions,86,7,7,100,0.070000
2025-09-15,UPS,39,45,16,100,0.160000
2025-09-15,US Bancorp,52,43,5,100,0.050000
2025-09-15,US Foods,38,55,7,100,0.070000
2025-09-15,USAA,40,39,21,100,0.210000
2025-09-15,Uber,34,45,20,99,0.202020
2025-09-15,Ulta Beauty,90,7,3,100,0.030000
2025-09-15,Under Armour,28,59,13,100,0.130000
2025-09-15,Union Pacific,42,49,9,100,0.090000
2025-09-15,United Airlines,64,10,26,100,0.260000
2025-09-15,United Natural Foods,82,12,6,100,0.060000
2025-09-15,United Rentals,98,1,1,100,0.010000
2025-09-15,United States Steel,55,36,9,100,0.090000
2025-09-15,UnitedHealth,44,45,11,100,0.110000
2025-09-15,Universal Corporation,38,54,8,100,0.080000
2025-09-15,Universal Health Services,40,44,16,100,0.160000
2025-09-15,Unum Group,43,43,14,100,0.140000
2025-09-15,Upbound Group,54,41,5,100,0.050000
2025-09-15,Urban Outfitters,47,49,4,100,0.040000
2025-09-15,V2X,45,50,5,100,0.050000
2025-09-15,VF Corporation,26,52,22,100,0.220000
2025-09-15,VICI Properties,42,54,4,100,0.040000
2025-09-15,Vail Resorts,30,47,23,100,0.230000
2025-09-15,Valero Energy,83,8,9,100,0.090000
2025-09-15,Valley National Bancorp,28,58,14,100,0.140000
2025-09-15,Valmont Industries,44,49,7,100,0.070000
2025-09-15,Valvoline Inc,34,61,5,100,0.050000
2025-09-15,Ventas Inc,50,48,2,100,0.020000
2025-09-15,Verisk Analytics,47,41,12,100,0.120000
2025-09-15,Verizon,44,38,18,100,0.180000
2025-09-15,Vertex Pharmaceuticals,41,38,21,100,0.210000
2025-09-15,Vertiv,57,40,3,100,0.030000
2025-09-15,Viasat,45,45,10,100,0.100000
2025-09-15,Viatris,35,45,20,100,0.200000
2025-09-15,Victorias Secret,31,46,23,100,0.230000
2025-09-15,Visa Inc,58,35,7,100,0.070000
2025-09-15,Vishay Intertechnology,33,51,16,100,0.160000
2025-09-15,Vista Outdoor,27,54,19,100,0.190000
2025-09-15,Visteon,44,50,6,100,0.060000
2025-09-15,Vistra,60,33,7,100,0.070000
2025-09-15,Vontier,40,50,10,100,0.100000
2025-09-15,Voya Financial,53,41,6,100,0.060000
2025-09-15,Vulcan Materials,35,48,17,100,0.170000
2025-09-15,WEC Energy,93,3,4,100,0.040000
2025-09-15,WESCO International,51,44,5,100,0.050000
2025-09-15,WEX,41,50,9,100,0.090000
2025-09-15,WR Berkley,39,51,10,100,0.100000
2025-09-15,WW Grainger,44,43,13,100,0.130000
2025-09-15,Wabash National,28,43,29,100,0.290000
2025-09-15,Walmart,32,30,38,100,0.380000
2025-09-15,Walt Disney,66,31,3,100,0.030000
2025-09-15,Warner Bros Discovery,17,67,16,100,0.160000
2025-09-15,Warner Music Group,25,65,10,100,0.100000
2025-09-15,Waters Corporation,43,51,6,100,0.060000
2025-09-15,Watsco,28,50,22,100,0.220000
2025-09-15,Wayfair,52,43,5,100,0.050000
2025-09-15,Webster Financial,36,51,13,100,0.130000
2025-09-15,Weis Markets,26,63,11,100,0.110000
2025-09-15,Wells Fargo,87,4,9,100,0.090000
2025-09-15,Welltower,73,27,0,100,0.000000
2025-09-15,Werner Enterprises,40,39,21,100,0.210000
2025-09-15,West Pharmaceutical Services,44,44,12,100,0.120000
2025-09-15,Western & Southern Financial,34,63,3,100,0.030000
2025-09-15,Western Alliance Bancorp,24,39,27,90,0.300000
2025-09-15,Western Digital,40,44,16,100,0.160000
2025-09-15,Western Midstream Partners,50,43,7,100,0.070000
2025-09-15,Western Union,32,59,9,100,0.090000
2025-09-15,Westinghouse Air Brake Technologies,42,45,13,100,0.130000
2025-09-15,Weyerhaeuser,31,55,14,100,0.140000
2025-09-15,Whirlpool,31,48,21,100,0.210000
2025-09-15,Williams Companies,48,45,7,100,0.070000
2025-09-15,Williams-Sonoma,41,50,9,100,0.090000
2025-09-15,Winnebago Industries,22,60,18,100,0.180000
2025-09-15,Wintrust Financial,40,56,4,100,0.040000
2025-09-15,Woodward Inc,43,53,4,100,0.040000
2025-09-15,Workday,32,50,18,100,0.180000
2025-09-15,World Kinect,42,44,14,100,0.140000
2025-09-15,Worthington Enterprises,43,53,4,100,0.040000
2025-09-15,Wynn Resorts,32,45,23,100,0.230000
2025-09-15,XPO,33,54,13,100,0.130000
2025-09-15,Xcel Energy,85,8,7,100,0.070000
2025-09-15,Xerox,38,45,17,100,0.170000
2025-09-15,Xylem Inc,49,46,5,100,0.050000
2025-09-15,Yum Brands,28,61,11,100,0.110000
2025-09-15,Yum China,48,42,10,100,0.100000
2025-09-15,Zebra Technologies,45,46,9,100,0.090000
2025-09-15,Zimmer Biomet,44,50,6,100,0.060000
2025-09-15,Zions Bancorp,45,40,15,100,0.150000
2025-09-15,Zoetis,60,37,3,100,0.030000
2025-09-15,Zoom Video Communications,33,49,18,100,0.180000
2025-09-15,eXp World,35,55,10,100,0.100000
2025-09-15,iHeartMedia,35,57,8,100,0.080000
2025-09-16,3M,45,49,6,100,0.060000
2025-09-16,A O Smith,31,66,3,100,0.030000
2025-09-16,A-Mark Precious Metals,89,11,0,100,0.000000
2025-09-16,ABM Industries,25,56,19,100,0.190000
2025-09-16,ADT,41,38,21,100,0.210000
2025-09-16,AECOM,46,45,9,100,0.090000
2025-09-16,AES,46,40,14,100,0.140000
2025-09-16,AGCO,45,47,8,100,0.080000
2025-09-16,AGNC Investment,36,40,24,100,0.240000
2025-09-16,AIG,26,54,20,100,0.200000
2025-09-16,AMC Entertainment,83,10,7,100,0.070000
2025-09-16,AMC Networks,40,43,17,100,0.170000
2025-09-16,AMN Healthcare Services,26,56,18,100,0.180000
2025-09-16,APA,43,43,14,100,0.140000
2025-09-16,APi Group,40,51,9,100,0.090000
2025-09-16,ARKO,24,64,12,100,0.120000
2025-09-16,ASGN,32,52,16,100,0.160000
2025-09-16,AT&T,42,45,13,100,0.130000
2025-09-16,ATI Inc,52,43,5,100,0.050000
2025-09-16,AbbVie,46,38,16,100,0.160000
2025-09-16,Abbott Laboratories,52,40,8,100,0.080000
2025-09-16,Abercrombie & Fitch,33,58,9,100,0.090000
2025-09-16,Academy Sports and Outdoors,30,56,14,100,0.140000
2025-09-16,Acadia Healthcare,29,47,24,100,0.240000
2025-09-16,Ace Hardware,38,51,11,100,0.110000
2025-09-16,Acuity Inc,52,40,8,100,0.080000
2025-09-16,Adams Resources & Energy,18,7,1,26,0.038462
2025-09-16,AdaptHealth,40,42,18,100,0.180000
2025-09-16,Adobe,50,38,12,100,0.120000
2025-09-16,Advance Auto Parts,22,53,25,100,0.250000
2025-09-16,Advanced Drainage Systems,82,12,6,100,0.060000
2025-09-16,Advanced Micro Devices,92,4,4,100,0.040000
2025-09-16,Advantage Solutions,89,6,5,100,0.050000
2025-09-16,Aflac,39,33,28,100,0.280000
2025-09-16,Agilent Technologies,58,37,5,100,0.050000
2025-09-16,Agilon Health,36,49,15,100,0.150000
2025-09-16,Air Lease,33,60,7,100,0.070000
2025-09-16,Air Products & Chemicals,32,56,12,100,0.120000
2025-09-16,Airbnb,45,49,6,100,0.060000
2025-09-16,Akamai Technologies,48,43,9,100,0.090000
2025-09-16,Alaska Air,37,46,17,100,0.170000
2025-09-16,Albemarle Corporation,37,53,10,100,0.100000
2025-09-16,Albertsons,35,51,14,100,0.140000
2025-09-16,Alcoa Corporation,29,52,19,100,0.190000
2025-09-16,Alexandria Real Estate Equities,38,54,8,100,0.080000
2025-09-16,Alight Solutions,54,38,8,100,0.080000
2025-09-16,Align Technology,29,51,20,100,0.200000
2025-09-16,Allegiant Travel Company,35,58,7,100,0.070000
2025-09-16,Alliance Resource Partners,33,49,18,100,0.180000
2025-09-16,Alliant Energy,82,11,7,100,0.070000
2025-09-16,Allison Transmission,35,51,14,100,0.140000
2025-09-16,Allstate,60,32,8,100,0.080000
2025-09-16,Ally Financial,41,53,6,100,0.060000
2025-09-16,Alpha Metallurgical Resources,39,43,18,100,0.180000
2025-09-16,Alphabet,39,54,7,100,0.070000
2025-09-16,Altice USA,33,48,19,100,0.190000
2025-09-16,Altria,52,37,11,100,0.110000
2025-09-16,Amazon,79,9,12,100,0.120000
2025-09-16,Ameren,42,46,12,100,0.120000
2025-09-16,American Airlines,32,37,31,100,0.310000
2025-09-16,American Axle & Manufacturing,26,64,10,100,0.100000
2025-09-16,American Eagle Outfitters,38,49,13,100,0.130000
2025-09-16,American Electric Power,49,44,7,100,0.070000
2025-09-16,American Express,35,57,8,100,0.080000
2025-09-16,American Family Insurance,54,36,10,100,0.100000
2025-09-16,American Financial Group,41,49,10,100,0.100000
2025-09-16,American Tower,47,45,8,100,0.080000
2025-09-16,American Water Works,46,44,10,100,0.100000
2025-09-16,Americold Realty Trust,74,20,6,100,0.060000
2025-09-16,Ameriprise Financial,56,36,8,100,0.080000
2025-09-16,Ametek,56,39,5,100,0.050000
2025-09-16,Amgen,40,50,10,100,0.100000
2025-09-16,Amica Mutual Insurance,29,56,4,89,0.044944
2025-09-16,Amkor Technology,36,58,6,100,0.060000
2025-09-16,Amphenol,47,47,6,100,0.060000
2025-09-16,Analog Devices,43,52,5,100,0.050000
2025-09-16,Antero Resources,44,48,8,100,0.080000
2025-09-16,Anywhere Real Estate Inc,42,44,14,100,0.140000
2025-09-16,Apollo Global Management,37,53,10,100,0.100000
2025-09-16,AppLovin,32,58,10,100,0.100000
2025-09-16,Apple,41,46,12,99,0.121212
2025-09-16,Applied Industrial Technologies,36,60,4,100,0.040000
2025-09-16,Applied Materials,21,46,33,100,0.330000
2025-09-16,AptarGroup,43,53,4,100,0.040000
2025-09-16,Aramark,51,44,5,100,0.050000
2025-09-16,ArcBest,30,59,11,100,0.110000
2025-09-16,Arch Resources,64,27,9,100,0.090000
2025-09-16,Archer Daniels Midland,41,44,15,100,0.150000
2025-09-16,Ares Management,46,50,4,100,0.040000
2025-09-16,Arista Networks,45,49,6,100,0.060000
2025-09-16,Arrow Electronics,48,42,10,100,0.100000
2025-09-16,Arthur J Gallagher,36,59,5,100,0.050000
2025-09-16,Asbury Automotive Group,32,60,8,100,0.080000
2025-09-16,Assurant,53,38,9,100,0.090000
2025-09-16,Atkore,38,49,13,100,0.130000
2025-09-16,Atlassian,39,43,18,100,0.180000
2025-09-16,Atmos Energy,96,3,1,100,0.010000
2025-09-16,Auto-Owners Insurance,40,50,10,100,0.100000
2025-09-16,AutoNation,41,42,17,100,0.170000
2025-09-16,AutoZone,16,54,30,100,0.300000
2025-09-16,Autodesk,49,50,1,100,0.010000
2025-09-16,Autoliv,46,44,10,100,0.100000
2025-09-16,Automatic Data Processing,53,42,5,100,0.050000
2025-09-16,AvalonBay Communities,37,58,5,100,0.050000
2025-09-16,Avantor,34,46,20,100,0.200000
2025-09-16,Avery Dennison,38,58,4,100,0.040000
2025-09-16,Avient,33,57,10,100,0.100000
2025-09-16,Avis Budget,28,57,15,100,0.150000
2025-09-16,Avnet,35,58,7,100,0.070000
2025-09-16,BJ's Wholesale Club,38,44,18,100,0.180000
2025-09-16,BOK Financial,43,45,12,100,0.120000
2025-09-16,BWX Technologies,66,34,0,100,0.000000
2025-09-16,Baker Hughes,56,38,6,100,0.060000
2025-09-16,Ball Corporation,39,56,5,100,0.050000
2025-09-16,Bank of America,45,47,8,100,0.080000
2025-09-16,Bank of New York Mellon,59,38,3,100,0.030000
2025-09-16,Bath & Body Works,35,48,17,100,0.170000
2025-09-16,Baxter International,26,59,15,100,0.150000
2025-09-16,Becton Dickinson,56,36,8,100,0.080000
2025-09-16,Belden,37,52,11,100,0.110000
2025-09-16,Benchmark Electronics,43,45,12,100,0.120000
2025-09-16,Berkshire Hathaway,36,41,23,100,0.230000
2025-09-16,Berry Global,29,54,17,100,0.170000
2025-09-16,Best Buy,90,1,9,100,0.090000
2025-09-16,Bio-Rad Laboratories,39,50,11,100,0.110000
2025-09-16,Biogen,42,56,2,100,0.020000
2025-09-16,BlackRock,47,45,8,100,0.080000
2025-09-16,Blackstone,43,50,7,100,0.070000
2025-09-16,Bloomin Brands,18,63,19,100,0.190000
2025-09-16,BlueLinx,32,57,11,100,0.110000
2025-09-16,Boeing,42,38,20,100,0.200000
2025-09-16,Boise Cascade,22,47,31,100,0.310000
2025-09-16,Booking Holdings,43,46,11,100,0.110000
2025-09-16,Booz Allen Hamilton,46,40,14,100,0.140000
2025-09-16,BorgWarner,52,42,6,100,0.060000
2025-09-16,Boston Properties,24,65,11,100,0.110000
2025-09-16,Boston Scientific,41,51,8,100,0.080000
2025-09-16,Boyd Gaming,42,54,4,100,0.040000
2025-09-16,Bread Financial,41,55,4,100,0.040000
2025-09-16,BrightSpring Health Services,39,50,11,100,0.110000
2025-09-16,BrightView Holdings,37,56,7,100,0.070000
2025-09-16,Brighthouse Financial,32,55,13,100,0.130000
2025-09-16,Brinker International,47,49,4,100,0.040000
2025-09-16,Brinks Company,12,3,6,21,0.285714
2025-09-16,Bristol-Myers Squibb,40,45,15,100,0.150000
2025-09-16,Broadcom,48,48,4,100,0.040000
2025-09-16,Broadridge Financial Solutions,88,8,4,100,0.040000
2025-09-16,Brookdale Senior Living,32,51,17,100,0.170000
2025-09-16,Brown & Brown,34,47,19,100,0.190000
2025-09-16,Brown-Forman,25,52,23,100,0.230000
2025-09-16,Bruker,31,48,21,100,0.210000
2025-09-16,Brunswick Corporation,54,34,12,100,0.120000
2025-09-16,Builders FirstSource,44,44,12,100,0.120000
2025-09-16,Burlington Stores,37,57,6,100,0.060000
2025-09-16,CACI International,58,35,7,100,0.070000
2025-09-16,CBRE Group,49,48,3,100,0.030000
2025-09-16,CDW,55,39,6,100,0.060000
2025-09-16,CF Industries,49,48,3,100,0.030000
2025-09-16,CH Robinson Worldwide,44,43,13,100,0.130000
2025-09-16,CHS,49,40,11,100,0.110000
2025-09-16,CIncinnati Financial,37,55,8,100,0.080000
2025-09-16,CME Group,39,54,7,100,0.070000
2025-09-16,CMS Energy,91,7,2,100,0.020000
2025-09-16,CNO Financial Group,36,56,8,100,0.080000
2025-09-16,CNX Resources,52,38,10,100,0.100000
2025-09-16,CSX,43,41,16,100,0.160000
2025-09-16,CVS Health,57,33,10,100,0.100000
2025-09-16,Cabot Corporation,44,49,7,100,0.070000
2025-09-16,Cadence,32,51,17,100,0.170000
2025-09-16,Caesars Entertainment,86,11,3,100,0.030000
2025-09-16,Cal-Maine Foods,61,33,6,100,0.060000
2025-09-16,Caleres Inc,33,52,15,100,0.150000
2025-09-16,California Resources,42,52,6,100,0.060000
2025-09-16,Calumet Inc,39,41,14,94,0.148936
2025-09-16,Campbell Soup,39,50,11,100,0.110000
2025-09-16,Camping World,31,49,20,100,0.200000
2025-09-16,Capital One,50,34,16,100,0.160000
2025-09-16,CarMax,27,59,14,100,0.140000
2025-09-16,Cardinal Health,52,37,11,100,0.110000
2025-09-16,Carlisle Companies,39,50,11,100,0.110000
2025-09-16,Carlyle Group,40,51,9,100,0.090000
2025-09-16,Carpenter Technology,48,49,3,100,0.030000
2025-09-16,Carrier Global,30,50,20,100,0.200000
2025-09-16,Carters Inc,14,20,3,37,0.081081
2025-09-16,Carvana,43,52,5,100,0.050000
2025-09-16,Caseys General Stores,34,53,13,100,0.130000
2025-09-16,Catalent,29,60,11,100,0.110000
2025-09-16,Caterpillar,58,35,7,100,0.070000
2025-09-16,Cboe Global Markets,38,59,3,100,0.030000
2025-09-16,Celanese,32,40,28,100,0.280000
2025-09-16,Cencora,53,41,6,100,0.060000
2025-09-16,Centene,41,41,18,100,0.180000
2025-09-16,CenterPoint Energy,74,10,16,100,0.160000
2025-09-16,Central Garden & Pet,21,76,3,100,0.030000
2025-09-16,Century Communities,36,59,5,100,0.050000
2025-09-16,ChampionX,50,47,3,100,0.030000
2025-09-16,Charles River Laboratories International,31,54,15,100,0.150000
2025-09-16,Charles Schwab,42,47,11,100,0.110000
2025-09-16,Chart Industries,43,52,5,100,0.050000
2025-09-16,Charter Communications,28,57,15,100,0.150000
2025-09-16,Cheesecake Factory,31,49,20,100,0.200000
2025-09-16,Chefs Warehouse,46,47,7,100,0.070000
2025-09-16,Chemours,34,45,21,100,0.210000
2025-09-16,Cheniere Energy,97,3,0,100,0.000000
2025-09-16,Chevron,52,33,15,100,0.150000
2025-09-16,Chewy,37,34,29,100,0.290000
2025-09-16,Chipotle Mexican Grill,28,58,14,100,0.140000
2025-09-16,Chord Energy,90,3,7,100,0.070000
2025-09-16,Church & Dwight,42,53,5,100,0.050000
2025-09-16,Ciena,45,46,9,100,0.090000
2025-09-16,Cigna,48,41,11,100,0.110000
2025-09-16,Cinemark,27,57,16,100,0.160000
2025-09-16,Cintas,58,34,8,100,0.080000
2025-09-16,Cisco Systems,53,41,6,100,0.060000
2025-09-16,Citigroup,46,49,5,100,0.050000
2025-09-16,Citizens Financial Group,37,60,3,100,0.030000
2025-09-16,Civitas Resources,43,32,25,100,0.250000
2025-09-16,Clean Harbors,87,4,9,100,0.090000
2025-09-16,Clear Channel Outdoor Hldgs,8,0,2,10,0.200000
2025-09-16,Cleveland-Cliffs,26,52,22,100,0.220000
2025-09-16,Clorox,46,40,14,100,0.140000
2025-09-16,Cognizant Technology Solutions,86,9,5,100,0.050000
2025-09-16,Coherent,33,59,8,100,0.080000
2025-09-16,Coinbase Global,34,56,10,100,0.100000
2025-09-16,Colgate-Palmolive,31,52,17,100,0.170000
2025-09-16,Columbia Banking System,43,54,3,100,0.030000
2025-09-16,Columbia Sportswear,31,48,21,100,0.210000
2025-09-16,Comcast,50,33,17,100,0.170000
2025-09-16,Comerica,46,43,11,100,0.110000
2025-09-16,Comfort Systems USA,98,1,1,100,0.010000
2025-09-16,CommScope,42,57,1,100,0.010000
2025-09-16,Commercial Metals,37,46,17,100,0.170000
2025-09-16,Community Health Systems,29,50,21,100,0.210000
2025-09-16,Compass Group,40,44,16,100,0.160000
2025-09-16,Conagra Brands,33,52,15,100,0.150000
2025-09-16,Concentrix,43,46,11,100,0.110000
2025-09-16,Conduent,33,44,23,100,0.230000
2025-09-16,ConocoPhillips,41,34,25,100,0.250000
2025-09-16,Consol Energy,79,12,9,100,0.090000
2025-09-16,Consolidated Edison,36,52,12,100,0.120000
2025-09-16,Constellation Brands,28,34,38,100,0.380000
2025-09-16,Constellation Energy,89,7,4,100,0.040000
2025-09-16,Continental Resources,46,39,15,100,0.150000
2025-09-16,Cooper Cos,7,29,6,42,0.142857
2025-09-16,Cooper-Standard,34,58,8,100,0.080000
2025-09-16,Copart,41,53,6,100,0.060000
2025-09-16,Core & Main,32,44,24,100,0.240000
2025-09-16,Corebridge Financial,49,46,5,100,0.050000
2025-09-16,Cornerstone Building Brands,34,57,9,100,0.090000
2025-09-16,Corning,40,44,16,100,0.160000
2025-09-16,Corpay,42,58,0,100,0.000000
2025-09-16,Corteva,29,57,9,95,0.094737
2025-09-16,Costco,41,38,20,99,0.202020
2025-09-16,Coterra Energy,92,3,5,100,0.050000
2025-09-16,Coty,29,45,26,100,0.260000
2025-09-16,Country Financial,29,52,19,100,0.190000
2025-09-16,Coupang,42,42,16,100,0.160000
2025-09-16,Cracker Barrel Old Country Store,22,56,16,94,0.170213
2025-09-16,Crocs,45,47,8,100,0.080000
2025-09-16,CrossAmerica Partners,32,57,11,100,0.110000
2025-09-16,CrowdStrike,50,34,16,100,0.160000
2025-09-16,Crown Castle,39,57,4,100,0.040000
2025-09-16,Crown Holdings,51,40,9,100,0.090000
2025-09-16,Cullen Frost Bankers,54,40,6,100,0.060000
2025-09-16,Cummins Inc,58,37,5,100,0.050000
2025-09-16,Curtiss-Wright,53,42,5,100,0.050000
2025-09-16,DR Horton,51,40,9,100,0.090000
2025-09-16,DTE Energy,83,11,6,100,0.060000
2025-09-16,DXC Technology,41,56,3,100,0.030000
2025-09-16,DaVita,42,32,26,100,0.260000
2025-09-16,Dana Incorporated,40,51,9,100,0.090000
2025-09-16,Danaher,51,42,7,100,0.070000
2025-09-16,Darden Restaurants,41,50,9,100,0.090000
2025-09-16,Darling Ingredients,94,3,3,100,0.030000
2025-09-16,Deckers Outdoor,52,39,9,100,0.090000
2025-09-16,Deere,46,42,12,100,0.120000
2025-09-16,Delek US,51,38,11,100,0.110000
2025-09-16,Dell Technologies,44,52,4,100,0.040000
2025-09-16,Delta Air Lines,19,51,30,100,0.300000
2025-09-16,Dentsply Sirona,30,65,5,100,0.050000
2025-09-16,Designer Brands,32,55,13,100,0.130000
2025-09-16,Devon Energy,94,2,4,100,0.040000
2025-09-16,DexCom,38,48,14,100,0.140000
2025-09-16,Diamondback Energy,91,3,6,100,0.060000
2025-09-16,Dicks Sporting Goods,38,57,5,100,0.050000
2025-09-16,Diebold Nixdorf,41,54,5,100,0.050000
2025-09-16,Digital Realty Trust,89,11,0,100,0.000000
2025-09-16,Dillards,31,47,22,100,0.220000
2025-09-16,Discover Financial,44,44,12,100,0.120000
2025-09-16,DocuSign,46,41,13,100,0.130000
2025-09-16,Dollar General,23,49,28,100,0.280000
2025-09-16,Dollar Tree,45,44,11,100,0.110000
2025-09-16,Dominion Energy,77,15,8,100,0.080000
2025-09-16,Dominos Pizza Inc,20,14,5,39,0.128205
2025-09-16,Domtar,31,55,14,100,0.140000
2025-09-16,Donaldson Company,49,47,4,100,0.040000
2025-09-16,DoorDash,39,35,26,100,0.260000
2025-09-16,Dover Corporation,53,44,3,100,0.030000
2025-09-16,DraftKings,64,30,6,100,0.060000
2025-09-16,Dream Finders Homes,86,8,6,100,0.060000
2025-09-16,Dropbox,40,55,5,100,0.050000
2025-09-16,DuPont,41,42,17,100,0.170000
2025-09-16,Duke Energy,96,2,2,100,0.020000
2025-09-16,Dycom Industries,43,51,6,100,0.060000
2025-09-16,EMCOR Group,43,53,4,100,0.040000
2025-09-16,EOG Resources,51,45,4,100,0.040000
2025-09-16,EPAM Systems,47,44,9,100,0.090000
2025-09-16,EQT,48,50,2,100,0.020000
2025-09-16,ESAB,36,53,11,100,0.110000
2025-09-16,East West Bancorp,47,48,5,100,0.050000
2025-09-16,Eastman Chemical,28,39,33,100,0.330000
2025-09-16,Ebay,33,54,13,100,0.130000
2025-09-16,EchoStar,33,54,13,100,0.130000
2025-09-16,Ecolab,44,51,5,100,0.050000
2025-09-16,Edison International,33,46,21,100,0.210000
2025-09-16,Edward Jones,35,50,15,100,0.150000
2025-09-16,Edwards Lifesciences,48,36,16,100,0.160000
2025-09-16,Elanco Animal Health,40,55,5,100,0.050000
2025-09-16,Electronic Arts,34,50,16,100,0.160000
2025-09-16,Elevance Health,49,31,20,100,0.200000
2025-09-16,Eli Lilly,36,42,22,100,0.220000
2025-09-16,Emerson Electric,51,41,8,100,0.080000
2025-09-16,EnLink Midstream,46,46,8,100,0.080000
2025-09-16,Encompass Health,32,60,8,100,0.080000
2025-09-16,Endeavor Group,29,61,10,100,0.100000
2025-09-16,Endeavor Group Holdings,31,58,11,100,0.110000
2025-09-16,EnerSys,44,48,8,100,0.080000
2025-09-16,Energizer Holdings,94,3,3,100,0.030000
2025-09-16,Energy Transfer,82,5,13,100,0.130000
2025-09-16,Ensign Group,53,42,5,100,0.050000
2025-09-16,Entegris,55,37,8,100,0.080000
2025-09-16,Entergy,56,40,4,100,0.040000
2025-09-16,Enterprise Products Partners,51,33,16,100,0.160000
2025-09-16,Envista,37,56,7,100,0.070000
2025-09-16,Equifax,51,27,22,100,0.220000
2025-09-16,Equinix,54,38,8,100,0.080000
2025-09-16,Equitable Holdings,38,49,13,100,0.130000
2025-09-16,Equity Residential,39,53,8,100,0.080000
2025-09-16,Erie Insurance,37,45,18,100,0.180000
2025-09-16,Estée Lauder,44,44,12,100,0.120000
2025-09-16,Etsy,33,35,32,100,0.320000
2025-09-16,Euronet Worldwide,37,54,9,100,0.090000
2025-09-16,Evergy,46,43,11,100,0.110000
2025-09-16,Eversource Energy,84,9,7,100,0.070000
2025-09-16,Exact Sciences,28,49,23,100,0.230000
2025-09-16,Exelon,51,45,4,100,0.040000
2025-09-16,Expand Energy Corporation,99,0,1,100,0.010000
2025-09-16,Expedia,50,43,7,100,0.070000
2025-09-16,Expeditors International of Washington,44,52,4,100,0.040000
2025-09-16,Extra Space Storage,34,57,9,100,0.090000
2025-09-16,Exxon Mobil,51,38,11,100,0.110000
2025-09-16,F5,45,45,10,100,0.100000
2025-09-16,FM Global,39,37,24,100,0.240000
2025-09-16,FMC Corporation,34,51,15,100,0.150000
2025-09-16,FTI Consulting,27,61,12,100,0.120000
2025-09-16,Fannie Mae,27,61,12,100,0.120000
2025-09-16,Farmers Insurance Exchange,24,44,27,95,0.284211
2025-09-16,Fastenal,39,55,6,100,0.060000
2025-09-16,FedEx,43,42,15,100,0.150000
2025-09-16,Federated Mutual Insurance,17,24,6,47,0.127660
2025-09-16,Ferguson Enterprises,34,58,8,100,0.080000
2025-09-16,Fidelity National Financial,44,43,13,100,0.130000
2025-09-16,Fidelity National Information Services,56,34,10,100,0.100000
2025-09-16,Fifth Third Bancorp,48,36,16,100,0.160000
2025-09-16,First American Financial,33,56,11,100,0.110000
2025-09-16,First Citizens BancShares,39,53,8,100,0.080000
2025-09-16,First Horizon,47,52,1,100,0.010000
2025-09-16,First National of Nebraska,20,26,2,48,0.041667
2025-09-16,First Solar,48,44,8,100,0.080000
2025-09-16,FirstCash,37,48,15,100,0.150000
2025-09-16,FirstEnergy,48,36,16,100,0.160000
2025-09-16,Fiserv,41,50,9,100,0.090000
2025-09-16,Five Below,38,53,9,100,0.090000
2025-09-16,Flagstar Financial,43,46,11,100,0.110000
2025-09-16,Floor & Decor,45,47,8,100,0.080000
2025-09-16,Flowers Foods,33,46,21,100,0.210000
2025-09-16,Flowserve,37,56,7,100,0.070000
2025-09-16,Fluor,44,39,17,100,0.170000
2025-09-16,Foot Locker,11,69,20,100,0.200000
2025-09-16,Ford Motor,27,54,11,92,0.119565
2025-09-16,Fortinet,42,28,30,100,0.300000
2025-09-16,Fortive,37,50,13,100,0.130000
2025-09-16,Fortune Brands Innovations,29,62,9,100,0.090000
2025-09-16,Franklin Resources,41,50,9,100,0.090000
2025-09-16,Freddie Mac,33,54,13,100,0.130000
2025-09-16,Freeport-McMoRan,49,37,14,100,0.140000
2025-09-16,Frontier Airlines,31,51,18,100,0.180000
2025-09-16,Frontier Communications,44,46,10,100,0.100000
2025-09-16,G-III Apparel Group,29,58,13,100,0.130000
2025-09-16,GE HealthCare Technologies,48,46,6,100,0.060000
2025-09-16,GE Vernova,50,41,9,100,0.090000
2025-09-16,GMS,31,60,9,100,0.090000
2025-09-16,GXO Logistics,38,51,11,100,0.110000
2025-09-16,GameStop,42,42,16,100,0.160000
2025-09-16,Gannett,40,49,11,100,0.110000
2025-09-16,Garrett Motion Inc,43,53,4,100,0.040000
2025-09-16,Gartner,30,56,14,100,0.140000
2025-09-16,Gen Digital,54,39,7,100,0.070000
2025-09-16,Generac,43,44,13,100,0.130000
2025-09-16,General Dynamics,96,1,3,100,0.030000
2025-09-16,General Mills,39,47,14,100,0.140000
2025-09-16,General Motors,49,42,9,100,0.090000
2025-09-16,Genesis Energy,84,13,3,100,0.030000
2025-09-16,Genuine Parts,46,47,7,100,0.070000
2025-09-16,Genworth Financial,50,43,7,100,0.070000
2025-09-16,Gilead Sciences,42,46,12,100,0.120000
2025-09-16,Global Partners,43,43,14,100,0.140000
2025-09-16,Global Payments,39,54,7,100,0.070000
2025-09-16,Globe Life,48,41,11,100,0.110000
2025-09-16,GoDaddy,46,44,10,100,0.100000
2025-09-16,Goldman Sachs,52,36,12,100,0.120000
2025-09-16,Goodyear Tire & Rubber,27,60,13,100,0.130000
2025-09-16,Graham Holdings Company,35,57,8,100,0.080000
2025-09-16,Granite Construction,39,53,8,100,0.080000
2025-09-16,Graphic Packaging,37,50,13,100,0.130000
2025-09-16,Gray Television,35,48,17,100,0.170000
2025-09-16,Graybar Electric,17,25,7,49,0.142857
2025-09-16,Green Plains Inc,38,39,23,100,0.230000
2025-09-16,Greenbrier,30,46,24,100,0.240000
2025-09-16,Greif,26,69,5,100,0.050000
2025-09-16,Griffon Corporation,43,48,9,100,0.090000
2025-09-16,Grocery Outlet Holding,37,54,9,100,0.090000
2025-09-16,Group 1 Automotive,37,55,8,100,0.080000
2025-09-16,Guardian Life insurance,52,46,2,100,0.020000
2025-09-16,Guess Inc,33,58,9,100,0.090000
2025-09-16,GuideWell Mutual,24,19,1,44,0.022727
2025-09-16,HB Fuller,30,63,7,100,0.070000
2025-09-16,HCA Healthcare,56,37,7,100,0.070000
2025-09-16,HEICO,40,52,8,100,0.080000
2025-09-16,HF SInclair,38,48,14,100,0.140000
2025-09-16,HP,34,56,10,100,0.100000
2025-09-16,Halliburton,31,45,24,100,0.240000
2025-09-16,Hanesbrands,29,63,8,100,0.080000
2025-09-16,Hanover Insurance Group,45,47,8,100,0.080000
2025-09-16,Harley-Davidson,26,63,11,100,0.110000
2025-09-16,Hasbro,39,51,10,100,0.100000
2025-09-16,Hawaiian Airlines Inc,36,62,2,100,0.020000
2025-09-16,Hawaiian Electric Industries,37,52,11,100,0.110000
2025-09-16,Helmerich & Payne,31,53,16,100,0.160000
2025-09-16,Henry Schein,43,47,10,100,0.100000
2025-09-16,Herc Rentals,45,42,13,100,0.130000
2025-09-16,Hershey,37,56,7,100,0.070000
2025-09-16,Hertz,49,30,21,100,0.210000
2025-09-16,Hewlett Packard Enterprise,31,66,3,100,0.030000
2025-09-16,Hillenbrand,33,55,12,100,0.120000
2025-09-16,Hilton Grand Vacations,94,5,1,100,0.010000
2025-09-16,Hilton Worldwide,50,43,7,100,0.070000
2025-09-16,Hologic,42,52,6,100,0.060000
2025-09-16,Home Depot,28,42,30,100,0.300000
2025-09-16,Honeywell,53,43,4,100,0.040000
2025-09-16,Hormel Foods,29,62,9,100,0.090000
2025-09-16,Host Hotels & Resorts,33,64,3,100,0.030000
2025-09-16,Hovnanian Enterprises,37,47,16,100,0.160000
2025-09-16,Howmet Aerospace,38,55,7,100,0.070000
2025-09-16,Hub Group,31,52,17,100,0.170000
2025-09-16,Hubbell,37,51,12,100,0.120000
2025-09-16,Humana,58,31,11,100,0.110000
2025-09-16,Huntington Bancshares,40,55,5,100,0.050000
2025-09-16,Huntington Ingalls Industries,47,39,14,100,0.140000
2025-09-16,Huntsman,18,51,31,100,0.310000
2025-09-16,Hyatt Hotels,39,54,7,100,0.070000
2025-09-16,Hyster-Yale,32,60,8,100,0.080000
2025-09-16,IAC,35,53,12,100,0.120000
2025-09-16,IBM,43,43,14,100,0.140000
2025-09-16,IDEX,48,43,9,100,0.090000
2025-09-16,IDEXX Laboratories,51,42,7,100,0.070000
2025-09-16,IQVIA,51,41,8,100,0.080000
2025-09-16,ITT,35,55,10,100,0.100000
2025-09-16,Icahn Enterprises,30,44,26,100,0.260000
2025-09-16,Illinois Tool Works,50,39,11,100,0.110000
2025-09-16,Illumina Inc,31,59,10,100,0.100000
2025-09-16,Incyte,46,45,9,100,0.090000
2025-09-16,Ingersoll Rand,53,38,9,100,0.090000
2025-09-16,Ingles Markets,24,47,29,100,0.290000
2025-09-16,Ingram Micro,26,33,41,100,0.410000
2025-09-16,Ingredion,47,46,7,100,0.070000
2025-09-16,Insight Enterprises,34,53,13,100,0.130000
2025-09-16,Insperity,45,36,19,100,0.190000
2025-09-16,Instacart,35,55,10,100,0.100000
2025-09-16,Installed Building Products,29,62,9,100,0.090000
2025-09-16,Intel,31,53,16,100,0.160000
2025-09-16,Interactive Brokers,44,46,10,100,0.100000
2025-09-16,Intercontinental Exchange,43,54,3,100,0.030000
2025-09-16,International Flavors & Fragrances,36,55,9,100,0.090000
2025-09-16,International Paper,24,65,11,100,0.110000
2025-09-16,Interpublic Group,49,46,5,100,0.050000
2025-09-16,Intuit,45,46,9,100,0.090000
2025-09-16,Intuitive Surgical,42,44,14,100,0.140000
2025-09-16,Iron Mountain,29,51,20,100,0.200000
2025-09-16,JB Hunt Transport Services,34,54,12,100,0.120000
2025-09-16,JELD-WEN Holding,30,58,12,100,0.120000
2025-09-16,JM Smucker,41,39,20,100,0.200000
2025-09-16,JPMorgan Chase,49,39,12,100,0.120000
2025-09-16,Jabil,47,50,3,100,0.030000
2025-09-16,Jackson Financial,36,57,7,100,0.070000
2025-09-16,Jacobs Solutions,90,3,7,100,0.070000
2025-09-16,Jefferies Financial,26,55,19,100,0.190000
2025-09-16,JetBlue Airways,43,45,12,100,0.120000
2025-09-16,Johnson & Johnson,50,41,9,100,0.090000
2025-09-16,Jones Lang LaSalle,40,56,4,100,0.040000
2025-09-16,Juniper Networks,34,57,9,100,0.090000
2025-09-16,KB Home,45,39,16,100,0.160000
2025-09-16,KBR,63,29,8,100,0.080000
2025-09-16,KKR & Co,53,42,5,100,0.050000
2025-09-16,KLA,48,32,20,100,0.200000
2025-09-16,Kaiser Aluminum,33,55,12,100,0.120000
2025-09-16,Kellanova,48,44,8,100,0.080000
2025-09-16,Kelly Services Inc,41,50,9,100,0.090000
2025-09-16,Kemper Corporation,43,43,14,100,0.140000
2025-09-16,Kenvue,32,54,14,100,0.140000
2025-09-16,Keurig Dr Pepper,25,63,12,100,0.120000
2025-09-16,KeyCorp,48,46,6,100,0.060000
2025-09-16,Keysight Technologies,49,43,8,100,0.080000
2025-09-16,Kimberly-Clark,37,52,11,100,0.110000
2025-09-16,Kinder Morgan,100,0,0,100,0.000000
2025-09-16,Kirby Corporation,32,58,10,100,0.100000
2025-09-16,Knife River Corporation,40,42,11,93,0.118280
2025-09-16,Knight Swift Transportation,36,50,14,100,0.140000
2025-09-16,Kohl's,37,40,23,100,0.230000
2025-09-16,Kontoor Brands,38,58,4,100,0.040000
2025-09-16,Korn Ferry,55,32,13,100,0.130000
2025-09-16,Kraft Heinz,32,53,15,100,0.150000
2025-09-16,Kroger,47,34,19,100,0.190000
2025-09-16,Kyndryl,42,53,5,100,0.050000
2025-09-16,L3Harris Technologies,52,41,7,100,0.070000
2025-09-16,LCI Industries,39,54,7,100,0.070000
2025-09-16,LKQ,38,55,7,100,0.070000
2025-09-16,LPL Financial,69,31,0,100,0.000000
2025-09-16,Labcorp Holdings,47,47,6,100,0.060000
2025-09-16,Lam Research,53,44,3,100,0.030000
2025-09-16,Lamb Weston,36,53,11,100,0.110000
2025-09-16,Land O'Lakes,37,49,14,100,0.140000
2025-09-16,Landstar System,26,42,32,100,0.320000
2025-09-16,Las Vegas Sands,42,50,8,100,0.080000
2025-09-16,Lear Corporation,41,46,13,100,0.130000
2025-09-16,Leggett & Platt,35,55,10,100,0.100000
2025-09-16,Leidos,49,42,9,100,0.090000
2025-09-16,Lennar,30,64,6,100,0.060000
2025-09-16,Lennox International,39,56,5,100,0.050000
2025-09-16,Levi Strauss,30,67,3,100,0.030000
2025-09-16,Liberty Energy,97,2,1,100,0.010000
2025-09-16,Liberty Media,97,3,0,100,0.000000
2025-09-16,Liberty Mutual Insurance,90,2,8,100,0.080000
2025-09-16,Light & Wonder,27,56,17,100,0.170000
2025-09-16,Lincoln Electric,42,54,4,100,0.040000
2025-09-16,Lincoln National,42,45,13,100,0.130000
2025-09-16,Lithia Motors,40,53,7,100,0.070000
2025-09-16,Live Nation Entertainment,73,19,8,100,0.080000
2025-09-16,Lockheed Martin,54,36,10,100,0.100000
2025-09-16,Loews,43,51,6,100,0.060000
2025-09-16,Louisiana-Pacific Corporation,47,41,12,100,0.120000
2025-09-16,Lowe's,49,33,18,100,0.180000
2025-09-16,Lululemon athletica,27,43,30,100,0.300000
2025-09-16,Lumen Technologies,24,60,16,100,0.160000
2025-09-16,Lyft,31,52,17,100,0.170000
2025-09-16,M&T Bank,40,53,7,100,0.070000
2025-09-16,M/I Homes,30,59,11,100,0.110000
2025-09-16,MDU Resources Group,40,49,11,100,0.110000
2025-09-16,MGM Resorts International,48,46,6,100,0.060000
2025-09-16,MKS Instruments,41,49,10,100,0.100000
2025-09-16,MRC Global,39,56,5,100,0.050000
2025-09-16,MSC Industrial Direct,26,61,13,100,0.130000
2025-09-16,MSCI,32,63,5,100,0.050000
2025-09-16,MYR Group,36,55,9,100,0.090000
2025-09-16,Macys,39,49,12,100,0.120000
2025-09-16,ManpowerGroup,39,43,18,100,0.180000
2025-09-16,Marathon Oil,35,46,19,100,0.190000
2025-09-16,Marathon Petroleum,49,46,5,100,0.050000
2025-09-16,Markel Group,40,49,11,100,0.110000
2025-09-16,Marriott International,44,49,7,100,0.070000
2025-09-16,Marriott Vacations Worldwide,38,51,11,100,0.110000
2025-09-16,Marsh & McLennan,49,43,8,100,0.080000
2025-09-16,Martin Marietta Materials,34,46,20,100,0.200000
2025-09-16,Marvell Technology,38,51,11,100,0.110000
2025-09-16,MasTec,52,43,5,100,0.050000
2025-09-16,Masco,41,51,8,100,0.080000
2025-09-16,Mass Mutual,23,45,7,75,0.093333
2025-09-16,MasterBrand,40,52,8,100,0.080000
2025-09-16,Mastercard,36,57,7,100,0.070000
2025-09-16,Matador Resources,39,47,14,100,0.140000
2025-09-16,Match Group,30,44,26,100,0.260000
2025-09-16,Mativ,33,58,9,100,0.090000
2025-09-16,Matson Inc,47,40,13,100,0.130000
2025-09-16,Mattel,33,52,15,100,0.150000
2025-09-16,Maximus,33,59,8,100,0.080000
2025-09-16,McCormick & Company,44,42,14,100,0.140000
2025-09-16,McDonalds,33,57,10,100,0.100000
2025-09-16,McKesson,54,39,7,100,0.070000
2025-09-16,Medical Mutual of Ohio,28,60,12,100,0.120000
2025-09-16,Merck,35,43,22,100,0.220000
2025-09-16,Mercury General,35,44,21,100,0.210000
2025-09-16,Meritage Homes,30,52,18,100,0.180000
2025-09-16,MetLife,38,48,14,100,0.140000
2025-09-16,Meta Platforms,52,42,6,100,0.060000
2025-09-16,Mettler-Toledo International,44,53,3,100,0.030000
2025-09-16,Microchip Technology,39,52,9,100,0.090000
2025-09-16,Micron Technology,51,36,5,92,0.054348
2025-09-16,Microsoft,44,47,9,100,0.090000
2025-09-16,Middleby,35,56,9,100,0.090000
2025-09-16,MillerKnoll,40,49,11,100,0.110000
2025-09-16,Moderna,33,41,26,100,0.260000
2025-09-16,ModivCare,32,45,23,100,0.230000
2025-09-16,Mohawk Industries,44,43,13,100,0.130000
2025-09-16,Molina Healthcare,44,35,21,100,0.210000
2025-09-16,Molson Coors Beverage,45,37,18,100,0.180000
2025-09-16,Mondelez,38,45,17,100,0.170000
2025-09-16,Monster Beverage,47,42,11,100,0.110000
2025-09-16,Moodys Corporation,3,13,2,18,0.111111
2025-09-16,Moog Inc,46,46,8,100,0.080000
2025-09-16,Morgan Stanley,36,48,16,100,0.160000
2025-09-16,Motorola Solutions,92,2,6,100,0.060000
2025-09-16,Mueller Industries,54,42,4,100,0.040000
2025-09-16,Murphy Oil,38,45,17,100,0.170000
2025-09-16,Murphy USA,37,52,11,100,0.110000
2025-09-16,Mutual of Omaha,44,49,7,100,0.070000
2025-09-16,NCR Atleos,44,54,2,100,0.020000
2025-09-16,NCR Voyix,38,55,7,100,0.070000
2025-09-16,NGL Energy Partners,89,3,8,100,0.080000
2025-09-16,NLV Financial,5,3,2,10,0.200000
2025-09-16,NOV,31,59,10,100,0.100000
2025-09-16,NRG Energy,88,6,6,100,0.060000
2025-09-16,NVR Inc,42,45,13,100,0.130000
2025-09-16,Nasdaq Inc,53,41,6,100,0.060000
2025-09-16,Nationwide Insurance,26,54,20,100,0.200000
2025-09-16,Navient,38,37,25,100,0.250000
2025-09-16,NetApp,46,45,9,100,0.090000
2025-09-16,Netflix,36,40,24,100,0.240000
2025-09-16,NeueHealth,59,37,4,100,0.040000
2025-09-16,New York Life Insurance,43,48,9,100,0.090000
2025-09-16,NewMarket Corporation,33,37,6,76,0.078947
2025-09-16,Newell Brands,27,55,18,100,0.180000
2025-09-16,Newmont,30,58,12,100,0.120000
2025-09-16,News Corp,35,46,19,100,0.190000
2025-09-16,Nexstar Media Group,48,48,4,100,0.040000
2025-09-16,NextEra Energy,93,5,2,100,0.020000
2025-09-16,NiSource,49,38,13,100,0.130000
2025-09-16,Nike,42,44,14,100,0.140000
2025-09-16,Nordson,57,39,4,100,0.040000
2025-09-16,Nordstrom,39,50,11,100,0.110000
2025-09-16,Norfolk Southern,35,54,11,100,0.110000
2025-09-16,Northern Trust,95,3,2,100,0.020000
2025-09-16,Northrop Grumman,33,56,3,92,0.032609
2025-09-16,Northwestern Mutual,40,41,19,100,0.190000
2025-09-16,Nucor,32,54,14,100,0.140000
2025-09-16,Nvidia,27,34,39,100,0.390000
2025-09-16,O'Reilly Automotive,30,47,23,100,0.230000
2025-09-16,O-I Glass,40,50,10,100,0.100000
2025-09-16,ODP Business Solutions,26,35,2,63,0.031746
2025-09-16,OGE Energy,92,4,4,100,0.040000
2025-09-16,ON Semiconductor,31,50,19,100,0.190000
2025-09-16,Occidental Petroleum,29,58,13,100,0.130000
2025-09-16,Old Dominion Freight Line,47,39,14,100,0.140000
2025-09-16,Old National Bancorp,42,57,1,100,0.010000
2025-09-16,Old Republic International,54,42,4,100,0.040000
2025-09-16,Olin,31,49,20,100,0.200000
2025-09-16,Omnicom Group,52,38,10,100,0.100000
2025-09-16,OneMain,51,47,2,100,0.020000
2025-09-16,Oneok,53,44,3,100,0.030000
2025-09-16,Opendoor Technologies,34,48,18,100,0.180000
2025-09-16,Option Care Health,98,2,0,100,0.000000
2025-09-16,Oracle,45,45,10,100,0.100000
2025-09-16,Organon,33,45,22,100,0.220000
2025-09-16,Oscar Health,29,57,14,100,0.140000
2025-09-16,Oshkosh Corporation,48,45,7,100,0.070000
2025-09-16,Otis Worldwide,36,48,16,100,0.160000
2025-09-16,Ovintiv,58,32,10,100,0.100000
2025-09-16,Owens & Minor,29,48,23,100,0.230000
2025-09-16,Owens Corning,40,57,3,100,0.030000
2025-09-16,PACS Group,36,34,30,100,0.300000
2025-09-16,PBF Energy,80,6,14,100,0.140000
2025-09-16,PC Connection Inc,35,31,5,71,0.070423
2025-09-16,PENN Entertainment,89,9,2,100,0.020000
2025-09-16,PG&E,55,26,19,100,0.190000
2025-09-16,PNC Financial Services,44,53,3,100,0.030000
2025-09-16,PPG Industries,38,52,10,100,0.100000
2025-09-16,PPL Corporation,53,39,8,100,0.080000
2025-09-16,PVH,29,47,24,100,0.240000
2025-09-16,Paccar,45,38,17,100,0.170000
2025-09-16,Pacific Life,38,56,6,100,0.060000
2025-09-16,Packaging Corp of America,22,59,19,100,0.190000
2025-09-16,Palo Alto Networks,43,44,13,100,0.130000
2025-09-16,Par Pacific,38,53,9,100,0.090000
2025-09-16,Paramount Global,20,59,21,100,0.210000
2025-09-16,Park Hotels & Resorts,30,56,14,100,0.140000
2025-09-16,Parker-Hannifin,47,50,3,100,0.030000
2025-09-16,Parsons Corporation,53,33,14,100,0.140000
2025-09-16,Patrick Industries,34,58,8,100,0.080000
2025-09-16,Patterson Companies Inc,20,55,4,79,0.050633
2025-09-16,Patterson-UTI Energy,68,22,10,100,0.100000
2025-09-16,PayPal,40,46,6,92,0.065217
2025-09-16,Paychex,52,39,9,100,0.090000
2025-09-16,Peabody Energy,78,13,9,100,0.090000
2025-09-16,Peloton Interactive,48,43,9,100,0.090000
2025-09-16,Penn Mutual Life Insurance,39,57,4,100,0.040000
2025-09-16,PennyMac Financial Services,42,48,10,100,0.100000
2025-09-16,Penske Automotive,40,57,3,100,0.030000
2025-09-16,PepsiCo,59,35,6,100,0.060000
2025-09-16,Performance Food,39,53,8,100,0.080000
2025-09-16,Permian Resources,50,41,9,100,0.090000
2025-09-16,Petco Health and Wellness,83,12,5,100,0.050000
2025-09-16,Peter Kiewit Sons',5,20,14,39,0.358974
2025-09-16,Pfizer,45,35,20,100,0.200000
2025-09-16,Philip Morris International,40,50,10,100,0.100000
2025-09-16,Phillips 66,46,48,6,100,0.060000
2025-09-16,Pinnacle West Capital,33,43,24,100,0.240000
2025-09-16,Pinterest,42,53,5,100,0.050000
2025-09-16,Pioneer Natural Resources,48,33,19,100,0.190000
2025-09-16,Pitney Bowes,40,54,6,100,0.060000
2025-09-16,Plains GP,44,39,17,100,0.170000
2025-09-16,Playtika Holding,38,44,18,100,0.180000
2025-09-16,Plexus Corp,37,55,8,100,0.080000
2025-09-16,Polaris Inc,52,41,7,100,0.070000
2025-09-16,Pool Corporation,44,45,11,100,0.110000
2025-09-16,Popular Inc,97,2,1,100,0.010000
2025-09-16,Portland General Electric,39,49,12,100,0.120000
2025-09-16,Post Holdings,28,64,8,100,0.080000
2025-09-16,PrIncipal Financial,45,48,7,100,0.070000
2025-09-16,PriceSmart,42,47,11,100,0.110000
2025-09-16,Primerica,47,46,7,100,0.070000
2025-09-16,Primoris Services,50,46,4,100,0.040000
2025-09-16,ProFrac Holding,33,49,18,100,0.180000
2025-09-16,Procter & Gamble,40,38,22,100,0.220000
2025-09-16,Progressive Insurance,34,52,14,100,0.140000
2025-09-16,Prologis,49,46,5,100,0.050000
2025-09-16,Prudential Financial,46,44,10,100,0.100000
2025-09-16,Public Service Enterprise Group,47,45,8,100,0.080000
2025-09-16,Public Storage,44,40,16,100,0.160000
2025-09-16,Publix Super Markets,41,51,8,100,0.080000
2025-09-16,Puget Sound Energy,61,25,14,100,0.140000
2025-09-16,PulteGroup,56,39,5,100,0.050000
2025-09-16,Pure Storage,31,56,13,100,0.130000
2025-09-16,QVC Group,22,66,12,100,0.120000
2025-09-16,QXO Building Products,1,7,2,10,0.200000
2025-09-16,Qorvo,47,44,9,100,0.090000
2025-09-16,Qualcomm,56,42,2,100,0.020000
2025-09-16,Quanta Services,47,50,3,100,0.030000
2025-09-16,Quest Diagnostics,33,56,11,100,0.110000
2025-09-16,QuidelOrtho,36,54,10,100,0.100000
2025-09-16,REV Group,47,41,12,100,0.120000
2025-09-16,RPM International,36,57,7,100,0.070000
2025-09-16,RTX,48,44,8,100,0.080000
2025-09-16,RXO Inc,42,40,18,100,0.180000
2025-09-16,Rackspace Technology,28,58,14,100,0.140000
2025-09-16,Radius Recycling,21,53,26,100,0.260000
2025-09-16,Ralph Lauren,31,68,1,100,0.010000
2025-09-16,Range Resources,50,45,5,100,0.050000
2025-09-16,Raymond James Financial,48,47,5,100,0.050000
2025-09-16,Realty Income,48,38,14,100,0.140000
2025-09-16,Regal Rexnord,40,52,8,100,0.080000
2025-09-16,Regeneron Pharmaceuticals,54,38,8,100,0.080000
2025-09-16,Regions Financial,50,43,7,100,0.070000
2025-09-16,Reinsurance Group of America,36,54,10,100,0.100000
2025-09-16,Reliance Inc,51,39,10,100,0.100000
2025-09-16,Republic Services,39,28,33,100,0.330000
2025-09-16,ResMed,33,64,3,100,0.030000
2025-09-16,Resideo Technologies,46,47,7,100,0.070000
2025-09-16,Restoration Hardware,28,56,16,100,0.160000
2025-09-16,Revvity,38,45,17,100,0.170000
2025-09-16,Rithm Capital,39,52,9,100,0.090000
2025-09-16,Rivian Automotive,26,59,15,100,0.150000
2025-09-16,Robert Half,40,42,18,100,0.180000
2025-09-16,Roblox,27,36,37,100,0.370000
2025-09-16,Rocket Companies,34,54,12,100,0.120000
2025-09-16,Rockwell Automation,42,52,6,100,0.060000
2025-09-16,Roku,47,40,13,100,0.130000
2025-09-16,Rollins Inc,33,63,4,100,0.040000
2025-09-16,Roper Technologies,39,59,2,100,0.020000
2025-09-16,Ross Stores,44,46,10,100,0.100000
2025-09-16,Rush Enterprises,40,51,9,100,0.090000
2025-09-16,Ryder System,49,44,7,100,0.070000
2025-09-16,Ryerson Holding,33,57,10,100,0.100000
2025-09-16,S&P Global,38,53,9,100,0.090000
2025-09-16,SBA Communications,45,46,9,100,0.090000
2025-09-16,SS&C Technologies,47,48,5,100,0.050000
2025-09-16,Sabre Corporation,41,44,15,100,0.150000
2025-09-16,Saia Inc,41,47,12,100,0.120000
2025-09-16,Salesforce,49,24,27,100,0.270000
2025-09-16,Sallie Mae,43,48,9,100,0.090000
2025-09-16,Sally Beauty,96,3,1,100,0.010000
2025-09-16,Sanmina,36,59,5,100,0.050000
2025-09-16,ScanSource,48,47,5,100,0.050000
2025-09-16,Schneider National,41,46,13,100,0.130000
2025-09-16,Science Applications International,37,47,16,100,0.160000
2025-09-16,Scotts Miracle-Gro,39,42,19,100,0.190000
2025-09-16,Seaboard,35,44,21,100,0.210000
2025-09-16,Sealed Air Corporation,38,49,13,100,0.130000
2025-09-16,Securian Financial,36,57,7,100,0.070000
2025-09-16,Select Medical Holdings,31,53,16,100,0.160000
2025-09-16,Selective Insurance Group,39,39,22,100,0.220000
2025-09-16,Sempra,61,36,3,100,0.030000
2025-09-16,Sentry Insurance Group,4,6,0,10,0.000000
2025-09-16,Service Corp International,7,13,5,25,0.200000
2025-09-16,ServiceNow,39,48,13,100,0.130000
2025-09-16,Sherwin-Williams,28,52,20,100,0.200000
2025-09-16,Shift4 Payments,36,49,15,100,0.150000
2025-09-16,Silgan,27,50,23,100,0.230000
2025-09-16,Simon Property Group,41,48,11,100,0.110000
2025-09-16,Sinclair,30,56,14,100,0.140000
2025-09-16,Sirius XM,24,67,9,100,0.090000
2025-09-16,SiteOne Landscape Supply,31,55,14,100,0.140000
2025-09-16,Skechers USA,31,62,7,100,0.070000
2025-09-16,SkyWest,27,46,27,100,0.270000
2025-09-16,Skyline Champion,35,9,3,47,0.063830
2025-09-16,Skyworks Solutions,74,15,11,100,0.110000
2025-09-16,Smurfit Westrock,23,62,15,100,0.150000
2025-09-16,Snap Inc,38,35,27,100,0.270000
2025-09-16,Snap-on,15,64,21,100,0.210000
2025-09-16,Snowflake Inc,50,50,0,100,0.000000
2025-09-16,Solventum,35,57,8,100,0.080000
2025-09-16,Sonic Automotive,26,65,9,100,0.090000
2025-09-16,Sonoco Products,40,48,12,100,0.120000
2025-09-16,Southern Company,55,42,3,100,0.030000
2025-09-16,Southwest Airlines,28,60,12,100,0.120000
2025-09-16,Southwest Gas Holdings,46,47,7,100,0.070000
2025-09-16,SpartanNash,31,65,4,100,0.040000
2025-09-16,Spectrum Brands,36,44,20,100,0.200000
2025-09-16,Spire Inc,54,37,9,100,0.090000
2025-09-16,Spirit AeroSystems,79,7,14,100,0.140000
2025-09-16,Spirit Airlines,73,6,21,100,0.210000
2025-09-16,Splunk,40,44,16,100,0.160000
2025-09-16,Sprouts Farmers Market,32,62,6,100,0.060000
2025-09-16,Stagwell,35,54,11,100,0.110000
2025-09-16,Stanley Black & Decker,36,45,19,100,0.190000
2025-09-16,Starbucks,40,44,16,100,0.160000
2025-09-16,State Farm Insurance,28,45,27,100,0.270000
2025-09-16,State Street,37,44,19,100,0.190000
2025-09-16,Steel Dynamics,90,6,4,100,0.040000
2025-09-16,Steelcase,35,63,2,100,0.020000
2025-09-16,Stericycle,23,19,58,100,0.580000
2025-09-16,Stifel Financial,52,42,6,100,0.060000
2025-09-16,StoneX Group,45,52,3,100,0.030000
2025-09-16,Stryker,40,48,12,100,0.120000
2025-09-16,Summit Materials,26,63,11,100,0.110000
2025-09-16,Sun Communities,41,46,13,100,0.130000
2025-09-16,Super Micro Computer,92,4,4,100,0.040000
2025-09-16,Surgery Partners,37,49,14,100,0.140000
2025-09-16,Sylvamo,25,52,23,100,0.230000
2025-09-16,Synchrony Financial,62,31,7,100,0.070000
2025-09-16,Synopsys,35,35,30,100,0.300000
2025-09-16,Synovus Financial,48,46,6,100,0.060000
2025-09-16,Sysco,48,39,13,100,0.130000
2025-09-16,T Rowe Price,51,47,2,100,0.020000
2025-09-16,TD Synnex,52,42,6,100,0.060000
2025-09-16,TEGNA,36,59,5,100,0.050000
2025-09-16,THOR Industries,29,53,18,100,0.180000
2025-09-16,TIAA,32,51,17,100,0.170000
2025-09-16,TJX,53,39,8,100,0.080000
2025-09-16,Take-Two Interactive Software,37,50,13,100,0.130000
2025-09-16,Talen Energy,94,5,1,100,0.010000
2025-09-16,Tapestry,39,51,10,100,0.100000
2025-09-16,Targa Resources,52,41,7,100,0.070000
2025-09-16,Target Corporation,31,57,12,100,0.120000
2025-09-16,Taylor Morrison Home,43,51,6,100,0.060000
2025-09-16,Teladoc Health,37,53,10,100,0.100000
2025-09-16,Teledyne Technologies,40,53,7,100,0.070000
2025-09-16,Teleflex,35,57,8,100,0.080000
2025-09-16,Telephone & Data Systems,14,21,3,38,0.078947
2025-09-16,TelevisaUnivision,32,49,19,100,0.190000
2025-09-16,Tempur Sealy International,43,43,14,100,0.140000
2025-09-16,Tenet Healthcare,50,39,11,100,0.110000
2025-09-16,Teradyne,46,47,7,100,0.070000
2025-09-16,Terex,29,60,11,100,0.110000
2025-09-16,Tesla,34,49,17,100,0.170000
2025-09-16,Tetra Tech,57,37,6,100,0.060000
2025-09-16,Texas Instruments,25,62,13,100,0.130000
2025-09-16,Texas Roadhouse,35,49,16,100,0.160000
2025-09-16,Textron,37,54,9,100,0.090000
2025-09-16,The Andersons Inc,24,73,3,100,0.030000
2025-09-16,The Coca-Cola Company,35,58,7,100,0.070000
2025-09-16,The Hartford,32,48,20,100,0.200000
2025-09-16,The Mosaic Company,38,44,18,100,0.180000
2025-09-16,Thermo Fisher Scientific,50,40,10,100,0.100000
2025-09-16,Thrivent Financial for Lutherans,35,45,8,88,0.090909
2025-09-16,Timken,31,54,15,100,0.150000
2025-09-16,Titan Machinery,28,56,16,100,0.160000
2025-09-16,Toast Inc,51,44,5,100,0.050000
2025-09-16,Toll Brothers,27,66,7,100,0.070000
2025-09-16,TopBuild,37,62,1,100,0.010000
2025-09-16,Topgolf Callaway Brands,25,53,22,100,0.220000
2025-09-16,Toro Company,37,54,9,100,0.090000
2025-09-16,Tractor Supply,35,61,4,100,0.040000
2025-09-16,TransDigm,54,35,11,100,0.110000
2025-09-16,TransUnion,40,35,25,100,0.250000
2025-09-16,Travelers Insurance,34,40,26,100,0.260000
2025-09-16,TreeHouse Foods,22,55,23,100,0.230000
2025-09-16,Tri Pointe Homes,36,62,2,100,0.020000
2025-09-16,TriNet Group,35,54,11,100,0.110000
2025-09-16,Trimble Inc,41,53,6,100,0.060000
2025-09-16,Trinity Industries,31,46,23,100,0.230000
2025-09-16,TruStage,56,36,8,100,0.080000
2025-09-16,Truist Financial,34,58,8,100,0.080000
2025-09-16,Tutor Perini Corporation,60,37,3,100,0.030000
2025-09-16,Twilio,50,42,8,100,0.080000
2025-09-16,Tyson Foods,30,47,23,100,0.230000
2025-09-16,U-Haul,14,32,54,100,0.540000
2025-09-16,UFP Industries,31,60,9,100,0.090000
2025-09-16,UGI Utilities Inc,29,31,16,76,0.210526
2025-09-16,UL Solutions,86,7,7,100,0.070000
2025-09-16,UPS,39,44,17,100,0.170000
2025-09-16,US Bancorp,54,42,4,100,0.040000
2025-09-16,US Foods,53,42,5,100,0.050000
2025-09-16,USAA,38,40,22,100,0.220000
2025-09-16,Uber,33,36,30,99,0.303030
2025-09-16,Ulta Beauty,88,7,5,100,0.050000
2025-09-16,Under Armour,31,55,14,100,0.140000
2025-09-16,Union Pacific,40,52,8,100,0.080000
2025-09-16,United Airlines,70,7,23,100,0.230000
2025-09-16,United Natural Foods,80,13,7,100,0.070000
2025-09-16,United Rentals,98,1,1,100,0.010000
2025-09-16,United States Steel,59,33,8,100,0.080000
2025-09-16,UnitedHealth,45,42,13,100,0.130000
2025-09-16,Universal Corporation,40,52,8,100,0.080000
2025-09-16,Universal Health Services,41,43,16,100,0.160000
2025-09-16,Unum Group,46,43,11,100,0.110000
2025-09-16,Upbound Group,54,42,4,100,0.040000
2025-09-16,Urban Outfitters,53,42,5,100,0.050000
2025-09-16,V2X,50,46,4,100,0.040000
2025-09-16,VF Corporation,25,45,23,93,0.247312
2025-09-16,VICI Properties,31,61,8,100,0.080000
2025-09-16,Vail Resorts,27,48,25,100,0.250000
2025-09-16,Valero Energy,87,5,8,100,0.080000
2025-09-16,Valley National Bancorp,28,60,12,100,0.120000
2025-09-16,Valmont Industries,46,47,7,100,0.070000
2025-09-16,Valvoline Inc,35,60,5,100,0.050000
2025-09-16,Ventas Inc,52,44,4,100,0.040000
2025-09-16,Verisk Analytics,47,40,13,100,0.130000
2025-09-16,Verizon,44,41,15,100,0.150000
2025-09-16,Vertex Pharmaceuticals,46,36,18,100,0.180000
2025-09-16,Vertiv,62,34,4,100,0.040000
2025-09-16,Viasat,41,49,10,100,0.100000
2025-09-16,Viatris,35,45,20,100,0.200000
2025-09-16,Victorias Secret,29,50,21,100,0.210000
2025-09-16,Visa Inc,60,35,5,100,0.050000
2025-09-16,Vishay Intertechnology,33,49,18,100,0.180000
2025-09-16,Vista Outdoor,25,54,21,100,0.210000
2025-09-16,Visteon,50,44,6,100,0.060000
2025-09-16,Vistra,60,31,9,100,0.090000
2025-09-16,Vontier,38,52,10,100,0.100000
2025-09-16,Voya Financial,56,39,5,100,0.050000
2025-09-16,Vulcan Materials,38,44,18,100,0.180000
2025-09-16,WEC Energy,91,5,4,100,0.040000
2025-09-16,WESCO International,54,42,4,100,0.040000
2025-09-16,WEX,45,46,9,100,0.090000
2025-09-16,WR Berkley,40,50,10,100,0.100000
2025-09-16,WW Grainger,46,43,11,100,0.110000
2025-09-16,Wabash National,30,40,30,100,0.300000
2025-09-16,Walmart,32,39,29,100,0.290000
2025-09-16,Walt Disney,52,42,6,100,0.060000
2025-09-16,Warner Bros Discovery,20,63,17,100,0.170000
2025-09-16,Warner Music Group,27,60,13,100,0.130000
2025-09-16,Waters Corporation,46,47,7,100,0.070000
2025-09-16,Watsco,32,45,23,100,0.230000
2025-09-16,Wayfair,49,45,6,100,0.060000
2025-09-16,Webster Financial,37,52,11,100,0.110000
2025-09-16,Weis Markets,26,60,14,100,0.140000
2025-09-16,Wells Fargo,89,4,7,100,0.070000
2025-09-16,Welltower,70,29,1,100,0.010000
2025-09-16,Werner Enterprises,41,39,20,100,0.200000
2025-09-16,West Pharmaceutical Services,42,46,12,100,0.120000
2025-09-16,Western & Southern Financial,35,60,5,100,0.050000
2025-09-16,Western Alliance Bancorp,24,35,27,86,0.313953
2025-09-16,Western Digital,43,41,16,100,0.160000
2025-09-16,Western Midstream Partners,50,43,7,100,0.070000
2025-09-16,Western Union,30,62,8,100,0.080000
2025-09-16,Westinghouse Air Brake Technologies,42,42,16,100,0.160000
2025-09-16,Weyerhaeuser,34,52,14,100,0.140000
2025-09-16,Whirlpool,32,46,22,100,0.220000
2025-09-16,Williams Companies,48,45,7,100,0.070000
2025-09-16,Williams-Sonoma,42,49,9,100,0.090000
2025-09-16,Winnebago Industries,29,55,16,100,0.160000
2025-09-16,Wintrust Financial,43,53,4,100,0.040000
2025-09-16,Woodward Inc,40,55,5,100,0.050000
2025-09-16,Workday,32,49,19,100,0.190000
2025-09-16,World Kinect,39,48,13,100,0.130000
2025-09-16,Worthington Enterprises,44,51,5,100,0.050000
2025-09-16,Wynn Resorts,31,45,24,100,0.240000
2025-09-16,XPO,33,55,12,100,0.120000
2025-09-16,Xcel Energy,85,10,5,100,0.050000
2025-09-16,Xerox,33,51,16,100,0.160000
2025-09-16,Xylem Inc,54,42,4,100,0.040000
2025-09-16,Yum Brands,24,65,11,100,0.110000
2025-09-16,Yum China,48,38,14,100,0.140000
2025-09-16,Zebra Technologies,49,41,10,100,0.100000
2025-09-16,Zimmer Biomet,44,51,5,100,0.050000
2025-09-16,Zions Bancorp,41,42,17,100,0.170000
2025-09-16,Zoetis,60,36,4,100,0.040000
2025-09-16,Zoom Video Communications,23,55,22,100,0.220000
2025-09-16,eXp World,33,57,10,100,0.100000
2025-09-16,iHeartMedia,40,51,9,100,0.090000
2025-09-17,3M,45,51,4,100,0.040000
2025-09-17,A O Smith,31,66,3,100,0.030000
2025-09-17,A-Mark Precious Metals,89,11,0,100,0.000000
2025-09-17,ABM Industries,26,53,21,100,0.210000
2025-09-17,ADT,43,41,16,100,0.160000
2025-09-17,AECOM,48,43,9,100,0.090000
2025-09-17,AES,41,43,16,100,0.160000
2025-09-17,AGCO,45,44,11,100,0.110000
2025-09-17,AGNC Investment,38,40,22,100,0.220000
2025-09-17,AIG,27,55,18,100,0.180000
2025-09-17,AMC Entertainment,84,10,6,100,0.060000
2025-09-17,AMC Networks,41,41,18,100,0.180000
2025-09-17,AMN Healthcare Services,26,57,17,100,0.170000
2025-09-17,APA,42,42,16,100,0.160000
2025-09-17,APi Group,43,49,8,100,0.080000
2025-09-17,ARKO,27,65,8,100,0.080000
2025-09-17,ASGN,36,49,15,100,0.150000
2025-09-17,AT&T,36,46,18,100,0.180000
2025-09-17,ATI Inc,52,43,5,100,0.050000
2025-09-17,AbbVie,40,45,15,100,0.150000
2025-09-17,Abbott Laboratories,51,44,5,100,0.050000
2025-09-17,Abercrombie & Fitch,38,56,6,100,0.060000
2025-09-17,Academy Sports and Outdoors,36,51,13,100,0.130000
2025-09-17,Acadia Healthcare,27,50,23,100,0.230000
2025-09-17,Ace Hardware,44,45,11,100,0.110000
2025-09-17,Acuity Inc,52,41,7,100,0.070000
2025-09-17,Adams Resources & Energy,17,5,2,24,0.083333
2025-09-17,AdaptHealth,40,41,19,100,0.190000
2025-09-17,Adobe,42,42,16,100,0.160000
2025-09-17,Advance Auto Parts,18,55,27,100,0.270000
2025-09-17,Advanced Drainage Systems,81,12,7,100,0.070000
2025-09-17,Advanced Micro Devices,92,3,5,100,0.050000
2025-09-17,Advantage Solutions,91,5,4,100,0.040000
2025-09-17,Aflac,35,36,29,100,0.290000
2025-09-17,Agilent Technologies,59,35,6,100,0.060000
2025-09-17,Agilon Health,37,47,16,100,0.160000
2025-09-17,Air Lease,35,57,8,100,0.080000
2025-09-17,Air Products & Chemicals,29,62,9,100,0.090000
2025-09-17,Airbnb,40,51,9,100,0.090000
2025-09-17,Akamai Technologies,54,34,12,100,0.120000
2025-09-17,Alaska Air,36,45,19,100,0.190000
2025-09-17,Albemarle Corporation,36,54,10,100,0.100000
2025-09-17,Albertsons,39,42,19,100,0.190000
2025-09-17,Alcoa Corporation,28,50,22,100,0.220000
2025-09-17,Alexandria Real Estate Equities,46,46,8,100,0.080000
2025-09-17,Alight Solutions,55,36,9,100,0.090000
2025-09-17,Align Technology,35,48,17,100,0.170000
2025-09-17,Allegiant Travel Company,36,58,6,100,0.060000
2025-09-17,Alliance Resource Partners,37,45,18,100,0.180000
2025-09-17,Alliant Energy,82,12,6,100,0.060000
2025-09-17,Allison Transmission,37,49,14,100,0.140000
2025-09-17,Allstate,65,26,9,100,0.090000
2025-09-17,Ally Financial,37,55,8,100,0.080000
2025-09-17,Alpha Metallurgical Resources,44,42,14,100,0.140000
2025-09-17,Alphabet,38,54,7,99,0.070707
2025-09-17,Altice USA,40,46,14,100,0.140000
2025-09-17,Altria,52,37,11,100,0.110000
2025-09-17,Amazon,85,6,9,100,0.090000
2025-09-17,Ameren,38,49,13,100,0.130000
2025-09-17,American Airlines,40,36,23,99,0.232323
2025-09-17,American Axle & Manufacturing,28,63,9,100,0.090000
2025-09-17,American Eagle Outfitters,40,46,14,100,0.140000
2025-09-17,American Electric Power,50,43,7,100,0.070000
2025-09-17,American Express,33,59,8,100,0.080000
2025-09-17,American Family Insurance,54,36,10,100,0.100000
2025-09-17,American Financial Group,38,50,12,100,0.120000
2025-09-17,American Tower,39,55,6,100,0.060000
2025-09-17,American Water Works,46,46,8,100,0.080000
2025-09-17,Americold Realty Trust,74,18,8,100,0.080000
2025-09-17,Ameriprise Financial,55,37,8,100,0.080000
2025-09-17,Ametek,55,39,6,100,0.060000
2025-09-17,Amgen,42,48,10,100,0.100000
2025-09-17,Amica Mutual Insurance,29,55,4,88,0.045455
2025-09-17,Amkor Technology,35,58,7,100,0.070000
2025-09-17,Amphenol,52,47,1,100,0.010000
2025-09-17,Analog Devices,41,53,6,100,0.060000
2025-09-17,Antero Resources,40,51,9,100,0.090000
2025-09-17,Anywhere Real Estate Inc,42,46,12,100,0.120000
2025-09-17,Apollo Global Management,40,53,7,100,0.070000
2025-09-17,AppLovin,35,55,10,100,0.100000
2025-09-17,Apple,39,51,10,100,0.100000
2025-09-17,Applied Industrial Technologies,38,59,3,100,0.030000
2025-09-17,Applied Materials,26,48,26,100,0.260000
2025-09-17,AptarGroup,45,53,2,100,0.020000
2025-09-17,Aramark,49,44,7,100,0.070000
2025-09-17,ArcBest,30,59,11,100,0.110000
2025-09-17,Arch Resources,64,26,10,100,0.100000
2025-09-17,Archer Daniels Midland,33,49,18,100,0.180000
2025-09-17,Ares Management,48,47,5,100,0.050000
2025-09-17,Arista Networks,35,59,6,100,0.060000
2025-09-17,Arrow Electronics,45,44,11,100,0.110000
2025-09-17,Arthur J Gallagher,39,54,7,100,0.070000
2025-09-17,Asbury Automotive Group,36,53,11,100,0.110000
2025-09-17,Assurant,58,32,10,100,0.100000
2025-09-17,Atkore,37,49,14,100,0.140000
2025-09-17,Atlassian,35,51,14,100,0.140000
2025-09-17,Atmos Energy,92,6,2,100,0.020000
2025-09-17,Auto-Owners Insurance,41,49,10,100,0.100000
2025-09-17,AutoNation,39,47,14,100,0.140000
2025-09-17,AutoZone,19,49,32,100,0.320000
2025-09-17,Autodesk,48,49,3,100,0.030000
2025-09-17,Autoliv,46,44,10,100,0.100000
2025-09-17,Automatic Data Processing,52,43,5,100,0.050000
2025-09-17,AvalonBay Communities,38,53,9,100,0.090000
2025-09-17,Avantor,34,47,19,100,0.190000
2025-09-17,Avery Dennison,42,55,3,100,0.030000
2025-09-17,Avient,33,56,11,100,0.110000
2025-09-17,Avis Budget,23,54,23,100,0.230000
2025-09-17,Avnet,38,55,7,100,0.070000
2025-09-17,BJ's Wholesale Club,40,44,16,100,0.160000
2025-09-17,BOK Financial,44,44,12,100,0.120000
2025-09-17,BWX Technologies,65,33,2,100,0.020000
2025-09-17,Baker Hughes,57,39,4,100,0.040000
2025-09-17,Ball Corporation,44,51,5,100,0.050000
2025-09-17,Bank of America,40,49,11,100,0.110000
2025-09-17,Bank of New York Mellon,60,36,4,100,0.040000
2025-09-17,Bath & Body Works,33,54,13,100,0.130000
2025-09-17,Baxter International,31,56,13,100,0.130000
2025-09-17,Becton Dickinson,51,39,10,100,0.100000
2025-09-17,Belden,35,54,11,100,0.110000
2025-09-17,Benchmark Electronics,42,50,8,100,0.080000
2025-09-17,Berkshire Hathaway,41,38,21,100,0.210000
2025-09-17,Berry Global,28,56,16,100,0.160000
2025-09-17,Best Buy,94,2,4,100,0.040000
2025-09-17,Bio-Rad Laboratories,36,52,12,100,0.120000
2025-09-17,Biogen,43,54,3,100,0.030000
2025-09-17,BlackRock,45,42,13,100,0.130000
2025-09-17,Blackstone,42,51,7,100,0.070000
2025-09-17,Bloomin Brands,20,61,19,100,0.190000
2025-09-17,BlueLinx,32,57,11,100,0.110000
2025-09-17,Boeing,31,49,20,100,0.200000
2025-09-17,Boise Cascade,23,46,31,100,0.310000
2025-09-17,Booking Holdings,43,46,11,100,0.110000
2025-09-17,Booz Allen Hamilton,42,44,14,100,0.140000
2025-09-17,BorgWarner,61,34,5,100,0.050000
2025-09-17,Boston Properties,25,65,10,100,0.100000
2025-09-17,Boston Scientific,38,52,10,100,0.100000
2025-09-17,Boyd Gaming,38,59,3,100,0.030000
2025-09-17,Bread Financial,48,49,3,100,0.030000
2025-09-17,BrightSpring Health Services,41,49,10,100,0.100000
2025-09-17,BrightView Holdings,37,55,8,100,0.080000
2025-09-17,Brighthouse Financial,34,51,15,100,0.150000
2025-09-17,Brinker International,50,44,6,100,0.060000
2025-09-17,Brinks Company,12,3,7,22,0.318182
2025-09-17,Bristol-Myers Squibb,44,41,15,100,0.150000
2025-09-17,Broadcom,46,48,6,100,0.060000
2025-09-17,Broadridge Financial Solutions,86,11,3,100,0.030000
2025-09-17,Brookdale Senior Living,32,51,17,100,0.170000
2025-09-17,Brown & Brown,40,44,16,100,0.160000
2025-09-17,Brown-Forman,25,58,17,100,0.170000
2025-09-17,Bruker,31,49,20,100,0.200000
2025-09-17,Brunswick Corporation,51,35,14,100,0.140000
2025-09-17,Builders FirstSource,46,43,11,100,0.110000
2025-09-17,Burlington Stores,36,61,3,100,0.030000
2025-09-17,CACI International,59,34,7,100,0.070000
2025-09-17,CBRE Group,47,50,3,100,0.030000
2025-09-17,CDW,52,42,6,100,0.060000
2025-09-17,CF Industries,49,45,6,100,0.060000
2025-09-17,CH Robinson Worldwide,47,41,12,100,0.120000
2025-09-17,CHS,48,41,11,100,0.110000
2025-09-17,CIncinnati Financial,37,54,9,100,0.090000
2025-09-17,CME Group,33,61,6,100,0.060000
2025-09-17,CMS Energy,92,6,2,100,0.020000
2025-09-17,CNO Financial Group,37,57,6,100,0.060000
2025-09-17,CNX Resources,53,39,8,100,0.080000
2025-09-17,CSX,46,41,13,100,0.130000
2025-09-17,CVS Health,63,30,7,100,0.070000
2025-09-17,Cabot Corporation,42,51,7,100,0.070000
2025-09-17,Cadence,32,53,15,100,0.150000
2025-09-17,Caesars Entertainment,83,16,1,100,0.010000
2025-09-17,Cal-Maine Foods,59,36,5,100,0.050000
2025-09-17,Caleres Inc,34,50,16,100,0.160000
2025-09-17,California Resources,41,53,6,100,0.060000
2025-09-17,Calumet Inc,41,39,12,92,0.130435
2025-09-17,Campbell Soup,41,45,14,100,0.140000
2025-09-17,Camping World,30,50,20,100,0.200000
2025-09-17,Capital One,47,37,16,100,0.160000
2025-09-17,CarMax,28,57,15,100,0.150000
2025-09-17,Cardinal Health,45,45,10,100,0.100000
2025-09-17,Carlisle Companies,42,46,12,100,0.120000
2025-09-17,Carlyle Group,38,55,7,100,0.070000
2025-09-17,Carpenter Technology,50,47,3,100,0.030000
2025-09-17,Carrier Global,30,53,17,100,0.170000
2025-09-17,Carters Inc,17,19,3,39,0.076923
2025-09-17,Carvana,39,54,7,100,0.070000
2025-09-17,Caseys General Stores,35,53,12,100,0.120000
2025-09-17,Catalent,33,56,11,100,0.110000
2025-09-17,Caterpillar,48,43,9,100,0.090000
2025-09-17,Cboe Global Markets,41,56,3,100,0.030000
2025-09-17,Celanese,31,42,27,100,0.270000
2025-09-17,Cencora,53,37,10,100,0.100000
2025-09-17,Centene,38,41,21,100,0.210000
2025-09-17,CenterPoint Energy,74,10,16,100,0.160000
2025-09-17,Central Garden & Pet,24,73,3,100,0.030000
2025-09-17,Century Communities,34,61,5,100,0.050000
2025-09-17,ChampionX,49,49,2,100,0.020000
2025-09-17,Charles River Laboratories International,29,56,15,100,0.150000
2025-09-17,Charles Schwab,45,46,9,100,0.090000
2025-09-17,Chart Industries,45,50,5,100,0.050000
2025-09-17,Charter Communications,27,53,20,100,0.200000
2025-09-17,Cheesecake Factory,30,49,21,100,0.210000
2025-09-17,Chefs Warehouse,43,50,7,100,0.070000
2025-09-17,Chemours,37,42,21,100,0.210000
2025-09-17,Cheniere Energy,93,7,0,100,0.000000
2025-09-17,Chevron,39,38,23,100,0.230000
2025-09-17,Chewy,40,34,26,100,0.260000
2025-09-17,Chipotle Mexican Grill,28,57,15,100,0.150000
2025-09-17,Chord Energy,91,2,7,100,0.070000
2025-09-17,Church & Dwight,44,50,6,100,0.060000
2025-09-17,Ciena,43,51,6,100,0.060000
2025-09-17,Cigna,46,43,11,100,0.110000
2025-09-17,Cinemark,27,56,17,100,0.170000
2025-09-17,Cintas,54,40,6,100,0.060000
2025-09-17,Cisco Systems,48,46,6,100,0.060000
2025-09-17,Citigroup,36,53,11,100,0.110000
2025-09-17,Citizens Financial Group,39,58,3,100,0.030000
2025-09-17,Civitas Resources,40,30,30,100,0.300000
2025-09-17,Clean Harbors,87,5,8,100,0.080000
2025-09-17,Clear Channel Outdoor Hldgs,8,0,2,10,0.200000
2025-09-17,Cleveland-Cliffs,26,50,24,100,0.240000
2025-09-17,Clorox,46,42,12,100,0.120000
2025-09-17,Cognizant Technology Solutions,86,9,5,100,0.050000
2025-09-17,Coherent,34,54,12,100,0.120000
2025-09-17,Coinbase Global,38,56,6,100,0.060000
2025-09-17,Colgate-Palmolive,35,47,18,100,0.180000
2025-09-17,Columbia Banking System,39,58,3,100,0.030000
2025-09-17,Columbia Sportswear,32,47,21,100,0.210000
2025-09-17,Comcast,51,32,17,100,0.170000
2025-09-17,Comerica,47,41,12,100,0.120000
2025-09-17,Comfort Systems USA,99,0,1,100,0.010000
2025-09-17,CommScope,45,54,1,100,0.010000
2025-09-17,Commercial Metals,39,41,20,100,0.200000
2025-09-17,Community Health Systems,29,52,19,100,0.190000
2025-09-17,Compass Group,40,43,17,100,0.170000
2025-09-17,Conagra Brands,34,51,15,100,0.150000
2025-09-17,Concentrix,42,47,11,100,0.110000
2025-09-17,Conduent,33,43,24,100,0.240000
2025-09-17,ConocoPhillips,46,32,22,100,0.220000
2025-09-17,Consol Energy,80,12,8,100,0.080000
2025-09-17,Consolidated Edison,38,52,10,100,0.100000
2025-09-17,Constellation Brands,29,38,33,100,0.330000
2025-09-17,Constellation Energy,89,7,4,100,0.040000
2025-09-17,Continental Resources,47,38,15,100,0.150000
2025-09-17,Cooper Cos,5,26,6,37,0.162162
2025-09-17,Cooper-Standard,35,57,8,100,0.080000
2025-09-17,Copart,43,50,7,100,0.070000
2025-09-17,Core & Main,32,46,22,100,0.220000
2025-09-17,Corebridge Financial,48,46,6,100,0.060000
2025-09-17,Cornerstone Building Brands,35,55,10,100,0.100000
2025-09-17,Corning,42,41,17,100,0.170000
2025-09-17,Corpay,36,64,0,100,0.000000
2025-09-17,Corteva,34,58,8,100,0.080000
2025-09-17,Costco,40,34,26,100,0.260000
2025-09-17,Coterra Energy,90,4,6,100,0.060000
2025-09-17,Coty,28,43,29,100,0.290000
2025-09-17,Country Financial,29,54,17,100,0.170000
2025-09-17,Coupang,46,39,15,100,0.150000
2025-09-17,Cracker Barrel Old Country Store,23,54,23,100,0.230000
2025-09-17,Crocs,39,50,11,100,0.110000
2025-09-17,CrossAmerica Partners,28,63,9,100,0.090000
2025-09-17,CrowdStrike,45,37,16,98,0.163265
2025-09-17,Crown Castle,47,49,4,100,0.040000
2025-09-17,Crown Holdings,51,41,8,100,0.080000
2025-09-17,Cullen Frost Bankers,55,38,7,100,0.070000
2025-09-17,Cummins Inc,59,36,5,100,0.050000
2025-09-17,Curtiss-Wright,52,43,5,100,0.050000
2025-09-17,DR Horton,52,38,10,100,0.100000
2025-09-17,DTE Energy,79,10,11,100,0.110000
2025-09-17,DXC Technology,39,58,3,100,0.030000
2025-09-17,DaVita,39,33,28,100,0.280000
2025-09-17,Dana Incorporated,40,50,10,100,0.100000
2025-09-17,Danaher,51,43,6,100,0.060000
2025-09-17,Darden Restaurants,39,52,9,100,0.090000
2025-09-17,Darling Ingredients,93,4,3,100,0.030000
2025-09-17,Deckers Outdoor,45,43,12,100,0.120000
2025-09-17,Deere,46,43,11,100,0.110000
2025-09-17,Delek US,51,38,11,100,0.110000
2025-09-17,Dell Technologies,41,54,5,100,0.050000
2025-09-17,Delta Air Lines,15,54,31,100,0.310000
2025-09-17,Dentsply Sirona,34,59,7,100,0.070000
2025-09-17,Designer Brands,26,62,12,100,0.120000
2025-09-17,Devon Energy,96,1,3,100,0.030000
2025-09-17,DexCom,32,51,17,100,0.170000
2025-09-17,Diamondback Energy,89,4,7,100,0.070000
2025-09-17,Dicks Sporting Goods,33,62,5,100,0.050000
2025-09-17,Diebold Nixdorf,42,52,6,100,0.060000
2025-09-17,Digital Realty Trust,89,11,0,100,0.000000
2025-09-17,Dillards,32,46,22,100,0.220000
2025-09-17,Discover Financial,43,45,12,100,0.120000
2025-09-17,DocuSign,44,43,13,100,0.130000
2025-09-17,Dollar General,22,47,31,100,0.310000
2025-09-17,Dollar Tree,47,40,13,100,0.130000
2025-09-17,Dominion Energy,79,14,7,100,0.070000
2025-09-17,Dominos Pizza Inc,10,7,4,21,0.190476
2025-09-17,Domtar,29,57,14,100,0.140000
2025-09-17,Donaldson Company,52,45,3,100,0.030000
2025-09-17,DoorDash,43,32,25,100,0.250000
2025-09-17,Dover Corporation,52,47,1,100,0.010000
2025-09-17,DraftKings,59,34,7,100,0.070000
2025-09-17,Dream Finders Homes,85,11,4,100,0.040000
2025-09-17,Dropbox,38,58,4,100,0.040000
2025-09-17,DuPont,36,47,17,100,0.170000
2025-09-17,Duke Energy,95,2,3,100,0.030000
2025-09-17,Dycom Industries,45,49,6,100,0.060000
2025-09-17,EMCOR Group,47,50,3,100,0.030000
2025-09-17,EOG Resources,45,49,6,100,0.060000
2025-09-17,EPAM Systems,47,44,9,100,0.090000
2025-09-17,EQT,44,52,4,100,0.040000
2025-09-17,ESAB,32,54,14,100,0.140000
2025-09-17,East West Bancorp,46,49,5,100,0.050000
2025-09-17,Eastman Chemical,27,41,32,100,0.320000
2025-09-17,Ebay,37,47,16,100,0.160000
2025-09-17,EchoStar,32,53,14,99,0.141414
2025-09-17,Ecolab,43,50,7,100,0.070000
2025-09-17,Edison International,31,48,21,100,0.210000
2025-09-17,Edward Jones,37,50,13,100,0.130000
2025-09-17,Edwards Lifesciences,46,36,18,100,0.180000
2025-09-17,Elanco Animal Health,41,53,6,100,0.060000
2025-09-17,Electronic Arts,32,54,14,100,0.140000
2025-09-17,Elevance Health,47,35,18,100,0.180000
2025-09-17,Eli Lilly,19,55,25,99,0.252525
2025-09-17,Emerson Electric,51,41,8,100,0.080000
2025-09-17,EnLink Midstream,47,45,8,100,0.080000
2025-09-17,Encompass Health,34,60,6,100,0.060000
2025-09-17,Endeavor Group,28,62,10,100,0.100000
2025-09-17,Endeavor Group Holdings,30,60,10,100,0.100000
2025-09-17,EnerSys,47,45,8,100,0.080000
2025-09-17,Energizer Holdings,93,4,3,100,0.030000
2025-09-17,Energy Transfer,85,5,10,100,0.100000
2025-09-17,Ensign Group,54,41,5,100,0.050000
2025-09-17,Entegris,53,38,9,100,0.090000
2025-09-17,Entergy,54,41,5,100,0.050000
2025-09-17,Enterprise Products Partners,53,30,17,100,0.170000
2025-09-17,Envista,40,55,5,100,0.050000
2025-09-17,Equifax,51,27,22,100,0.220000
2025-09-17,Equinix,50,43,7,100,0.070000
2025-09-17,Equitable Holdings,35,49,16,100,0.160000
2025-09-17,Equity Residential,34,56,10,100,0.100000
2025-09-17,Erie Insurance,37,45,18,100,0.180000
2025-09-17,Estée Lauder,50,40,10,100,0.100000
2025-09-17,Etsy,33,35,32,100,0.320000
2025-09-17,Euronet Worldwide,40,51,9,100,0.090000
2025-09-17,Evergy,50,40,10,100,0.100000
2025-09-17,Eversource Energy,84,8,8,100,0.080000
2025-09-17,Exact Sciences,31,49,20,100,0.200000
2025-09-17,Exelon,46,50,4,100,0.040000
2025-09-17,Expand Energy Corporation,99,0,1,100,0.010000
2025-09-17,Expedia,55,37,8,100,0.080000
2025-09-17,Expeditors International of Washington,44,50,6,100,0.060000
2025-09-17,Extra Space Storage,32,59,9,100,0.090000
2025-09-17,Exxon Mobil,48,39,13,100,0.130000
2025-09-17,F5,44,48,8,100,0.080000
2025-09-17,FM Global,39,35,26,100,0.260000
2025-09-17,FMC Corporation,35,49,16,100,0.160000
2025-09-17,FTI Consulting,32,51,17,100,0.170000
2025-09-17,Fannie Mae,27,62,11,100,0.110000
2025-09-17,Farmers Insurance Exchange,22,44,27,93,0.290323
2025-09-17,Fastenal,37,58,5,100,0.050000
2025-09-17,FedEx,32,49,19,100,0.190000
2025-09-17,Federated Mutual Insurance,19,21,7,47,0.148936
2025-09-17,Ferguson Enterprises,40,54,6,100,0.060000
2025-09-17,Fidelity National Financial,45,44,11,100,0.110000
2025-09-17,Fidelity National Information Services,59,30,11,100,0.110000
2025-09-17,Fifth Third Bancorp,49,37,14,100,0.140000
2025-09-17,First American Financial,36,53,11,100,0.110000
2025-09-17,First Citizens BancShares,43,49,8,100,0.080000
2025-09-17,First Horizon,49,50,1,100,0.010000
2025-09-17,First National of Nebraska,21,27,2,50,0.040000
2025-09-17,First Solar,47,47,6,100,0.060000
2025-09-17,FirstCash,39,47,14,100,0.140000
2025-09-17,FirstEnergy,49,35,16,100,0.160000
2025-09-17,Fiserv,36,55,9,100,0.090000
2025-09-17,Five Below,36,54,10,100,0.100000
2025-09-17,Flagstar Financial,41,49,10,100,0.100000
2025-09-17,Floor & Decor,41,49,10,100,0.100000
2025-09-17,Flowers Foods,35,47,18,100,0.180000
2025-09-17,Flowserve,37,56,7,100,0.070000
2025-09-17,Fluor,39,42,19,100,0.190000
2025-09-17,Foot Locker,16,66,18,100,0.180000
2025-09-17,Ford Motor,24,59,17,100,0.170000
2025-09-17,Fortinet,40,29,31,100,0.310000
2025-09-17,Fortive,39,47,14,100,0.140000
2025-09-17,Fortune Brands Innovations,30,61,9,100,0.090000
2025-09-17,Franklin Resources,44,47,9,100,0.090000
2025-09-17,Freddie Mac,31,60,9,100,0.090000
2025-09-17,Freeport-McMoRan,43,41,16,100,0.160000
2025-09-17,Frontier Airlines,34,51,15,100,0.150000
2025-09-17,Frontier Communications,44,47,9,100,0.090000
2025-09-17,G-III Apparel Group,31,56,13,100,0.130000
2025-09-17,GE HealthCare Technologies,46,46,8,100,0.080000
2025-09-17,GE Vernova,49,42,9,100,0.090000
2025-09-17,GMS,33,59,8,100,0.080000
2025-09-17,GXO Logistics,40,50,10,100,0.100000
2025-09-17,GameStop,44,44,12,100,0.120000
2025-09-17,Gannett,40,49,11,100,0.110000
2025-09-17,Garrett Motion Inc,42,52,6,100,0.060000
2025-09-17,Gartner,29,56,15,100,0.150000
2025-09-17,Gen Digital,56,36,8,100,0.080000
2025-09-17,Generac,42,46,12,100,0.120000
2025-09-17,General Dynamics,96,1,3,100,0.030000
2025-09-17,General Mills,33,60,5,98,0.051020
2025-09-17,General Motors,43,43,14,100,0.140000
2025-09-17,Genesis Energy,84,14,2,100,0.020000
2025-09-17,Genuine Parts,43,50,7,100,0.070000
2025-09-17,Genworth Financial,56,37,7,100,0.070000
2025-09-17,Gilead Sciences,43,48,9,100,0.090000
2025-09-17,Global Partners,41,46,13,100,0.130000
2025-09-17,Global Payments,37,56,7,100,0.070000
2025-09-17,Globe Life,46,43,11,100,0.110000
2025-09-17,GoDaddy,47,47,6,100,0.060000
2025-09-17,Goldman Sachs,39,48,13,100,0.130000
2025-09-17,Goodyear Tire & Rubber,27,62,11,100,0.110000
2025-09-17,Graham Holdings Company,35,57,8,100,0.080000
2025-09-17,Granite Construction,50,46,4,100,0.040000
2025-09-17,Graphic Packaging,35,53,12,100,0.120000
2025-09-17,Gray Television,35,47,18,100,0.180000
2025-09-17,Graybar Electric,19,24,6,49,0.122449
2025-09-17,Green Plains Inc,39,37,24,100,0.240000
2025-09-17,Greenbrier,34,41,25,100,0.250000
2025-09-17,Greif,25,70,5,100,0.050000
2025-09-17,Griffon Corporation,46,44,10,100,0.100000
2025-09-17,Grocery Outlet Holding,34,55,11,100,0.110000
2025-09-17,Group 1 Automotive,36,56,8,100,0.080000
2025-09-17,Guardian Life insurance,51,47,2,100,0.020000
2025-09-17,Guess Inc,35,55,10,100,0.100000
2025-09-17,GuideWell Mutual,22,20,1,43,0.023256
2025-09-17,HB Fuller,31,63,6,100,0.060000
2025-09-17,HCA Healthcare,54,37,9,100,0.090000
2025-09-17,HEICO,42,51,7,100,0.070000
2025-09-17,HF SInclair,37,51,12,100,0.120000
2025-09-17,HP,32,61,7,100,0.070000
2025-09-17,Halliburton,24,50,26,100,0.260000
2025-09-17,Hanesbrands,32,61,7,100,0.070000
2025-09-17,Hanover Insurance Group,43,49,8,100,0.080000
2025-09-17,Harley-Davidson,29,60,11,100,0.110000
2025-09-17,Hasbro,39,49,12,100,0.120000
2025-09-17,Hawaiian Airlines Inc,33,65,2,100,0.020000
2025-09-17,Hawaiian Electric Industries,39,51,10,100,0.100000
2025-09-17,Helmerich & Payne,27,54,19,100,0.190000
2025-09-17,Henry Schein,45,48,7,100,0.070000
2025-09-17,Herc Rentals,42,44,14,100,0.140000
2025-09-17,Hershey,43,50,7,100,0.070000
2025-09-17,Hertz,55,28,17,100,0.170000
2025-09-17,Hewlett Packard Enterprise,34,64,2,100,0.020000
2025-09-17,Hillenbrand,33,57,10,100,0.100000
2025-09-17,Hilton Grand Vacations,92,7,1,100,0.010000
2025-09-17,Hilton Worldwide,53,41,6,100,0.060000
2025-09-17,Hologic,43,51,6,100,0.060000
2025-09-17,Home Depot,25,41,34,100,0.340000
2025-09-17,Honeywell,49,47,4,100,0.040000
2025-09-17,Hormel Foods,31,61,8,100,0.080000
2025-09-17,Host Hotels & Resorts,32,64,4,100,0.040000
2025-09-17,Hovnanian Enterprises,17,47,11,75,0.146667
2025-09-17,Howmet Aerospace,37,55,8,100,0.080000
2025-09-17,Hub Group,33,51,16,100,0.160000
2025-09-17,Hubbell,34,52,14,100,0.140000
2025-09-17,Humana,59,28,13,100,0.130000
2025-09-17,Huntington Bancshares,44,51,5,100,0.050000
2025-09-17,Huntington Ingalls Industries,49,38,13,100,0.130000
2025-09-17,Huntsman,17,50,33,100,0.330000
2025-09-17,Hyatt Hotels,36,58,6,100,0.060000
2025-09-17,Hyster-Yale,32,58,10,100,0.100000
2025-09-17,IAC,37,51,12,100,0.120000
2025-09-17,IBM,46,43,11,100,0.110000
2025-09-17,IDEX,44,45,11,100,0.110000
2025-09-17,IDEXX Laboratories,50,44,6,100,0.060000
2025-09-17,IQVIA,49,43,8,100,0.080000
2025-09-17,ITT,38,51,11,100,0.110000
2025-09-17,Icahn Enterprises,30,45,25,100,0.250000
2025-09-17,Illinois Tool Works,51,39,10,100,0.100000
2025-09-17,Illumina Inc,30,61,9,100,0.090000
2025-09-17,Incyte,46,44,10,100,0.100000
2025-09-17,Ingersoll Rand,52,40,8,100,0.080000
2025-09-17,Ingles Markets,24,50,26,100,0.260000
2025-09-17,Ingram Micro,23,36,41,100,0.410000
2025-09-17,Ingredion,44,51,5,100,0.050000
2025-09-17,Insight Enterprises,36,47,17,100,0.170000
2025-09-17,Insperity,50,36,14,100,0.140000
2025-09-17,Instacart,36,55,9,100,0.090000
2025-09-17,Installed Building Products,31,61,8,100,0.080000
2025-09-17,Intel,32,48,19,99,0.191919
2025-09-17,Interactive Brokers,42,52,6,100,0.060000
2025-09-17,Intercontinental Exchange,43,53,4,100,0.040000
2025-09-17,International Flavors & Fragrances,37,54,9,100,0.090000
2025-09-17,International Paper,22,67,11,100,0.110000
2025-09-17,Interpublic Group,47,45,8,100,0.080000
2025-09-17,Intuit,48,45,7,100,0.070000
2025-09-17,Intuitive Surgical,44,44,12,100,0.120000
2025-09-17,Iron Mountain,30,52,18,100,0.180000
2025-09-17,JB Hunt Transport Services,32,55,13,100,0.130000
2025-09-17,JELD-WEN Holding,33,55,12,100,0.120000
2025-09-17,JM Smucker,37,45,18,100,0.180000
2025-09-17,JPMorgan Chase,50,37,13,100,0.130000
2025-09-17,Jabil,43,51,6,100,0.060000
2025-09-17,Jackson Financial,38,55,7,100,0.070000
2025-09-17,Jacobs Solutions,87,5,8,100,0.080000
2025-09-17,Jefferies Financial,29,55,16,100,0.160000
2025-09-17,JetBlue Airways,44,44,12,100,0.120000
2025-09-17,Johnson & Johnson,43,46,11,100,0.110000
2025-09-17,Jones Lang LaSalle,42,53,5,100,0.050000
2025-09-17,Juniper Networks,35,57,8,100,0.080000
2025-09-17,KB Home,45,38,17,100,0.170000
2025-09-17,KBR,60,32,8,100,0.080000
2025-09-17,KKR & Co,60,36,4,100,0.040000
2025-09-17,KLA,51,33,16,100,0.160000
2025-09-17,Kaiser Aluminum,35,53,12,100,0.120000
2025-09-17,Kellanova,50,41,9,100,0.090000
2025-09-17,Kelly Services Inc,39,51,10,100,0.100000
2025-09-17,Kemper Corporation,44,43,13,100,0.130000
2025-09-17,Kenvue,35,48,17,100,0.170000
2025-09-17,Keurig Dr Pepper,26,61,13,100,0.130000
2025-09-17,KeyCorp,46,51,3,100,0.030000
2025-09-17,Keysight Technologies,47,41,12,100,0.120000
2025-09-17,Kimberly-Clark,34,55,11,100,0.110000
2025-09-17,Kinder Morgan,100,0,0,100,0.000000
2025-09-17,Kirby Corporation,31,59,10,100,0.100000
2025-09-17,Knife River Corporation,36,37,9,82,0.109756
2025-09-17,Knight Swift Transportation,35,49,16,100,0.160000
2025-09-17,Kohl's,34,42,24,100,0.240000
2025-09-17,Kontoor Brands,42,51,7,100,0.070000
2025-09-17,Korn Ferry,52,38,10,100,0.100000
2025-09-17,Kraft Heinz,34,53,13,100,0.130000
2025-09-17,Kroger,46,35,18,99,0.181818
2025-09-17,Kyndryl,45,50,5,100,0.050000
2025-09-17,L3Harris Technologies,57,37,6,100,0.060000
2025-09-17,LCI Industries,43,51,6,100,0.060000
2025-09-17,LKQ,30,60,10,100,0.100000
2025-09-17,LPL Financial,65,33,2,100,0.020000
2025-09-17,Labcorp Holdings,47,47,6,100,0.060000
2025-09-17,Lam Research,57,41,2,100,0.020000
2025-09-17,Lamb Weston,35,54,11,100,0.110000
2025-09-17,Land O'Lakes,36,50,14,100,0.140000
2025-09-17,Landstar System,27,43,30,100,0.300000
2025-09-17,Las Vegas Sands,41,53,6,100,0.060000
2025-09-17,Lear Corporation,45,44,11,100,0.110000
2025-09-17,Leggett & Platt,34,56,10,100,0.100000
2025-09-17,Leidos,48,41,11,100,0.110000
2025-09-17,Lennar,30,62,8,100,0.080000
2025-09-17,Lennox International,36,57,7,100,0.070000
2025-09-17,Levi Strauss,32,63,5,100,0.050000
2025-09-17,Liberty Energy,94,5,1,100,0.010000
2025-09-17,Liberty Media,96,4,0,100,0.000000
2025-09-17,Liberty Mutual Insurance,86,3,11,100,0.110000
2025-09-17,Light & Wonder,30,54,16,100,0.160000
2025-09-17,Lincoln Electric,41,55,4,100,0.040000
2025-09-17,Lincoln National,39,46,15,100,0.150000
2025-09-17,Lithia Motors,39,55,6,100,0.060000
2025-09-17,Live Nation Entertainment,70,21,9,100,0.090000
2025-09-17,Lockheed Martin,50,34,16,100,0.160000
2025-09-17,Loews,39,53,8,100,0.080000
2025-09-17,Louisiana-Pacific Corporation,44,46,10,100,0.100000
2025-09-17,Lowe's,43,38,19,100,0.190000
2025-09-17,Lululemon athletica,27,41,32,100,0.320000
2025-09-17,Lumen Technologies,22,62,16,100,0.160000
2025-09-17,Lyft,33,54,13,100,0.130000
2025-09-17,M&T Bank,45,51,4,100,0.040000
2025-09-17,M/I Homes,28,61,11,100,0.110000
2025-09-17,MDU Resources Group,44,47,9,100,0.090000
2025-09-17,MGM Resorts International,54,41,5,100,0.050000
2025-09-17,MKS Instruments,42,48,10,100,0.100000
2025-09-17,MRC Global,30,62,8,100,0.080000
2025-09-17,MSC Industrial Direct,25,62,13,100,0.130000
2025-09-17,MSCI,37,57,6,100,0.060000
2025-09-17,MYR Group,41,49,10,100,0.100000
2025-09-17,Macys,39,51,10,100,0.100000
2025-09-17,ManpowerGroup,40,43,17,100,0.170000
2025-09-17,Marathon Oil,37,45,18,100,0.180000
2025-09-17,Marathon Petroleum,53,41,6,100,0.060000
2025-09-17,Markel Group,36,54,10,100,0.100000
2025-09-17,Marriott International,48,48,4,100,0.040000
2025-09-17,Marriott Vacations Worldwide,39,50,11,100,0.110000
2025-09-17,Marsh & McLennan,48,44,8,100,0.080000
2025-09-17,Martin Marietta Materials,37,43,20,100,0.200000
2025-09-17,Marvell Technology,34,52,14,100,0.140000
2025-09-17,MasTec,49,48,3,100,0.030000
2025-09-17,Masco,40,52,8,100,0.080000
2025-09-17,Mass Mutual,25,46,7,78,0.089744
2025-09-17,MasterBrand,40,52,8,100,0.080000
2025-09-17,Mastercard,39,52,9,100,0.090000
2025-09-17,Matador Resources,41,47,12,100,0.120000
2025-09-17,Match Group,31,42,27,100,0.270000
2025-09-17,Mativ,29,60,11,100,0.110000
2025-09-17,Matson Inc,45,41,14,100,0.140000
2025-09-17,Mattel,32,51,17,100,0.170000
2025-09-17,Maximus,37,53,10,100,0.100000
2025-09-17,McCormick & Company,43,41,16,100,0.160000
2025-09-17,McDonalds,38,55,7,100,0.070000
2025-09-17,McKesson,50,45,5,100,0.050000
2025-09-17,Medical Mutual of Ohio,29,57,14,100,0.140000
2025-09-17,Merck,27,51,22,100,0.220000
2025-09-17,Mercury General,33,45,22,100,0.220000
2025-09-17,Meritage Homes,31,53,16,100,0.160000
2025-09-17,MetLife,36,55,9,100,0.090000
2025-09-17,Meta Platforms,50,44,6,100,0.060000
2025-09-17,Mettler-Toledo International,42,55,3,100,0.030000
2025-09-17,Microchip Technology,46,46,8,100,0.080000
2025-09-17,Micron Technology,56,35,9,100,0.090000
2025-09-17,Microsoft,47,44,9,100,0.090000
2025-09-17,Middleby,38,53,9,100,0.090000
2025-09-17,MillerKnoll,39,50,11,100,0.110000
2025-09-17,Moderna,36,40,24,100,0.240000
2025-09-17,ModivCare,32,43,25,100,0.250000
2025-09-17,Mohawk Industries,39,50,11,100,0.110000
2025-09-17,Molina Healthcare,44,37,19,100,0.190000
2025-09-17,Molson Coors Beverage,47,35,18,100,0.180000
2025-09-17,Mondelez,40,44,16,100,0.160000
2025-09-17,Monster Beverage,41,45,14,100,0.140000
2025-09-17,Moodys Corporation,4,13,4,21,0.190476
2025-09-17,Moog Inc,47,44,9,100,0.090000
2025-09-17,Morgan Stanley,31,52,17,100,0.170000
2025-09-17,Motorola Solutions,87,6,7,100,0.070000
2025-09-17,Mueller Industries,50,44,6,100,0.060000
2025-09-17,Murphy Oil,38,46,16,100,0.160000
2025-09-17,Murphy USA,42,47,11,100,0.110000
2025-09-17,Mutual of Omaha,43,50,7,100,0.070000
2025-09-17,NCR Atleos,48,50,2,100,0.020000
2025-09-17,NCR Voyix,40,53,7,100,0.070000
2025-09-17,NGL Energy Partners,88,3,9,100,0.090000
2025-09-17,NLV Financial,5,3,2,10,0.200000
2025-09-17,NOV,21,68,11,100,0.110000
2025-09-17,NRG Energy,85,11,4,100,0.040000
2025-09-17,NVR Inc,38,50,12,100,0.120000
2025-09-17,Nasdaq Inc,48,45,7,100,0.070000
2025-09-17,Nationwide Insurance,24,55,21,100,0.210000
2025-09-17,Navient,43,38,19,100,0.190000
2025-09-17,NetApp,47,45,8,100,0.080000
2025-09-17,Netflix,33,51,16,100,0.160000
2025-09-17,NeueHealth,61,35,4,100,0.040000
2025-09-17,New York Life Insurance,41,50,9,100,0.090000
2025-09-17,NewMarket Corporation,26,32,5,63,0.079365
2025-09-17,Newell Brands,28,56,16,100,0.160000
2025-09-17,Newmont,31,59,10,100,0.100000
2025-09-17,News Corp,33,46,21,100,0.210000
2025-09-17,Nexstar Media Group,48,47,5,100,0.050000
2025-09-17,NextEra Energy,95,4,1,100,0.010000
2025-09-17,NiSource,48,36,16,100,0.160000
2025-09-17,Nike,44,43,13,100,0.130000
2025-09-17,Nordson,51,43,6,100,0.060000
2025-09-17,Nordstrom,38,51,11,100,0.110000
2025-09-17,Norfolk Southern,31,52,17,100,0.170000
2025-09-17,Northern Trust,93,4,3,100,0.030000
2025-09-17,Northrop Grumman,35,51,6,92,0.065217
2025-09-17,Northwestern Mutual,45,42,13,100,0.130000
2025-09-17,Nucor,33,53,14,100,0.140000
2025-09-17,Nvidia,26,41,33,100,0.330000
2025-09-17,O'Reilly Automotive,29,47,24,100,0.240000
2025-09-17,O-I Glass,40,48,12,100,0.120000
2025-09-17,ODP Business Solutions,25,34,3,62,0.048387
2025-09-17,OGE Energy,93,4,3,100,0.030000
2025-09-17,ON Semiconductor,34,51,15,100,0.150000
2025-09-17,Occidental Petroleum,32,52,16,100,0.160000
2025-09-17,Old Dominion Freight Line,44,43,13,100,0.130000
2025-09-17,Old National Bancorp,42,54,4,100,0.040000
2025-09-17,Old Republic International,48,46,6,100,0.060000
2025-09-17,Olin,29,51,20,100,0.200000
2025-09-17,Omnicom Group,49,39,12,100,0.120000
2025-09-17,OneMain,49,49,2,100,0.020000
2025-09-17,Oneok,57,39,4,100,0.040000
2025-09-17,Opendoor Technologies,26,46,20,92,0.217391
2025-09-17,Option Care Health,97,3,0,100,0.000000
2025-09-17,Oracle,47,44,9,100,0.090000
2025-09-17,Organon,35,46,19,100,0.190000
2025-09-17,Oscar Health,30,54,16,100,0.160000
2025-09-17,Oshkosh Corporation,46,44,10,100,0.100000
2025-09-17,Otis Worldwide,37,49,14,100,0.140000
2025-09-17,Ovintiv,53,34,13,100,0.130000
2025-09-17,Owens & Minor,28,49,23,100,0.230000
2025-09-17,Owens Corning,41,56,3,100,0.030000
2025-09-17,PACS Group,35,36,29,100,0.290000
2025-09-17,PBF Energy,81,6,13,100,0.130000
2025-09-17,PC Connection Inc,40,35,6,81,0.074074
2025-09-17,PENN Entertainment,88,9,3,100,0.030000
2025-09-17,PG&E,57,25,18,100,0.180000
2025-09-17,PNC Financial Services,44,51,5,100,0.050000
2025-09-17,PPG Industries,37,53,10,100,0.100000
2025-09-17,PPL Corporation,49,44,7,100,0.070000
2025-09-17,PVH,28,47,25,100,0.250000
2025-09-17,Paccar,46,38,16,100,0.160000
2025-09-17,Pacific Life,40,54,6,100,0.060000
2025-09-17,Packaging Corp of America,18,62,20,100,0.200000
2025-09-17,Palo Alto Networks,43,45,12,100,0.120000
2025-09-17,Par Pacific,38,55,7,100,0.070000
2025-09-17,Paramount Global,18,64,18,100,0.180000
2025-09-17,Park Hotels & Resorts,27,60,13,100,0.130000
2025-09-17,Parker-Hannifin,52,43,5,100,0.050000
2025-09-17,Parsons Corporation,52,34,14,100,0.140000
2025-09-17,Patrick Industries,36,56,8,100,0.080000
2025-09-17,Patterson Companies Inc,19,54,2,75,0.026667
2025-09-17,Patterson-UTI Energy,69,20,11,100,0.110000
2025-09-17,PayPal,33,50,9,92,0.097826
2025-09-17,Paychex,51,42,7,100,0.070000
2025-09-17,Peabody Energy,82,12,6,100,0.060000
2025-09-17,Peloton Interactive,46,42,12,100,0.120000
2025-09-17,Penn Mutual Life Insurance,40,56,4,100,0.040000
2025-09-17,PennyMac Financial Services,47,44,9,100,0.090000
2025-09-17,Penske Automotive,43,53,4,100,0.040000
2025-09-17,PepsiCo,55,38,7,100,0.070000
2025-09-17,Performance Food,40,53,7,100,0.070000
2025-09-17,Permian Resources,52,40,8,100,0.080000
2025-09-17,Petco Health and Wellness,85,8,7,100,0.070000
2025-09-17,Peter Kiewit Sons',7,23,14,44,0.318182
2025-09-17,Pfizer,54,31,15,100,0.150000
2025-09-17,Philip Morris International,37,54,9,100,0.090000
2025-09-17,Phillips 66,49,45,6,100,0.060000
2025-09-17,Pinnacle West Capital,32,46,22,100,0.220000
2025-09-17,Pinterest,47,45,8,100,0.080000
2025-09-17,Pioneer Natural Resources,51,32,17,100,0.170000
2025-09-17,Pitney Bowes,46,49,5,100,0.050000
2025-09-17,Plains GP,40,37,23,100,0.230000
2025-09-17,Playtika Holding,36,46,18,100,0.180000
2025-09-17,Plexus Corp,40,52,8,100,0.080000
2025-09-17,Polaris Inc,50,41,9,100,0.090000
2025-09-17,Pool Corporation,47,42,11,100,0.110000
2025-09-17,Popular Inc,97,2,1,100,0.010000
2025-09-17,Portland General Electric,41,48,11,100,0.110000
2025-09-17,Post Holdings,31,61,8,100,0.080000
2025-09-17,PrIncipal Financial,47,49,4,100,0.040000
2025-09-17,PriceSmart,42,47,11,100,0.110000
2025-09-17,Primerica,46,48,6,100,0.060000
2025-09-17,Primoris Services,51,45,4,100,0.040000
2025-09-17,ProFrac Holding,34,48,18,100,0.180000
2025-09-17,Procter & Gamble,42,44,14,100,0.140000
2025-09-17,Progressive Insurance,34,51,15,100,0.150000
2025-09-17,Prologis,46,48,6,100,0.060000
2025-09-17,Prudential Financial,40,49,11,100,0.110000
2025-09-17,Public Service Enterprise Group,48,45,7,100,0.070000
2025-09-17,Public Storage,38,44,18,100,0.180000
2025-09-17,Publix Super Markets,39,52,9,100,0.090000
2025-09-17,Puget Sound Energy,61,24,15,100,0.150000
2025-09-17,PulteGroup,55,40,5,100,0.050000
2025-09-17,Pure Storage,30,57,13,100,0.130000
2025-09-17,QVC Group,23,64,13,100,0.130000
2025-09-17,QXO Building Products,1,7,2,10,0.200000
2025-09-17,Qorvo,50,39,11,100,0.110000
2025-09-17,Qualcomm,51,43,5,99,0.050505
2025-09-17,Quanta Services,46,50,4,100,0.040000
2025-09-17,Quest Diagnostics,28,43,10,81,0.123457
2025-09-17,QuidelOrtho,37,53,10,100,0.100000
2025-09-17,REV Group,48,42,10,100,0.100000
2025-09-17,RPM International,35,58,7,100,0.070000
2025-09-17,RTX,44,48,8,100,0.080000
2025-09-17,RXO Inc,42,42,16,100,0.160000
2025-09-17,Rackspace Technology,27,57,16,100,0.160000
2025-09-17,Radius Recycling,22,52,26,100,0.260000
2025-09-17,Ralph Lauren,37,61,2,100,0.020000
2025-09-17,Range Resources,50,44,6,100,0.060000
2025-09-17,Raymond James Financial,36,59,5,100,0.050000
2025-09-17,Realty Income,54,35,11,100,0.110000
2025-09-17,Regal Rexnord,41,52,7,100,0.070000
2025-09-17,Regeneron Pharmaceuticals,50,38,12,100,0.120000
2025-09-17,Regions Financial,52,43,5,100,0.050000
2025-09-17,Reinsurance Group of America,40,51,9,100,0.090000
2025-09-17,Reliance Inc,49,40,11,100,0.110000
2025-09-17,Republic Services,35,26,39,100,0.390000
2025-09-17,ResMed,34,62,4,100,0.040000
2025-09-17,Resideo Technologies,47,47,6,100,0.060000
2025-09-17,Restoration Hardware,26,55,19,100,0.190000
2025-09-17,Revvity,41,43,16,100,0.160000
2025-09-17,Rithm Capital,39,48,7,94,0.074468
2025-09-17,Rivian Automotive,30,50,12,92,0.130435
2025-09-17,Robert Half,44,41,15,100,0.150000
2025-09-17,Roblox,31,32,37,100,0.370000
2025-09-17,Rocket Companies,30,60,10,100,0.100000
2025-09-17,Rockwell Automation,42,51,7,100,0.070000
2025-09-17,Roku,51,36,12,99,0.121212
2025-09-17,Rollins Inc,35,62,3,100,0.030000
2025-09-17,Roper Technologies,40,56,4,100,0.040000
2025-09-17,Ross Stores,41,49,10,100,0.100000
2025-09-17,Rush Enterprises,41,48,11,100,0.110000
2025-09-17,Ryder System,54,41,5,100,0.050000
2025-09-17,Ryerson Holding,34,56,10,100,0.100000
2025-09-17,S&P Global,39,55,6,100,0.060000
2025-09-17,SBA Communications,43,48,9,100,0.090000
2025-09-17,SS&C Technologies,45,50,5,100,0.050000
2025-09-17,Sabre Corporation,40,44,16,100,0.160000
2025-09-17,Saia Inc,41,47,12,100,0.120000
2025-09-17,Salesforce,46,28,26,100,0.260000
2025-09-17,Sallie Mae,41,51,8,100,0.080000
2025-09-17,Sally Beauty,97,3,0,100,0.000000
2025-09-17,Sanmina,34,59,7,100,0.070000
2025-09-17,ScanSource,47,46,7,100,0.070000
2025-09-17,Schneider National,40,48,12,100,0.120000
2025-09-17,Science Applications International,36,49,15,100,0.150000
2025-09-17,Scotts Miracle-Gro,40,40,20,100,0.200000
2025-09-17,Seaboard,36,44,20,100,0.200000
2025-09-17,Sealed Air Corporation,36,51,13,100,0.130000
2025-09-17,Securian Financial,38,56,6,100,0.060000
2025-09-17,Select Medical Holdings,33,55,12,100,0.120000
2025-09-17,Selective Insurance Group,40,39,21,100,0.210000
2025-09-17,Sempra,62,36,2,100,0.020000
2025-09-17,Sentry Insurance Group,3,6,0,9,0.000000
2025-09-17,Service Corp International,7,12,5,24,0.208333
2025-09-17,ServiceNow,41,46,13,100,0.130000
2025-09-17,Sherwin-Williams,30,49,21,100,0.210000
2025-09-17,Shift4 Payments,37,49,14,100,0.140000
2025-09-17,Silgan,29,48,23,100,0.230000
2025-09-17,Simon Property Group,40,49,11,100,0.110000
2025-09-17,Sinclair,28,57,15,100,0.150000
2025-09-17,Sirius XM,32,59,9,100,0.090000
2025-09-17,SiteOne Landscape Supply,35,52,13,100,0.130000
2025-09-17,Skechers USA,32,62,6,100,0.060000
2025-09-17,SkyWest,30,43,27,100,0.270000
2025-09-17,Skyline Champion,37,9,3,49,0.061224
2025-09-17,Skyworks Solutions,73,16,11,100,0.110000
2025-09-17,Smurfit Westrock,23,62,15,100,0.150000
2025-09-17,Snap Inc,36,39,25,100,0.250000
2025-09-17,Snap-on,20,64,16,100,0.160000
2025-09-17,Snowflake Inc,49,50,1,100,0.010000
2025-09-17,Solventum,38,55,7,100,0.070000
2025-09-17,Sonic Automotive,23,67,10,100,0.100000
2025-09-17,Sonoco Products,38,49,13,100,0.130000
2025-09-17,Southern Company,50,46,4,100,0.040000
2025-09-17,Southwest Airlines,29,55,16,100,0.160000
2025-09-17,Southwest Gas Holdings,49,44,7,100,0.070000
2025-09-17,SpartanNash,33,63,4,100,0.040000
2025-09-17,Spectrum Brands,33,48,19,100,0.190000
2025-09-17,Spire Inc,55,37,8,100,0.080000
2025-09-17,Spirit AeroSystems,81,7,12,100,0.120000
2025-09-17,Spirit Airlines,72,8,20,100,0.200000
2025-09-17,Splunk,39,44,17,100,0.170000
2025-09-17,Sprouts Farmers Market,32,63,5,100,0.050000
2025-09-17,Stagwell,36,53,11,100,0.110000
2025-09-17,Stanley Black & Decker,33,47,20,100,0.200000
2025-09-17,Starbucks,31,52,17,100,0.170000
2025-09-17,State Farm Insurance,27,44,29,100,0.290000
2025-09-17,State Street,35,51,14,100,0.140000
2025-09-17,Steel Dynamics,91,6,3,100,0.030000
2025-09-17,Steelcase,35,63,2,100,0.020000
2025-09-17,Stericycle,21,19,60,100,0.600000
2025-09-17,Stifel Financial,55,39,6,100,0.060000
2025-09-17,StoneX Group,45,52,3,100,0.030000
2025-09-17,Stryker,43,43,14,100,0.140000
2025-09-17,Summit Materials,28,63,9,100,0.090000
2025-09-17,Sun Communities,41,46,13,100,0.130000
2025-09-17,Super Micro Computer,92,4,4,100,0.040000
2025-09-17,Surgery Partners,33,57,8,98,0.081633
2025-09-17,Sylvamo,26,53,21,100,0.210000
2025-09-17,Synchrony Financial,59,33,8,100,0.080000
2025-09-17,Synopsys,38,32,30,100,0.300000
2025-09-17,Synovus Financial,48,47,5,100,0.050000
2025-09-17,Sysco,53,38,9,100,0.090000
2025-09-17,T Rowe Price,41,58,1,100,0.010000
2025-09-17,TD Synnex,57,42,1,100,0.010000
2025-09-17,TEGNA,36,58,6,100,0.060000
2025-09-17,THOR Industries,28,56,16,100,0.160000
2025-09-17,TIAA,30,54,16,100,0.160000
2025-09-17,TJX,51,43,6,100,0.060000
2025-09-17,Take-Two Interactive Software,37,52,11,100,0.110000
2025-09-17,Talen Energy,96,3,1,100,0.010000
2025-09-17,Tapestry,34,55,11,100,0.110000
2025-09-17,Targa Resources,51,42,7,100,0.070000
2025-09-17,Target Corporation,32,57,11,100,0.110000
2025-09-17,Taylor Morrison Home,44,50,6,100,0.060000
2025-09-17,Teladoc Health,37,53,10,100,0.100000
2025-09-17,Teledyne Technologies,50,47,3,100,0.030000
2025-09-17,Teleflex,37,56,7,100,0.070000
2025-09-17,Telephone & Data Systems,11,19,2,32,0.062500
2025-09-17,TelevisaUnivision,34,48,18,100,0.180000
2025-09-17,Tempur Sealy International,43,43,14,100,0.140000
2025-09-17,Tenet Healthcare,51,36,13,100,0.130000
2025-09-17,Teradyne,48,48,4,100,0.040000
2025-09-17,Terex,32,58,10,100,0.100000
2025-09-17,Tesla,29,41,30,100,0.300000
2025-09-17,Tetra Tech,54,40,6,100,0.060000
2025-09-17,Texas Instruments,29,57,14,100,0.140000
2025-09-17,Texas Roadhouse,33,47,20,100,0.200000
2025-09-17,Textron,43,47,10,100,0.100000
2025-09-17,The Andersons Inc,27,70,3,100,0.030000
2025-09-17,The Coca-Cola Company,37,56,7,100,0.070000
2025-09-17,The Hartford,35,43,22,100,0.220000
2025-09-17,The Mosaic Company,39,43,18,100,0.180000
2025-09-17,Thermo Fisher Scientific,45,48,7,100,0.070000
2025-09-17,Thrivent Financial for Lutherans,36,46,8,90,0.088889
2025-09-17,Timken,29,57,14,100,0.140000
2025-09-17,Titan Machinery,30,54,16,100,0.160000
2025-09-17,Toast Inc,49,44,7,100,0.070000
2025-09-17,Toll Brothers,26,69,5,100,0.050000
2025-09-17,TopBuild,37,63,0,100,0.000000
2025-09-17,Topgolf Callaway Brands,28,53,19,100,0.190000
2025-09-17,Toro Company,35,58,7,100,0.070000
2025-09-17,Tractor Supply,34,62,4,100,0.040000
2025-09-17,TransDigm,49,37,14,100,0.140000
2025-09-17,TransUnion,37,36,27,100,0.270000
2025-09-17,Travelers Insurance,36,39,25,100,0.250000
2025-09-17,TreeHouse Foods,27,52,21,100,0.210000
2025-09-17,Tri Pointe Homes,37,61,2,100,0.020000
2025-09-17,TriNet Group,38,52,10,100,0.100000
2025-09-17,Trimble Inc,44,51,5,100,0.050000
2025-09-17,Trinity Industries,33,45,22,100,0.220000
2025-09-17,TruStage,58,34,8,100,0.080000
2025-09-17,Truist Financial,41,57,2,100,0.020000
2025-09-17,Tutor Perini Corporation,64,34,2,100,0.020000
2025-09-17,Twilio,52,42,6,100,0.060000
2025-09-17,Tyson Foods,28,49,23,100,0.230000
2025-09-17,U-Haul,15,29,56,100,0.560000
2025-09-17,UFP Industries,30,59,11,100,0.110000
2025-09-17,UGI Utilities Inc,29,32,16,77,0.207792
2025-09-17,UL Solutions,89,4,7,100,0.070000
2025-09-17,UPS,40,35,25,100,0.250000
2025-09-17,US Bancorp,53,43,4,100,0.040000
2025-09-17,US Foods,45,50,5,100,0.050000
2025-09-17,USAA,42,38,20,100,0.200000
2025-09-17,Uber,33,44,23,100,0.230000
2025-09-17,Ulta Beauty,89,7,4,100,0.040000
2025-09-17,Under Armour,27,60,13,100,0.130000
2025-09-17,Union Pacific,39,49,12,100,0.120000
2025-09-17,United Airlines,81,6,12,99,0.121212
2025-09-17,United Natural Foods,80,13,7,100,0.070000
2025-09-17,United Rentals,98,1,1,100,0.010000
2025-09-17,United States Steel,61,33,6,100,0.060000
2025-09-17,UnitedHealth,44,43,13,100,0.130000
2025-09-17,Universal Corporation,41,52,7,100,0.070000
2025-09-17,Universal Health Services,40,47,13,100,0.130000
2025-09-17,Unum Group,46,40,14,100,0.140000
2025-09-17,Upbound Group,53,43,4,100,0.040000
2025-09-17,Urban Outfitters,47,49,4,100,0.040000
2025-09-17,V2X,59,38,3,100,0.030000
2025-09-17,VF Corporation,26,46,20,92,0.217391
2025-09-17,VICI Properties,35,60,5,100,0.050000
2025-09-17,Vail Resorts,26,51,23,100,0.230000
2025-09-17,Valero Energy,86,8,6,100,0.060000
2025-09-17,Valley National Bancorp,30,58,12,100,0.120000
2025-09-17,Valmont Industries,48,46,6,100,0.060000
2025-09-17,Valvoline Inc,35,60,5,100,0.050000
2025-09-17,Ventas Inc,57,41,2,100,0.020000
2025-09-17,Verisk Analytics,42,42,16,100,0.160000
2025-09-17,Verizon,42,42,16,100,0.160000
2025-09-17,Vertex Pharmaceuticals,45,35,20,100,0.200000
2025-09-17,Vertiv,60,36,4,100,0.040000
2025-09-17,Viasat,40,51,9,100,0.090000
2025-09-17,Viatris,35,44,21,100,0.210000
2025-09-17,Victorias Secret,32,43,25,100,0.250000
2025-09-17,Visa Inc,59,35,6,100,0.060000
2025-09-17,Vishay Intertechnology,36,48,16,100,0.160000
2025-09-17,Vista Outdoor,23,57,20,100,0.200000
2025-09-17,Visteon,50,44,6,100,0.060000
2025-09-17,Vistra,56,37,7,100,0.070000
2025-09-17,Vontier,37,54,9,100,0.090000
2025-09-17,Voya Financial,59,37,4,100,0.040000
2025-09-17,Vulcan Materials,37,44,19,100,0.190000
2025-09-17,WEC Energy,91,5,4,100,0.040000
2025-09-17,WESCO International,47,47,6,100,0.060000
2025-09-17,WEX,46,45,9,100,0.090000
2025-09-17,WR Berkley,39,52,9,100,0.090000
2025-09-17,WW Grainger,49,41,10,100,0.100000
2025-09-17,Wabash National,32,37,31,100,0.310000
2025-09-17,Walmart,34,43,23,100,0.230000
2025-09-17,Walt Disney,48,44,8,100,0.080000
2025-09-17,Warner Bros Discovery,17,59,24,100,0.240000
2025-09-17,Warner Music Group,25,64,11,100,0.110000
2025-09-17,Waters Corporation,42,50,8,100,0.080000
2025-09-17,Watsco,33,44,23,100,0.230000
2025-09-17,Wayfair,49,44,7,100,0.070000
2025-09-17,Webster Financial,39,50,11,100,0.110000
2025-09-17,Weis Markets,26,62,12,100,0.120000
2025-09-17,Wells Fargo,85,5,10,100,0.100000
2025-09-17,Welltower,68,29,3,100,0.030000
2025-09-17,Werner Enterprises,41,39,20,100,0.200000
2025-09-17,West Pharmaceutical Services,39,51,10,100,0.100000
2025-09-17,Western & Southern Financial,35,60,5,100,0.050000
2025-09-17,Western Alliance Bancorp,26,35,28,89,0.314607
2025-09-17,Western Digital,46,40,14,100,0.140000
2025-09-17,Western Midstream Partners,50,41,9,100,0.090000
2025-09-17,Western Union,26,66,8,100,0.080000
2025-09-17,Westinghouse Air Brake Technologies,38,47,15,100,0.150000
2025-09-17,Weyerhaeuser,34,53,13,100,0.130000
2025-09-17,Whirlpool,34,44,22,100,0.220000
2025-09-17,Williams Companies,55,38,7,100,0.070000
2025-09-17,Williams-Sonoma,40,51,9,100,0.090000
2025-09-17,Winnebago Industries,29,55,16,100,0.160000
2025-09-17,Wintrust Financial,42,55,3,100,0.030000
2025-09-17,Woodward Inc,38,56,6,100,0.060000
2025-09-17,Workday,37,54,7,98,0.071429
2025-09-17,World Kinect,41,47,12,100,0.120000
2025-09-17,Worthington Enterprises,39,55,6,100,0.060000
2025-09-17,Wynn Resorts,33,45,22,100,0.220000
2025-09-17,XPO,36,50,14,100,0.140000
2025-09-17,Xcel Energy,84,12,4,100,0.040000
2025-09-17,Xerox,32,52,16,100,0.160000
2025-09-17,Xylem Inc,51,44,5,100,0.050000
2025-09-17,Yum Brands,24,63,13,100,0.130000
2025-09-17,Yum China,45,41,14,100,0.140000
2025-09-17,Zebra Technologies,44,46,10,100,0.100000
2025-09-17,Zimmer Biomet,42,52,6,100,0.060000
2025-09-17,Zions Bancorp,43,40,17,100,0.170000
2025-09-17,Zoetis,61,35,4,100,0.040000
2025-09-17,Zoom Video Communications,32,49,19,100,0.190000
2025-09-17,eXp World,32,59,9,100,0.090000
2025-09-17,iHeartMedia,40,53,7,100,0.070000
2025-09-18,3M,14,16,10,40,0.250000
2025-09-18,A O Smith,12,28,0,40,0.000000
2025-09-18,A-Mark Precious Metals,39,1,0,40,0.000000
2025-09-18,ABM Industries,10,20,10,40,0.250000
2025-09-18,ADT,19,18,3,40,0.075000
2025-09-18,AECOM,23,16,1,40,0.025000
2025-09-18,AES,16,19,5,40,0.125000
2025-09-18,AGCO,15,19,6,40,0.150000
2025-09-18,AGNC Investment,15,20,5,40,0.125000
2025-09-18,AIG,10,26,4,40,0.100000
2025-09-18,AMC Entertainment,35,3,2,40,0.050000
2025-09-18,AMC Networks,13,18,9,40,0.225000
2025-09-18,AMN Healthcare Services,11,21,8,40,0.200000
2025-09-18,APA,15,19,6,40,0.150000
2025-09-18,APi Group,22,16,2,40,0.050000
2025-09-18,ARKO,12,26,2,40,0.050000
2025-09-18,ASGN,15,19,6,40,0.150000
2025-09-18,AT&T,19,15,6,40,0.150000
2025-09-18,ATI Inc,23,14,3,40,0.075000
2025-09-18,AbbVie,12,19,9,40,0.225000
2025-09-18,Abbott Laboratories,24,15,1,40,0.025000
2025-09-18,Abercrombie & Fitch,15,21,4,40,0.100000
2025-09-18,Academy Sports and Outdoors,15,22,3,40,0.075000
2025-09-18,Acadia Healthcare,9,23,8,40,0.200000
2025-09-18,Ace Hardware,15,17,8,40,0.200000
2025-09-18,Acuity Inc,19,19,2,40,0.050000
2025-09-18,Adams Resources & Energy,17,5,2,24,0.083333
2025-09-18,AdaptHealth,15,18,7,40,0.175000
2025-09-18,Adobe,17,20,3,40,0.075000
2025-09-18,Advance Auto Parts,8,23,9,40,0.225000
2025-09-18,Advanced Drainage Systems,37,1,2,40,0.050000
2025-09-18,Advanced Micro Devices,33,4,3,40,0.075000
2025-09-18,Advantage Solutions,36,1,3,40,0.075000
2025-09-18,Aflac,12,18,10,40,0.250000
2025-09-18,Agilent Technologies,30,8,2,40,0.050000
2025-09-18,Agilon Health,10,24,6,40,0.150000
2025-09-18,Air Lease,18,21,1,40,0.025000
2025-09-18,Air Products & Chemicals,14,22,4,40,0.100000
2025-09-18,Airbnb,16,20,4,40,0.100000
2025-09-18,Akamai Technologies,26,9,5,40,0.125000
2025-09-18,Alaska Air,19,9,12,40,0.300000
2025-09-18,Albemarle Corporation,13,21,6,40,0.150000
2025-09-18,Albertsons,20,15,5,40,0.125000
2025-09-18,Alcoa Corporation,8,25,7,40,0.175000
2025-09-18,Alexandria Real Estate Equities,21,17,2,40,0.050000
2025-09-18,Alight Solutions,16,20,4,40,0.100000
2025-09-18,Align Technology,14,19,7,40,0.175000
2025-09-18,Allegiant Travel Company,19,18,3,40,0.075000
2025-09-18,Alliance Resource Partners,15,16,9,40,0.225000
2025-09-18,Alliant Energy,36,3,1,40,0.025000
2025-09-18,Allison Transmission,10,25,5,40,0.125000
2025-09-18,Allstate,26,8,6,40,0.150000
2025-09-18,Ally Financial,13,24,3,40,0.075000
2025-09-18,Alpha Metallurgical Resources,19,14,7,40,0.175000
2025-09-18,Alphabet,18,15,7,40,0.175000
2025-09-18,Altice USA,16,17,7,40,0.175000
2025-09-18,Altria,24,15,1,40,0.025000
2025-09-18,Amazon,30,2,8,40,0.200000
2025-09-18,Ameren,15,23,2,40,0.050000
2025-09-18,American Airlines,17,12,11,40,0.275000
2025-09-18,American Axle & Manufacturing,12,24,4,40,0.100000
2025-09-18,American Eagle Outfitters,16,16,8,40,0.200000
2025-09-18,American Electric Power,22,13,5,40,0.125000
2025-09-18,American Express,20,17,3,40,0.075000
2025-09-18,American Family Insurance,22,14,4,40,0.100000
2025-09-18,American Financial Group,14,24,2,40,0.050000
2025-09-18,American Tower,23,15,2,40,0.050000
2025-09-18,American Water Works,20,16,4,40,0.100000
2025-09-18,Americold Realty Trust,37,2,1,40,0.025000
2025-09-18,Ameriprise Financial,23,16,1,40,0.025000
2025-09-18,Ametek,27,11,2,40,0.050000
2025-09-18,Amgen,23,16,1,40,0.025000
2025-09-18,Amica Mutual Insurance,13,25,2,40,0.050000
2025-09-18,Amkor Technology,14,24,2,40,0.050000
2025-09-18,Amphenol,20,19,1,40,0.025000
2025-09-18,Analog Devices,19,19,2,40,0.050000
2025-09-18,Antero Resources,16,21,3,40,0.075000
2025-09-18,Anywhere Real Estate Inc,18,17,5,40,0.125000
2025-09-18,Apollo Global Management,16,21,3,40,0.075000
2025-09-18,AppLovin,16,21,3,40,0.075000
2025-09-18,Apple,10,24,6,40,0.150000
2025-09-18,Applied Industrial Technologies,18,22,0,40,0.000000
2025-09-18,Applied Materials,10,14,16,40,0.400000
2025-09-18,AptarGroup,18,21,1,40,0.025000
2025-09-18,Aramark,24,16,0,40,0.000000
2025-09-18,ArcBest,16,19,5,40,0.125000
2025-09-18,Arch Resources,31,6,3,40,0.075000
2025-09-18,Archer Daniels Midland,11,18,11,40,0.275000
2025-09-18,Ares Management,24,15,1,40,0.025000
2025-09-18,Arista Networks,17,21,2,40,0.050000
2025-09-18,Arrow Electronics,17,22,1,40,0.025000
2025-09-18,Arthur J Gallagher,24,16,0,40,0.000000
2025-09-18,Asbury Automotive Group,9,26,5,40,0.125000
2025-09-18,Assurant,22,14,4,40,0.100000
2025-09-18,Atkore,22,15,3,40,0.075000
2025-09-18,Atlassian,8,25,7,40,0.175000
2025-09-18,Atmos Energy,36,3,1,40,0.025000
2025-09-18,Auto-Owners Insurance,16,18,6,40,0.150000
2025-09-18,AutoNation,21,16,3,40,0.075000
2025-09-18,AutoZone,10,21,9,40,0.225000
2025-09-18,Autodesk,21,17,2,40,0.050000
2025-09-18,Autoliv,22,14,4,40,0.100000
2025-09-18,Automatic Data Processing,23,14,3,40,0.075000
2025-09-18,AvalonBay Communities,13,25,2,40,0.050000
2025-09-18,Avantor,16,16,8,40,0.200000
2025-09-18,Avery Dennison,24,15,1,40,0.025000
2025-09-18,Avient,13,20,7,40,0.175000
2025-09-18,Avis Budget,13,19,8,40,0.200000
2025-09-18,Avnet,16,23,1,40,0.025000
2025-09-18,BJ's Wholesale Club,20,11,9,40,0.225000
2025-09-18,BOK Financial,22,14,4,40,0.100000
2025-09-18,BWX Technologies,28,10,2,40,0.050000
2025-09-18,Baker Hughes,28,11,1,40,0.025000
2025-09-18,Ball Corporation,16,22,2,40,0.050000
2025-09-18,Bank of America,17,22,1,40,0.025000
2025-09-18,Bank of New York Mellon,22,14,4,40,0.100000
2025-09-18,Bath & Body Works,19,14,7,40,0.175000
2025-09-18,Baxter International,17,19,4,40,0.100000
2025-09-18,Becton Dickinson,28,10,2,40,0.050000
2025-09-18,Belden,14,22,4,40,0.100000
2025-09-18,Benchmark Electronics,19,17,4,40,0.100000
2025-09-18,Berkshire Hathaway,19,10,11,40,0.275000
2025-09-18,Berry Global,10,21,9,40,0.225000
2025-09-18,Best Buy,39,0,1,40,0.025000
2025-09-18,Bio-Rad Laboratories,16,19,5,40,0.125000
2025-09-18,Biogen,17,15,8,40,0.200000
2025-09-18,BlackRock,18,21,1,40,0.025000
2025-09-18,Blackstone,17,22,1,40,0.025000
2025-09-18,Bloomin Brands,8,25,7,40,0.175000
2025-09-18,BlueLinx,13,22,5,40,0.125000
2025-09-18,Boeing,12,15,13,40,0.325000
2025-09-18,Boise Cascade,15,12,13,40,0.325000
2025-09-18,Booking Holdings,24,10,6,40,0.150000
2025-09-18,Booz Allen Hamilton,23,16,1,40,0.025000
2025-09-18,BorgWarner,21,16,3,40,0.075000
2025-09-18,Boston Properties,11,23,6,40,0.150000
2025-09-18,Boston Scientific,15,22,3,40,0.075000
2025-09-18,Boyd Gaming,17,22,1,40,0.025000
2025-09-18,Bread Financial,22,17,1,40,0.025000
2025-09-18,BrightSpring Health Services,14,23,3,40,0.075000
2025-09-18,BrightView Holdings,23,14,3,40,0.075000
2025-09-18,Brighthouse Financial,13,23,4,40,0.100000
2025-09-18,Brinker International,19,19,2,40,0.050000
2025-09-18,Brinks Company,13,3,7,23,0.304348
2025-09-18,Bristol-Myers Squibb,13,21,6,40,0.150000
2025-09-18,Broadcom,18,19,3,40,0.075000
2025-09-18,Broadridge Financial Solutions,36,4,0,40,0.000000
2025-09-18,Brookdale Senior Living,14,18,8,40,0.200000
2025-09-18,Brown & Brown,17,18,5,40,0.125000
2025-09-18,Brown-Forman,13,21,6,40,0.150000
2025-09-18,Bruker,17,15,8,40,0.200000
2025-09-18,Brunswick Corporation,25,14,1,40,0.025000
2025-09-18,Builders FirstSource,22,14,4,40,0.100000
2025-09-18,Burlington Stores,13,24,3,40,0.075000
2025-09-18,CACI International,27,11,2,40,0.050000
2025-09-18,CBRE Group,18,22,0,40,0.000000
2025-09-18,CDW,24,16,0,40,0.000000
2025-09-18,CF Industries,29,10,1,40,0.025000
2025-09-18,CH Robinson Worldwide,22,17,1,40,0.025000
2025-09-18,CHS,19,16,5,40,0.125000
2025-09-18,CIncinnati Financial,18,20,2,40,0.050000
2025-09-18,CME Group,16,22,2,40,0.050000
2025-09-18,CMS Energy,36,4,0,40,0.000000
2025-09-18,CNO Financial Group,18,22,0,40,0.000000
2025-09-18,CNX Resources,20,18,2,40,0.050000
2025-09-18,CSX,20,15,5,40,0.125000
2025-09-18,CVS Health,22,13,5,40,0.125000
2025-09-18,Cabot Corporation,18,21,1,40,0.025000
2025-09-18,Cadence,11,25,4,40,0.100000
2025-09-18,Caesars Entertainment,17,12,11,40,0.275000
2025-09-18,Cal-Maine Foods,28,12,0,40,0.000000
2025-09-18,Caleres Inc,22,13,5,40,0.125000
2025-09-18,California Resources,15,21,4,40,0.100000
2025-09-18,Calumet Inc,20,13,7,40,0.175000
2025-09-18,Campbell Soup,15,15,10,40,0.250000
2025-09-18,Camping World,9,23,8,40,0.200000
2025-09-18,Capital One,16,18,6,40,0.150000
2025-09-18,CarMax,7,28,5,40,0.125000
2025-09-18,Cardinal Health,21,17,2,40,0.050000
2025-09-18,Carlisle Companies,22,14,4,40,0.100000
2025-09-18,Carlyle Group,13,24,3,40,0.075000
2025-09-18,Carpenter Technology,26,13,1,40,0.025000
2025-09-18,Carrier Global,10,19,11,40,0.275000
2025-09-18,Carters Inc,17,18,3,38,0.078947
2025-09-18,Carvana,13,26,1,40,0.025000
2025-09-18,Caseys General Stores,10,24,6,40,0.150000
2025-09-18,Catalent,9,27,4,40,0.100000
2025-09-18,Caterpillar,23,12,5,40,0.125000
2025-09-18,Cboe Global Markets,18,17,5,40,0.125000
2025-09-18,Celanese,15,16,9,40,0.225000
2025-09-18,Cencora,30,7,3,40,0.075000
2025-09-18,Centene,22,14,4,40,0.100000
2025-09-18,CenterPoint Energy,31,3,6,40,0.150000
2025-09-18,Central Garden & Pet,8,30,2,40,0.050000
2025-09-18,Century Communities,13,25,2,40,0.050000
2025-09-18,ChampionX,22,18,0,40,0.000000
2025-09-18,Charles River Laboratories International,18,19,3,40,0.075000
2025-09-18,Charles Schwab,17,18,5,40,0.125000
2025-09-18,Chart Industries,19,21,0,40,0.000000
2025-09-18,Charter Communications,12,16,12,40,0.300000
2025-09-18,Cheesecake Factory,14,21,5,40,0.125000
2025-09-18,Chefs Warehouse,19,17,4,40,0.100000
2025-09-18,Chemours,13,18,9,40,0.225000
2025-09-18,Cheniere Energy,37,3,0,40,0.000000
2025-09-18,Chevron,12,18,10,40,0.250000
2025-09-18,Chewy,17,15,8,40,0.200000
2025-09-18,Chipotle Mexican Grill,13,22,5,40,0.125000
2025-09-18,Chord Energy,37,1,2,40,0.050000
2025-09-18,Church & Dwight,22,17,1,40,0.025000
2025-09-18,Ciena,21,17,2,40,0.050000
2025-09-18,Cigna,17,16,7,40,0.175000
2025-09-18,Cinemark,12,23,5,40,0.125000
2025-09-18,Cintas,25,15,0,40,0.000000
2025-09-18,Cisco Systems,27,10,3,40,0.075000
2025-09-18,Citigroup,13,22,5,40,0.125000
2025-09-18,Citizens Financial Group,13,25,2,40,0.050000
2025-09-18,Civitas Resources,13,17,10,40,0.250000
2025-09-18,Clean Harbors,34,2,4,40,0.100000
2025-09-18,Clear Channel Outdoor Hldgs,8,0,2,10,0.200000
2025-09-18,Cleveland-Cliffs,14,16,10,40,0.250000
2025-09-18,Clorox,25,11,4,40,0.100000
2025-09-18,Cognizant Technology Solutions,38,0,2,40,0.050000
2025-09-18,Coherent,17,20,3,40,0.075000
2025-09-18,Coinbase Global,13,26,1,40,0.025000
2025-09-18,Colgate-Palmolive,13,22,5,40,0.125000
2025-09-18,Columbia Banking System,15,23,2,40,0.050000
2025-09-18,Columbia Sportswear,13,16,11,40,0.275000
2025-09-18,Comcast,18,14,8,40,0.200000
2025-09-18,Comerica,15,18,7,40,0.175000
2025-09-18,Comfort Systems USA,40,0,0,40,0.000000
2025-09-18,CommScope,16,23,1,40,0.025000
2025-09-18,Commercial Metals,15,21,4,40,0.100000
2025-09-18,Community Health Systems,18,17,5,40,0.125000
2025-09-18,Compass Group,16,18,6,40,0.150000
2025-09-18,Conagra Brands,12,26,2,40,0.050000
2025-09-18,Concentrix,13,20,7,40,0.175000
2025-09-18,Conduent,16,16,8,40,0.200000
2025-09-18,ConocoPhillips,20,15,5,40,0.125000
2025-09-18,Consol Energy,34,5,1,40,0.025000
2025-09-18,Consolidated Edison,17,19,4,40,0.100000
2025-09-18,Constellation Brands,16,12,12,40,0.300000
2025-09-18,Constellation Energy,34,4,2,40,0.050000
2025-09-18,Continental Resources,17,13,10,40,0.250000
2025-09-18,Cooper Cos,5,24,6,35,0.171429
2025-09-18,Cooper-Standard,15,25,0,40,0.000000
2025-09-18,Copart,15,24,1,40,0.025000
2025-09-18,Core & Main,13,20,7,40,0.175000
2025-09-18,Corebridge Financial,20,17,3,40,0.075000
2025-09-18,Cornerstone Building Brands,15,18,7,40,0.175000
2025-09-18,Corning,13,17,10,40,0.250000
2025-09-18,Corpay,22,18,0,40,0.000000
2025-09-18,Corteva,12,25,3,40,0.075000
2025-09-18,Costco,11,23,6,40,0.150000
2025-09-18,Coterra Energy,39,0,1,40,0.025000
2025-09-18,Coty,8,18,14,40,0.350000
2025-09-18,Country Financial,12,26,2,40,0.050000
2025-09-18,Coupang,21,14,5,40,0.125000
2025-09-18,Cracker Barrel Old Country Store,7,18,15,40,0.375000
2025-09-18,Crocs,12,25,3,40,0.075000
2025-09-18,CrossAmerica Partners,12,24,4,40,0.100000
2025-09-18,CrowdStrike,15,15,10,40,0.250000
2025-09-18,Crown Castle,16,19,5,40,0.125000
2025-09-18,Crown Holdings,18,19,3,40,0.075000
2025-09-18,Cullen Frost Bankers,20,16,4,40,0.100000
2025-09-18,Cummins Inc,25,15,0,40,0.000000
2025-09-18,Curtiss-Wright,22,17,1,40,0.025000
2025-09-18,DR Horton,27,13,0,40,0.000000
2025-09-18,DTE Energy,33,3,4,40,0.100000
2025-09-18,DXC Technology,20,20,0,40,0.000000
2025-09-18,DaVita,18,10,12,40,0.300000
2025-09-18,Dana Incorporated,20,15,5,40,0.125000
2025-09-18,Danaher,25,14,1,40,0.025000
2025-09-18,Darden Restaurants,9,24,7,40,0.175000
2025-09-18,Darling Ingredients,38,1,1,40,0.025000
2025-09-18,Deckers Outdoor,17,18,5,40,0.125000
2025-09-18,Deere,16,21,3,40,0.075000
2025-09-18,Delek US,19,19,2,40,0.050000
2025-09-18,Dell Technologies,17,21,2,40,0.050000
2025-09-18,Delta Air Lines,6,25,9,40,0.225000
2025-09-18,Dentsply Sirona,12,28,0,40,0.000000
2025-09-18,Designer Brands,13,24,3,40,0.075000
2025-09-18,Devon Energy,37,2,1,40,0.025000
2025-09-18,DexCom,11,16,13,40,0.325000
2025-09-18,Diamondback Energy,35,1,4,40,0.100000
2025-09-18,Dicks Sporting Goods,10,28,2,40,0.050000
2025-09-18,Diebold Nixdorf,17,23,0,40,0.000000
2025-09-18,Digital Realty Trust,37,3,0,40,0.000000
2025-09-18,Dillards,16,14,10,40,0.250000
2025-09-18,Discover Financial,14,20,6,40,0.150000
2025-09-18,DocuSign,24,14,2,40,0.050000
2025-09-18,Dollar General,4,21,15,40,0.375000
2025-09-18,Dollar Tree,12,22,6,40,0.150000
2025-09-18,Dominion Energy,31,7,2,40,0.050000
2025-09-18,Dominos Pizza Inc,19,16,5,40,0.125000
2025-09-18,Domtar,10,22,8,40,0.200000
2025-09-18,Donaldson Company,25,14,1,40,0.025000
2025-09-18,DoorDash,11,25,4,40,0.100000
2025-09-18,Dover Corporation,25,15,0,40,0.000000
2025-09-18,DraftKings,28,7,5,40,0.125000
2025-09-18,Dream Finders Homes,35,3,2,40,0.050000
2025-09-18,Dropbox,11,25,4,40,0.100000
2025-09-18,DuPont,16,18,6,40,0.150000
2025-09-18,Duke Energy,34,2,4,40,0.100000
2025-09-18,Dycom Industries,24,12,4,40,0.100000
2025-09-18,EMCOR Group,14,23,3,40,0.075000
2025-09-18,EOG Resources,23,15,2,40,0.050000
2025-09-18,EPAM Systems,18,19,3,40,0.075000
2025-09-18,EQT,14,19,7,40,0.175000
2025-09-18,ESAB,8,28,4,40,0.100000
2025-09-18,East West Bancorp,20,18,2,40,0.050000
2025-09-18,Eastman Chemical,15,16,9,40,0.225000
2025-09-18,Ebay,17,17,6,40,0.150000
2025-09-18,EchoStar,10,21,9,40,0.225000
2025-09-18,Ecolab,19,19,2,40,0.050000
2025-09-18,Edison International,19,16,5,40,0.125000
2025-09-18,Edward Jones,17,19,4,40,0.100000
2025-09-18,Edwards Lifesciences,22,11,7,40,0.175000
2025-09-18,Elanco Animal Health,14,25,1,40,0.025000
2025-09-18,Electronic Arts,9,25,6,40,0.150000
2025-09-18,Elevance Health,20,14,6,40,0.150000
2025-09-18,Eli Lilly,7,24,9,40,0.225000
2025-09-18,Emerson Electric,22,16,2,40,0.050000
2025-09-18,EnLink Midstream,19,16,5,40,0.125000
2025-09-18,Encompass Health,15,24,1,40,0.025000
2025-09-18,Endeavor Group,13,23,4,40,0.100000
2025-09-18,Endeavor Group Holdings,14,21,5,40,0.125000
2025-09-18,EnerSys,23,17,0,40,0.000000
2025-09-18,Energizer Holdings,40,0,0,40,0.000000
2025-09-18,Energy Transfer,34,3,3,40,0.075000
2025-09-18,Ensign Group,17,19,4,40,0.100000
2025-09-18,Entegris,26,14,0,40,0.000000
2025-09-18,Entergy,24,13,3,40,0.075000
2025-09-18,Enterprise Products Partners,22,13,5,40,0.125000
2025-09-18,Envista,14,22,4,40,0.100000
2025-09-18,Equifax,19,10,11,40,0.275000
2025-09-18,Equinix,25,14,1,40,0.025000
2025-09-18,Equitable Holdings,20,15,5,40,0.125000
2025-09-18,Equity Residential,14,24,2,40,0.050000
2025-09-18,Erie Insurance,14,16,10,40,0.250000
2025-09-18,Estée Lauder,20,16,4,40,0.100000
2025-09-18,Etsy,14,13,13,40,0.325000
2025-09-18,Euronet Worldwide,18,21,1,40,0.025000
2025-09-18,Evergy,22,14,4,40,0.100000
2025-09-18,Eversource Energy,34,4,2,40,0.050000
2025-09-18,Exact Sciences,10,21,9,40,0.225000
2025-09-18,Exelon,18,21,1,40,0.025000
2025-09-18,Expand Energy Corporation,40,0,0,40,0.000000
2025-09-18,Expedia,21,17,2,40,0.050000
2025-09-18,Expeditors International of Washington,22,17,1,40,0.025000
2025-09-18,Extra Space Storage,12,26,2,40,0.050000
2025-09-18,Exxon Mobil,23,15,2,40,0.050000
2025-09-18,F5,26,13,1,40,0.025000
2025-09-18,FM Global,18,14,8,40,0.200000
2025-09-18,FMC Corporation,14,23,3,40,0.075000
2025-09-18,Fannie Mae,11,27,2,40,0.050000
2025-09-18,Farmers Insurance Exchange,10,18,12,40,0.300000
2025-09-18,Fastenal,16,22,2,40,0.050000
2025-09-18,FedEx,12,18,10,40,0.250000
2025-09-18,Federated Mutual Insurance,16,17,7,40,0.175000
2025-09-18,Ferguson Enterprises,18,21,1,40,0.025000
2025-09-18,Fidelity National Financial,20,14,6,40,0.150000
2025-09-18,Fidelity National Information Services,24,10,6,40,0.150000
2025-09-18,Fifth Third Bancorp,16,20,4,40,0.100000
2025-09-18,First American Financial,14,23,3,40,0.075000
2025-09-18,First Citizens BancShares,17,19,4,40,0.100000
2025-09-18,First Horizon,23,17,0,40,0.000000
2025-09-18,First National of Nebraska,17,23,0,40,0.000000
2025-09-18,First Solar,20,20,0,40,0.000000
2025-09-18,FirstCash,15,19,6,40,0.150000
2025-09-18,FirstEnergy,12,19,9,40,0.225000
2025-09-18,Fiserv,19,16,5,40,0.125000
2025-09-18,Five Below,15,18,7,40,0.175000
2025-09-18,Flagstar Financial,14,23,3,40,0.075000
2025-09-18,Floor & Decor,16,18,6,40,0.150000
2025-09-18,Flowers Foods,11,23,6,40,0.150000
2025-09-18,Flowserve,18,19,3,40,0.075000
2025-09-18,Fluor,20,8,12,40,0.300000
2025-09-18,Foot Locker,7,24,9,40,0.225000
2025-09-18,Ford Motor,15,18,7,40,0.175000
2025-09-18,Fortinet,19,13,8,40,0.200000
2025-09-18,Fortive,16,19,5,40,0.125000
2025-09-18,Fortune Brands Innovations,17,20,3,40,0.075000
2025-09-18,Freddie Mac,16,21,3,40,0.075000
2025-09-18,Freeport-McMoRan,18,16,6,40,0.150000
2025-09-18,Frontier Airlines,16,16,8,40,0.200000
2025-09-18,Frontier Communications,15,22,3,40,0.075000
2025-09-18,G-III Apparel Group,14,22,4,40,0.100000
2025-09-18,GE HealthCare Technologies,18,20,2,40,0.050000
2025-09-18,GE Vernova,24,16,0,40,0.000000
2025-09-18,GMS,17,21,2,40,0.050000
2025-09-18,GXO Logistics,13,23,4,40,0.100000
2025-09-18,GameStop,25,7,8,40,0.200000
2025-09-18,Gannett,18,15,7,40,0.175000
2025-09-18,Garrett Motion Inc,17,21,2,40,0.050000
2025-09-18,Gartner,14,23,3,40,0.075000
2025-09-18,Gen Digital,21,16,3,40,0.075000
2025-09-18,Generac,19,18,3,40,0.075000
2025-09-18,General Dynamics,38,0,2,40,0.050000
2025-09-18,General Mills,13,21,6,40,0.150000
2025-09-18,General Motors,14,20,6,40,0.150000
2025-09-18,Genesis Energy,35,3,2,40,0.050000
2025-09-18,Genuine Parts,21,17,2,40,0.050000
2025-09-18,Genworth Financial,22,17,1,40,0.025000
2025-09-18,Gilead Sciences,21,17,2,40,0.050000
2025-09-18,Global Partners,17,18,5,40,0.125000
2025-09-18,Global Payments,16,21,3,40,0.075000
2025-09-18,Globe Life,19,17,4,40,0.100000
2025-09-18,GoDaddy,14,23,3,40,0.075000
2025-09-18,Goldman Sachs,16,15,9,40,0.225000
2025-09-18,Goodyear Tire & Rubber,12,24,4,40,0.100000
2025-09-18,Graham Holdings Company,22,16,2,40,0.050000
2025-09-18,Granite Construction,24,14,2,40,0.050000
2025-09-18,Graphic Packaging,15,17,8,40,0.200000
2025-09-18,Gray Television,13,21,6,40,0.150000
2025-09-18,Graybar Electric,15,19,6,40,0.150000
2025-09-18,Green Plains Inc,22,13,5,40,0.125000
2025-09-18,Greenbrier,13,9,18,40,0.450000
2025-09-18,Greif,12,26,2,40,0.050000
2025-09-18,Griffon Corporation,21,17,2,40,0.050000
2025-09-18,Grocery Outlet Holding,18,21,1,40,0.025000
2025-09-18,Group 1 Automotive,8,27,5,40,0.125000
2025-09-18,Guardian Life insurance,21,19,0,40,0.000000
2025-09-18,Guess Inc,16,21,3,40,0.075000
2025-09-18,GuideWell Mutual,20,19,1,40,0.025000
2025-09-18,HB Fuller,14,21,5,40,0.125000
2025-09-18,HCA Healthcare,27,9,4,40,0.100000
2025-09-18,HEICO,16,18,6,40,0.150000
2025-09-18,HF SInclair,17,21,2,40,0.050000
2025-09-18,HP,11,24,5,40,0.125000
2025-09-18,Halliburton,12,18,10,40,0.250000
2025-09-18,Hanesbrands,15,22,3,40,0.075000
2025-09-18,Hanover Insurance Group,17,20,3,40,0.075000
2025-09-18,Harley-Davidson,15,19,6,40,0.150000
2025-09-18,Hasbro,17,20,3,40,0.075000
2025-09-18,Hawaiian Airlines Inc,15,25,0,40,0.000000
2025-09-18,Hawaiian Electric Industries,17,21,2,40,0.050000
2025-09-18,Helmerich & Payne,9,23,8,40,0.200000
2025-09-18,Henry Schein,17,23,0,40,0.000000
2025-09-18,Herc Rentals,17,17,6,40,0.150000
2025-09-18,Hershey,18,19,3,40,0.075000
2025-09-18,Hertz,27,10,3,40,0.075000
2025-09-18,Hewlett Packard Enterprise,19,21,0,40,0.000000
2025-09-18,Hillenbrand,17,21,2,40,0.050000
2025-09-18,Hilton Grand Vacations,38,1,1,40,0.025000
2025-09-18,Hilton Worldwide,22,16,2,40,0.050000
2025-09-18,Hologic,22,18,0,40,0.000000
2025-09-18,Home Depot,11,16,13,40,0.325000
2025-09-18,Honeywell,15,9,16,40,0.400000
2025-09-18,Hormel Foods,13,26,1,40,0.025000
2025-09-18,Host Hotels & Resorts,15,25,0,40,0.000000
2025-09-18,Hovnanian Enterprises,12,25,3,40,0.075000
2025-09-18,Howmet Aerospace,14,22,4,40,0.100000
2025-09-18,Hub Group,10,21,9,40,0.225000
2025-09-18,Hubbell,18,18,4,40,0.100000
2025-09-18,Humana,21,16,3,40,0.075000
2025-09-18,Huntington Bancshares,16,20,4,40,0.100000
2025-09-18,Huntington Ingalls Industries,22,11,7,40,0.175000
2025-09-18,Huntsman,9,18,13,40,0.325000
2025-09-18,Hyatt Hotels,12,26,2,40,0.050000
2025-09-18,Hyster-Yale,15,20,5,40,0.125000
2025-09-18,IAC,12,23,5,40,0.125000
2025-09-18,IBM,19,15,6,40,0.150000
2025-09-18,IDEX,18,16,6,40,0.150000
2025-09-18,IDEXX Laboratories,20,19,1,40,0.025000
2025-09-18,IQVIA,24,13,3,40,0.075000
2025-09-18,ITT,16,17,7,40,0.175000
2025-09-18,Icahn Enterprises,10,19,11,40,0.275000
2025-09-18,Illinois Tool Works,26,10,4,40,0.100000
2025-09-18,Illumina Inc,9,27,4,40,0.100000
2025-09-18,Incyte,22,16,2,40,0.050000
2025-09-18,Ingersoll Rand,22,14,4,40,0.100000
2025-09-18,Ingles Markets,9,18,13,40,0.325000
2025-09-18,Ingram Micro,14,14,12,40,0.300000
2025-09-18,Ingredion,19,17,4,40,0.100000
2025-09-18,Insight Enterprises,12,19,9,40,0.225000
2025-09-18,Insperity,20,17,3,40,0.075000
2025-09-18,Instacart,11,24,5,40,0.125000
2025-09-18,Installed Building Products,12,27,1,40,0.025000
2025-09-18,Intel,8,29,3,40,0.075000
2025-09-18,Interactive Brokers,23,16,1,40,0.025000
2025-09-18,Intercontinental Exchange,21,18,1,40,0.025000
2025-09-18,International Flavors & Fragrances,16,22,2,40,0.050000
2025-09-18,International Paper,14,21,5,40,0.125000
2025-09-18,Interpublic Group,21,16,3,40,0.075000
2025-09-18,Intuit,21,14,5,40,0.125000
2025-09-18,Intuitive Surgical,19,18,3,40,0.075000
2025-09-18,Iron Mountain,7,22,11,40,0.275000
2025-09-18,JB Hunt Transport Services,12,21,7,40,0.175000
2025-09-18,JELD-WEN Holding,13,20,7,40,0.175000
2025-09-18,JM Smucker,18,20,2,40,0.050000
2025-09-18,JPMorgan Chase,19,17,4,40,0.100000
2025-09-18,Jabil,15,22,3,40,0.075000
2025-09-18,Jackson Financial,19,20,1,40,0.025000
2025-09-18,Jacobs Solutions,33,2,5,40,0.125000
2025-09-18,Jefferies Financial,14,22,4,40,0.100000
2025-09-18,JetBlue Airways,21,18,1,40,0.025000
2025-09-18,Johnson & Johnson,21,14,5,40,0.125000
2025-09-18,Jones Lang LaSalle,18,19,3,40,0.075000
2025-09-18,Juniper Networks,14,23,3,40,0.075000
2025-09-18,KB Home,24,14,2,40,0.050000
2025-09-18,KBR,29,10,1,40,0.025000
2025-09-18,KKR & Co,23,16,1,40,0.025000
2025-09-18,KLA,17,14,9,40,0.225000
2025-09-18,Kaiser Aluminum,15,23,2,40,0.050000
2025-09-18,Kellanova,15,23,2,40,0.050000
2025-09-18,Kelly Services Inc,10,24,6,40,0.150000
2025-09-18,Kemper Corporation,21,14,5,40,0.125000
2025-09-18,Kenvue,17,18,5,40,0.125000
2025-09-18,Keurig Dr Pepper,12,22,6,40,0.150000
2025-09-18,KeyCorp,19,16,5,40,0.125000
2025-09-18,Keysight Technologies,26,12,2,40,0.050000
2025-09-18,Kimberly-Clark,14,20,6,40,0.150000
2025-09-18,Kirby Corporation,17,21,2,40,0.050000
2025-09-18,Knife River Corporation,17,20,3,40,0.075000
2025-09-18,Knight Swift Transportation,18,16,6,40,0.150000
2025-09-18,Kohl's,14,17,9,40,0.225000
2025-09-18,Kontoor Brands,16,22,2,40,0.050000
2025-09-18,Korn Ferry,19,16,5,40,0.125000
2025-09-18,Kraft Heinz,13,22,5,40,0.125000
2025-09-18,Kroger,13,19,8,40,0.200000
2025-09-18,Kyndryl,21,18,1,40,0.025000
2025-09-18,L3Harris Technologies,25,13,2,40,0.050000
2025-09-18,LCI Industries,19,16,5,40,0.125000
2025-09-18,LKQ,14,24,2,40,0.050000
2025-09-18,LPL Financial,28,12,0,40,0.000000
2025-09-18,Labcorp Holdings,24,15,1,40,0.025000
2025-09-18,Lam Research,17,17,6,40,0.150000
2025-09-18,Lamb Weston,14,24,2,40,0.050000
2025-09-18,Land O'Lakes,12,26,2,40,0.050000
2025-09-18,Landstar System,13,17,10,40,0.250000
2025-09-18,Las Vegas Sands,15,25,0,40,0.000000
2025-09-18,Lear Corporation,23,14,3,40,0.075000
2025-09-18,Leggett & Platt,16,20,4,40,0.100000
2025-09-18,Leidos,16,18,6,40,0.150000
2025-09-18,Lennar,9,28,3,40,0.075000
2025-09-18,Lennox International,15,20,5,40,0.125000
2025-09-18,Levi Strauss,11,28,1,40,0.025000
2025-09-18,Liberty Energy,39,1,0,40,0.000000
2025-09-18,Liberty Media,38,2,0,40,0.000000
2025-09-18,Liberty Mutual Insurance,34,1,5,40,0.125000
2025-09-18,Light & Wonder,8,28,4,40,0.100000
2025-09-18,Lincoln Electric,19,21,0,40,0.000000
2025-09-18,Lincoln National,14,15,11,40,0.275000
2025-09-18,Lithia Motors,13,22,5,40,0.125000
2025-09-18,Live Nation Entertainment,34,4,2,40,0.050000
2025-09-18,Lockheed Martin,21,7,12,40,0.300000
2025-09-18,Loews,20,18,2,40,0.050000
2025-09-18,Louisiana-Pacific Corporation,13,22,5,40,0.125000
2025-09-18,Lowe's,16,10,14,40,0.350000
2025-09-18,Lululemon athletica,11,19,10,40,0.250000
2025-09-18,Lumen Technologies,9,23,8,40,0.200000
2025-09-18,Lyft,5,33,2,40,0.050000
2025-09-18,M&T Bank,10,24,6,40,0.150000
2025-09-18,M/I Homes,10,24,6,40,0.150000
2025-09-18,MDU Resources Group,17,20,3,40,0.075000
2025-09-18,MGM Resorts International,23,15,2,40,0.050000
2025-09-18,MKS Instruments,19,20,1,40,0.025000
2025-09-18,MRC Global,17,22,1,40,0.025000
2025-09-18,MSC Industrial Direct,17,21,2,40,0.050000
2025-09-18,MSCI,20,17,3,40,0.075000
2025-09-18,MYR Group,22,16,2,40,0.050000
2025-09-18,Macys,13,21,6,40,0.150000
2025-09-18,ManpowerGroup,18,15,7,40,0.175000
2025-09-18,Marathon Oil,15,21,4,40,0.100000
2025-09-18,Marathon Petroleum,22,15,3,40,0.075000
2025-09-18,Markel Group,22,17,1,40,0.025000
2025-09-18,Marriott International,25,12,3,40,0.075000
2025-09-18,Marriott Vacations Worldwide,20,18,2,40,0.050000
2025-09-18,Marsh & McLennan,22,14,4,40,0.100000
2025-09-18,Martin Marietta Materials,16,17,7,40,0.175000
2025-09-18,Marvell Technology,23,13,4,40,0.100000
2025-09-18,MasTec,18,21,1,40,0.025000
2025-09-18,Masco,15,22,3,40,0.075000
2025-09-18,Mass Mutual,13,23,4,40,0.100000
2025-09-18,MasterBrand,16,22,2,40,0.050000
2025-09-18,Mastercard,25,13,2,40,0.050000
2025-09-18,Matador Resources,22,17,1,40,0.025000
2025-09-18,Match Group,17,13,10,40,0.250000
2025-09-18,Mativ,16,18,6,40,0.150000
2025-09-18,Matson Inc,23,13,4,40,0.100000
2025-09-18,Mattel,18,17,5,40,0.125000
2025-09-18,Maximus,11,23,6,40,0.150000
2025-09-18,McCormick & Company,16,20,4,40,0.100000
2025-09-18,McDonalds,6,29,5,40,0.125000
2025-09-18,McKesson,19,19,2,40,0.050000
2025-09-18,Medical Mutual of Ohio,15,17,8,40,0.200000
2025-09-18,Merck,22,16,2,40,0.050000
2025-09-18,Mercury General,15,17,8,40,0.200000
2025-09-18,Meritage Homes,13,23,4,40,0.100000
2025-09-18,MetLife,19,18,3,40,0.075000
2025-09-18,Meta Platforms,21,14,5,40,0.125000
2025-09-18,Mettler-Toledo International,20,20,0,40,0.000000
2025-09-18,Microchip Technology,24,13,3,40,0.075000
2025-09-18,Micron Technology,17,20,3,40,0.075000
2025-09-18,Microsoft,13,21,6,40,0.150000
2025-09-18,Middleby,14,21,5,40,0.125000
2025-09-18,MillerKnoll,18,18,4,40,0.100000
2025-09-18,Moderna,16,20,4,40,0.100000
2025-09-18,ModivCare,13,16,11,40,0.275000
2025-09-18,Mohawk Industries,20,17,3,40,0.075000
2025-09-18,Molina Healthcare,20,11,9,40,0.225000
2025-09-18,Molson Coors Beverage,18,15,7,40,0.175000
2025-09-18,Mondelez,20,17,3,40,0.075000
2025-09-18,Monster Beverage,24,16,0,40,0.000000
2025-09-18,Moodys Corporation,3,12,4,19,0.210526
2025-09-18,Moog Inc,25,14,1,40,0.025000
2025-09-18,Morgan Stanley,17,18,5,40,0.125000
2025-09-18,Motorola Solutions,35,2,3,40,0.075000
2025-09-18,Mueller Industries,23,16,1,40,0.025000
2025-09-18,Murphy Oil,14,22,4,40,0.100000
2025-09-18,Murphy USA,16,21,3,40,0.075000
2025-09-18,Mutual of Omaha,19,19,2,40,0.050000
2025-09-18,NCR Atleos,14,24,2,40,0.050000
2025-09-18,NCR Voyix,19,17,4,40,0.100000
2025-09-18,NGL Energy Partners,36,2,2,40,0.050000
2025-09-18,NLV Financial,5,3,2,10,0.200000
2025-09-18,NOV,8,25,7,40,0.175000
2025-09-18,NRG Energy,36,3,1,40,0.025000
2025-09-18,NVR Inc,19,17,4,40,0.100000
2025-09-18,Nasdaq Inc,21,15,4,40,0.100000
2025-09-18,Nationwide Insurance,10,18,12,40,0.300000
2025-09-18,Navient,19,14,7,40,0.175000
2025-09-18,NetApp,19,19,2,40,0.050000
2025-09-18,Netflix,13,15,12,40,0.300000
2025-09-18,NeueHealth,15,23,2,40,0.050000
2025-09-18,New York Life Insurance,15,23,2,40,0.050000
2025-09-18,NewMarket Corporation,20,19,1,40,0.025000
2025-09-18,Newell Brands,8,24,8,40,0.200000
2025-09-18,Newmont,12,23,5,40,0.125000
2025-09-18,News Corp,14,17,9,40,0.225000
2025-09-18,Nexstar Media Group,9,21,10,40,0.250000
2025-09-18,NextEra Energy,38,1,1,40,0.025000
2025-09-18,NiSource,17,13,10,40,0.250000
2025-09-18,Nike,16,20,4,40,0.100000
2025-09-18,Nordson,18,21,1,40,0.025000
2025-09-18,Nordstrom,17,21,2,40,0.050000
2025-09-18,Norfolk Southern,16,20,4,40,0.100000
2025-09-18,Northern Trust,37,3,0,40,0.000000
2025-09-18,Northrop Grumman,20,18,2,40,0.050000
2025-09-18,Northwestern Mutual,16,14,10,40,0.250000
2025-09-18,Nucor,10,20,10,40,0.250000
2025-09-18,Nvidia,11,27,2,40,0.050000
2025-09-18,O'Reilly Automotive,8,20,12,40,0.300000
2025-09-18,O-I Glass,19,18,3,40,0.075000
2025-09-18,ODP Business Solutions,18,21,1,40,0.025000
2025-09-18,OGE Energy,40,0,0,40,0.000000
2025-09-18,ON Semiconductor,20,17,3,40,0.075000
2025-09-18,Occidental Petroleum,15,19,6,40,0.150000
2025-09-18,Old Dominion Freight Line,19,15,6,40,0.150000
2025-09-18,Old National Bancorp,18,20,2,40,0.050000
2025-09-18,Old Republic International,17,20,3,40,0.075000
2025-09-18,Olin,16,14,10,40,0.250000
2025-09-18,Omnicom Group,20,18,2,40,0.050000
2025-09-18,OneMain,18,22,0,40,0.000000
2025-09-18,Oneok,22,18,0,40,0.000000
2025-09-18,Opendoor Technologies,11,21,8,40,0.200000
2025-09-18,Option Care Health,39,1,0,40,0.000000
2025-09-18,Oracle,19,19,2,40,0.050000
2025-09-18,Organon,19,17,4,40,0.100000
2025-09-18,Oscar Health,15,18,7,40,0.175000
2025-09-18,Oshkosh Corporation,22,14,4,40,0.100000
2025-09-18,Otis Worldwide,10,23,7,40,0.175000
2025-09-18,Ovintiv,22,11,7,40,0.175000
2025-09-18,Owens & Minor,10,24,6,40,0.150000
2025-09-18,Owens Corning,20,18,2,40,0.050000
2025-09-18,PACS Group,20,10,10,40,0.250000
2025-09-18,PBF Energy,32,2,6,40,0.150000
2025-09-18,PC Connection Inc,24,15,1,40,0.025000
2025-09-18,PENN Entertainment,35,4,1,40,0.025000
2025-09-18,PG&E,21,10,9,40,0.225000
2025-09-18,PNC Financial Services,21,18,1,40,0.025000
2025-09-18,PPG Industries,15,21,4,40,0.100000
2025-09-18,PPL Corporation,15,22,3,40,0.075000
2025-09-18,PVH,18,18,4,40,0.100000
2025-09-18,Paccar,17,19,4,40,0.100000
2025-09-18,Pacific Life,19,21,0,40,0.000000
2025-09-18,Packaging Corp of America,9,27,4,40,0.100000
2025-09-18,Palo Alto Networks,18,15,7,40,0.175000
2025-09-18,Par Pacific,18,21,1,40,0.025000
2025-09-18,Paramount Global,10,26,4,40,0.100000
2025-09-18,Park Hotels & Resorts,17,20,3,40,0.075000
2025-09-18,Parker-Hannifin,22,18,0,40,0.000000
2025-09-18,Parsons Corporation,25,13,2,40,0.050000
2025-09-18,Patrick Industries,16,20,4,40,0.100000
2025-09-18,Patterson Companies Inc,9,29,2,40,0.050000
2025-09-18,Patterson-UTI Energy,36,3,1,40,0.025000
2025-09-18,PayPal,19,19,2,40,0.050000
2025-09-18,Paychex,23,13,4,40,0.100000
2025-09-18,Peabody Energy,32,5,3,40,0.075000
2025-09-18,Peloton Interactive,20,16,4,40,0.100000
2025-09-18,Penn Mutual Life Insurance,19,17,4,40,0.100000
2025-09-18,PennyMac Financial Services,16,20,4,40,0.100000
2025-09-18,Penske Automotive,11,28,1,40,0.025000
2025-09-18,PepsiCo,19,20,1,40,0.025000
2025-09-18,Performance Food,23,16,1,40,0.025000
2025-09-18,Permian Resources,24,13,3,40,0.075000
2025-09-18,Petco Health and Wellness,32,5,3,40,0.075000
2025-09-18,Peter Kiewit Sons',7,21,12,40,0.300000
2025-09-18,Pfizer,24,11,5,40,0.125000
2025-09-18,Philip Morris International,15,25,0,40,0.000000
2025-09-18,Phillips 66,18,21,1,40,0.025000
2025-09-18,Pinnacle West Capital,16,12,12,40,0.300000
2025-09-18,Pinterest,20,18,2,40,0.050000
2025-09-18,Pioneer Natural Resources,17,13,10,40,0.250000
2025-09-18,Pitney Bowes,17,23,0,40,0.000000
2025-09-18,Plains GP,14,11,15,40,0.375000
2025-09-18,Playtika Holding,15,19,6,40,0.150000
2025-09-18,Plexus Corp,18,19,3,40,0.075000
2025-09-18,Polaris Inc,24,15,1,40,0.025000
2025-09-18,Pool Corporation,19,20,1,40,0.025000
2025-09-18,Popular Inc,40,0,0,40,0.000000
2025-09-18,Portland General Electric,20,17,3,40,0.075000
2025-09-18,Post Holdings,12,27,1,40,0.025000
2025-09-18,PrIncipal Financial,21,18,1,40,0.025000
2025-09-18,PriceSmart,16,22,2,40,0.050000
2025-09-18,Primerica,21,16,3,40,0.075000
2025-09-18,Primoris Services,23,16,1,40,0.025000
2025-09-18,ProFrac Holding,16,18,6,40,0.150000
2025-09-18,Procter & Gamble,18,18,4,40,0.100000
2025-09-18,Progressive Insurance,18,19,3,40,0.075000
2025-09-18,Prologis,17,21,2,40,0.050000
2025-09-18,Prudential Financial,19,17,4,40,0.100000
2025-09-18,Public Service Enterprise Group,19,19,2,40,0.050000
2025-09-18,Public Storage,18,17,5,40,0.125000
2025-09-18,Publix Super Markets,21,16,3,40,0.075000
2025-09-18,Puget Sound Energy,31,7,2,40,0.050000
2025-09-18,PulteGroup,20,19,1,40,0.025000
2025-09-18,Pure Storage,17,19,4,40,0.100000
2025-09-18,QVC Group,11,25,4,40,0.100000
2025-09-18,QXO Building Products,1,6,3,10,0.300000
2025-09-18,Qorvo,21,17,2,40,0.050000
2025-09-18,Qualcomm,24,14,2,40,0.050000
2025-09-18,Quanta Services,21,19,0,40,0.000000
2025-09-18,Quest Diagnostics,8,29,3,40,0.075000
2025-09-18,QuidelOrtho,17,21,2,40,0.050000
2025-09-18,REV Group,21,14,5,40,0.125000
2025-09-18,RPM International,17,21,2,40,0.050000
2025-09-18,RTX,15,22,3,40,0.075000
2025-09-18,RXO Inc,21,16,3,40,0.075000
2025-09-18,Rackspace Technology,14,21,5,40,0.125000
2025-09-18,Radius Recycling,5,24,11,40,0.275000
2025-09-18,Ralph Lauren,17,21,2,40,0.050000
2025-09-18,Range Resources,18,18,4,40,0.100000
2025-09-18,Raymond James Financial,11,28,1,40,0.025000
2025-09-18,Realty Income,23,13,4,40,0.100000
2025-09-18,Regal Rexnord,11,23,6,40,0.150000
2025-09-18,Regeneron Pharmaceuticals,28,10,2,40,0.050000
2025-09-18,Regions Financial,20,19,1,40,0.025000
2025-09-18,Reinsurance Group of America,19,19,2,40,0.050000
2025-09-18,Reliance Inc,25,13,2,40,0.050000
2025-09-18,Republic Services,17,14,9,40,0.225000
2025-09-18,ResMed,17,21,2,40,0.050000
2025-09-18,Resideo Technologies,18,20,2,40,0.050000
2025-09-18,Restoration Hardware,11,23,6,40,0.150000
2025-09-18,Revvity,17,18,5,40,0.125000
2025-09-18,Rithm Capital,10,25,5,40,0.125000
2025-09-18,Rivian Automotive,12,22,6,40,0.150000
2025-09-18,Robert Half,20,19,1,40,0.025000
2025-09-18,Roblox,11,13,16,40,0.400000
2025-09-18,Rocket Companies,15,21,4,40,0.100000
2025-09-18,Rockwell Automation,19,20,1,40,0.025000
2025-09-18,Roku,27,12,1,40,0.025000
2025-09-18,Rollins Inc,20,20,0,40,0.000000
2025-09-18,Roper Technologies,11,28,1,40,0.025000
2025-09-18,Ross Stores,14,24,2,40,0.050000
2025-09-18,Rush Enterprises,18,18,4,40,0.100000
2025-09-18,Ryder System,21,15,4,40,0.100000
2025-09-18,Ryerson Holding,12,23,5,40,0.125000
2025-09-18,S&P Global,15,21,4,40,0.100000
2025-09-18,SBA Communications,15,16,9,40,0.225000
2025-09-18,SS&C Technologies,21,19,0,40,0.000000
2025-09-18,Sabre Corporation,19,14,7,40,0.175000
2025-09-18,Saia Inc,22,14,4,40,0.100000
2025-09-18,Salesforce,18,9,13,40,0.325000
2025-09-18,Sallie Mae,11,26,3,40,0.075000
2025-09-18,Sally Beauty,39,1,0,40,0.000000
2025-09-18,Sanmina,13,25,2,40,0.050000
2025-09-18,ScanSource,22,16,2,40,0.050000
2025-09-18,Schneider National,16,19,5,40,0.125000
2025-09-18,Science Applications International,14,19,7,40,0.175000
2025-09-18,Scotts Miracle-Gro,16,19,5,40,0.125000
2025-09-18,Seaboard,20,14,6,40,0.150000
2025-09-18,Sealed Air Corporation,13,24,3,40,0.075000
2025-09-18,Securian Financial,13,23,4,40,0.100000
2025-09-18,Select Medical Holdings,18,17,5,40,0.125000
2025-09-18,Selective Insurance Group,22,11,7,40,0.175000
2025-09-18,Sempra,28,12,0,40,0.000000
2025-09-18,Sentry Insurance Group,3,6,0,9,0.000000
2025-09-18,Service Corp International,7,13,5,25,0.200000
2025-09-18,ServiceNow,18,19,3,40,0.075000
2025-09-18,Sherwin-Williams,8,26,6,40,0.150000
2025-09-18,Shift4 Payments,15,21,4,40,0.100000
2025-09-18,Silgan,9,22,9,40,0.225000
2025-09-18,Simon Property Group,18,19,3,40,0.075000
2025-09-18,Sinclair,12,20,8,40,0.200000
2025-09-18,Sirius XM,12,24,4,40,0.100000
2025-09-18,SiteOne Landscape Supply,18,15,7,40,0.175000
2025-09-18,Skechers USA,16,22,2,40,0.050000
2025-09-18,SkyWest,15,19,6,40,0.150000
2025-09-18,Skyline Champion,33,4,3,40,0.075000
2025-09-18,Skyworks Solutions,32,3,5,40,0.125000
2025-09-18,Smurfit Westrock,9,26,5,40,0.125000
2025-09-18,Snap Inc,13,16,11,40,0.275000
2025-09-18,Snap-on,12,27,1,40,0.025000
2025-09-18,Snowflake Inc,24,16,0,40,0.000000
2025-09-18,Solventum,17,20,3,40,0.075000
2025-09-18,Sonic Automotive,11,24,5,40,0.125000
2025-09-18,Sonoco Products,19,18,3,40,0.075000
2025-09-18,Southern Company,25,14,1,40,0.025000
2025-09-18,Southwest Airlines,8,25,7,40,0.175000
2025-09-18,Southwest Gas Holdings,17,22,1,40,0.025000
2025-09-18,SpartanNash,16,24,0,40,0.000000
2025-09-18,Spectrum Brands,14,18,8,40,0.200000
2025-09-18,Spire Inc,22,15,3,40,0.075000
2025-09-18,Spirit AeroSystems,30,2,8,40,0.200000
2025-09-18,Spirit Airlines,23,1,16,40,0.400000
2025-09-18,Splunk,14,24,2,40,0.050000
2025-09-18,Sprouts Farmers Market,10,27,3,40,0.075000
2025-09-18,Stagwell,8,25,7,40,0.175000
2025-09-18,Stanley Black & Decker,17,20,3,40,0.075000
2025-09-18,Starbucks,8,22,10,40,0.250000
2025-09-18,State Farm Insurance,11,19,10,40,0.250000
2025-09-18,State Street,13,26,1,40,0.025000
2025-09-18,Steel Dynamics,35,2,3,40,0.075000
2025-09-18,Steelcase,13,26,1,40,0.025000
2025-09-18,Stericycle,13,7,20,40,0.500000
2025-09-18,Stifel Financial,24,14,2,40,0.050000
2025-09-18,StoneX Group,14,25,1,40,0.025000
2025-09-18,Stryker,18,17,5,40,0.125000
2025-09-18,Summit Materials,12,25,3,40,0.075000
2025-09-18,Sun Communities,23,17,0,40,0.000000
2025-09-18,Super Micro Computer,38,1,1,40,0.025000
2025-09-18,Surgery Partners,21,15,4,40,0.100000
2025-09-18,Sylvamo,14,23,3,40,0.075000
2025-09-18,Synchrony Financial,21,16,3,40,0.075000
2025-09-18,Synopsys,16,13,11,40,0.275000
2025-09-18,Synovus Financial,22,15,3,40,0.075000
2025-09-18,Sysco,21,17,2,40,0.050000
2025-09-18,T Rowe Price,16,24,0,40,0.000000
2025-09-18,TD Synnex,22,18,0,40,0.000000
2025-09-18,TEGNA,13,22,5,40,0.125000
2025-09-18,THOR Industries,12,21,7,40,0.175000
2025-09-18,TIAA,14,23,3,40,0.075000
2025-09-18,TJX,19,17,4,40,0.100000
2025-09-18,Take-Two Interactive Software,18,22,0,40,0.000000
2025-09-18,Talen Energy,39,0,1,40,0.025000
2025-09-18,Tapestry,11,18,11,40,0.275000
2025-09-18,Targa Resources,20,18,2,40,0.050000
2025-09-18,Target Corporation,17,18,5,40,0.125000
2025-09-18,Taylor Morrison Home,19,16,5,40,0.125000
2025-09-18,Teladoc Health,15,17,8,40,0.200000
2025-09-18,Teledyne Technologies,16,23,1,40,0.025000
2025-09-18,Teleflex,10,27,3,40,0.075000
2025-09-18,Telephone & Data Systems,11,20,2,33,0.060606
2025-09-18,TelevisaUnivision,11,17,12,40,0.300000
2025-09-18,Tempur Sealy International,10,24,6,40,0.150000
2025-09-18,Tenet Healthcare,25,14,1,40,0.025000
2025-09-18,Teradyne,22,18,0,40,0.000000
2025-09-18,Terex,11,24,5,40,0.125000
2025-09-18,Tesla,12,9,19,40,0.475000
2025-09-18,Tetra Tech,20,16,4,40,0.100000
2025-09-18,Texas Instruments,11,23,6,40,0.150000
2025-09-18,Texas Roadhouse,13,15,12,40,0.300000
2025-09-18,Textron,15,21,4,40,0.100000
2025-09-18,The Andersons Inc,12,27,1,40,0.025000
2025-09-18,The Coca-Cola Company,12,25,3,40,0.075000
2025-09-18,The Hartford,18,13,9,40,0.225000
2025-09-18,The Mosaic Company,16,17,7,40,0.175000
2025-09-18,Thermo Fisher Scientific,24,11,5,40,0.125000
2025-09-18,Thrivent Financial for Lutherans,15,20,5,40,0.125000
2025-09-18,Timken,14,24,2,40,0.050000
2025-09-18,Titan Machinery,9,24,7,40,0.175000
2025-09-18,Toast Inc,17,22,1,40,0.025000
2025-09-18,Toll Brothers,15,23,2,40,0.050000
2025-09-18,TopBuild,14,25,1,40,0.025000
2025-09-18,Topgolf Callaway Brands,14,21,5,40,0.125000
2025-09-18,Toro Company,12,25,3,40,0.075000
2025-09-18,Tractor Supply,14,24,2,40,0.050000
2025-09-18,TransDigm,21,14,5,40,0.125000
2025-09-18,TransUnion,17,10,13,40,0.325000
2025-09-18,Travelers Insurance,14,16,10,40,0.250000
2025-09-18,TreeHouse Foods,13,16,11,40,0.275000
2025-09-18,Tri Pointe Homes,16,23,1,40,0.025000
2025-09-18,TriNet Group,24,14,2,40,0.050000
2025-09-18,Trimble Inc,17,20,3,40,0.075000
2025-09-18,Trinity Industries,16,15,9,40,0.225000
2025-09-18,TruStage,27,11,2,40,0.050000
2025-09-18,Truist Financial,17,20,3,40,0.075000
2025-09-18,Tutor Perini Corporation,22,17,1,40,0.025000
2025-09-18,Twilio,23,16,1,40,0.025000
2025-09-18,Tyson Foods,9,24,7,40,0.175000
2025-09-18,U-Haul,7,12,21,40,0.525000
2025-09-18,UFP Industries,11,23,6,40,0.150000
2025-09-18,UGI Utilities Inc,17,13,10,40,0.250000
2025-09-18,UL Solutions,35,1,4,40,0.100000
2025-09-18,UPS,10,13,17,40,0.425000
2025-09-18,US Bancorp,14,20,6,40,0.150000
2025-09-18,US Foods,27,11,2,40,0.050000
2025-09-18,USAA,20,13,7,40,0.175000
2025-09-18,Uber,8,23,9,40,0.225000
2025-09-18,Ulta Beauty,35,5,0,40,0.000000
2025-09-18,Under Armour,10,25,5,40,0.125000
2025-09-18,Union Pacific,14,21,5,40,0.125000
2025-09-18,United Airlines,31,3,6,40,0.150000
2025-09-18,United Natural Foods,32,6,2,40,0.050000
2025-09-18,United Rentals,40,0,0,40,0.000000
2025-09-18,United States Steel,23,12,5,40,0.125000
2025-09-18,UnitedHealth,25,8,7,40,0.175000
2025-09-18,Universal Corporation,17,21,2,40,0.050000
2025-09-18,Universal Health Services,17,18,5,40,0.125000
2025-09-18,Unum Group,17,17,6,40,0.150000
2025-09-18,Upbound Group,23,17,0,40,0.000000
2025-09-18,Urban Outfitters,16,23,1,40,0.025000
2025-09-18,V2X,25,10,5,40,0.125000
2025-09-18,VF Corporation,12,14,14,40,0.350000
2025-09-18,VICI Properties,16,22,2,40,0.050000
2025-09-18,Vail Resorts,10,14,16,40,0.400000
2025-09-18,Valero Energy,36,3,1,40,0.025000
2025-09-18,Valley National Bancorp,8,26,6,40,0.150000
2025-09-18,Valmont Industries,20,20,0,40,0.000000
2025-09-18,Valvoline Inc,15,23,2,40,0.050000
2025-09-18,Ventas Inc,24,15,1,40,0.025000
2025-09-18,Verisk Analytics,19,15,6,40,0.150000
2025-09-18,Verizon,21,10,9,40,0.225000
2025-09-18,Vertex Pharmaceuticals,24,13,3,40,0.075000
2025-09-18,Vertiv,26,13,1,40,0.025000
2025-09-18,Viasat,15,24,1,40,0.025000
2025-09-18,Viatris,10,19,11,40,0.275000
2025-09-18,Victorias Secret,14,14,12,40,0.300000
2025-09-18,Visa Inc,23,13,4,40,0.100000
2025-09-18,Vishay Intertechnology,13,22,5,40,0.125000
2025-09-18,Vista Outdoor,13,23,4,40,0.100000
2025-09-18,Visteon,20,17,3,40,0.075000
2025-09-18,Vistra,24,13,3,40,0.075000
2025-09-18,Vontier,18,21,1,40,0.025000
2025-09-18,Voya Financial,29,10,1,40,0.025000
2025-09-18,Vulcan Materials,13,18,9,40,0.225000
2025-09-18,WEC Energy,38,1,1,40,0.025000
2025-09-18,WESCO International,17,21,2,40,0.050000
2025-09-18,WEX,21,14,5,40,0.125000
2025-09-18,WR Berkley,18,21,1,40,0.025000
2025-09-18,WW Grainger,24,13,3,40,0.075000
2025-09-18,Wabash National,18,10,12,40,0.300000
2025-09-18,Walmart,15,18,7,40,0.175000
2025-09-18,Walt Disney,15,18,7,40,0.175000
2025-09-18,Warner Bros Discovery,12,23,5,40,0.125000
2025-09-18,Warner Music Group,7,31,2,40,0.050000
2025-09-18,Waters Corporation,20,18,2,40,0.050000
2025-09-18,Watsco,10,20,10,40,0.250000
2025-09-18,Wayfair,8,27,5,40,0.125000
2025-09-18,Webster Financial,18,19,3,40,0.075000
2025-09-18,Weis Markets,10,23,7,40,0.175000
2025-09-18,Wells Fargo,34,0,6,40,0.150000
2025-09-18,Welltower,31,9,0,40,0.000000
2025-09-18,Werner Enterprises,19,13,8,40,0.200000
2025-09-18,West Pharmaceutical Services,15,24,1,40,0.025000
2025-09-18,Western & Southern Financial,14,23,3,40,0.075000
2025-09-18,Western Alliance Bancorp,15,15,10,40,0.250000
2025-09-18,Western Digital,13,20,7,40,0.175000
2025-09-18,Western Midstream Partners,21,18,1,40,0.025000
2025-09-18,Western Union,16,21,3,40,0.075000
2025-09-18,Westinghouse Air Brake Technologies,18,20,2,40,0.050000
2025-09-18,Weyerhaeuser,16,21,3,40,0.075000
2025-09-18,Whirlpool,14,18,8,40,0.200000
2025-09-18,Williams Companies,22,17,1,40,0.025000
2025-09-18,Williams-Sonoma,17,19,4,40,0.100000
2025-09-18,Winnebago Industries,11,24,5,40,0.125000
2025-09-18,Wintrust Financial,17,22,1,40,0.025000
2025-09-18,Woodward Inc,19,20,1,40,0.025000
2025-09-18,Workday,12,20,8,40,0.200000
2025-09-18,World Kinect,14,23,3,40,0.075000
2025-09-18,Worthington Enterprises,14,24,2,40,0.050000
2025-09-18,Wynn Resorts,14,16,10,40,0.250000
2025-09-18,XPO,20,17,3,40,0.075000
2025-09-18,Xcel Energy,32,7,1,40,0.025000
2025-09-18,Xerox,12,24,4,40,0.100000
2025-09-18,Xylem Inc,22,18,0,40,0.000000
2025-09-18,Yum Brands,12,26,2,40,0.050000
2025-09-18,Yum China,20,14,6,40,0.150000
2025-09-18,Zebra Technologies,20,19,1,40,0.025000
2025-09-18,Zimmer Biomet,13,26,1,40,0.025000
2025-09-18,Zions Bancorp,18,19,3,40,0.075000
2025-09-18,Zoetis,34,5,1,40,0.025000
2025-09-18,Zoom Video Communications,13,21,6,40,0.150000
2025-09-18,eXp World,16,22,2,40,0.050000
2025-09-18,iHeartMedia,15,23,2,40,0.050000
2025-09-19,3M,17,15,8,40,0.200000
2025-09-19,A O Smith,10,30,0,40,0.000000
2025-09-19,A-Mark Precious Metals,39,1,0,40,0.000000
2025-09-19,ABM Industries,14,17,9,40,0.225000
2025-09-19,ADT,18,19,3,40,0.075000
2025-09-19,AECOM,22,17,1,40,0.025000
2025-09-19,AES,15,19,6,40,0.150000
2025-09-19,AGCO,15,18,7,40,0.175000
2025-09-19,AGNC Investment,16,20,4,40,0.100000
2025-09-19,AIG,9,27,4,40,0.100000
2025-09-19,AMC Entertainment,37,1,2,40,0.050000
2025-09-19,AMC Networks,12,18,10,40,0.250000
2025-09-19,AMN Healthcare Services,13,22,5,40,0.125000
2025-09-19,APA,20,15,5,40,0.125000
2025-09-19,APi Group,22,16,2,40,0.050000
2025-09-19,ARKO,12,26,2,40,0.050000
2025-09-19,ASGN,15,18,7,40,0.175000
2025-09-19,AT&T,15,18,7,40,0.175000
2025-09-19,ATI Inc,21,17,2,40,0.050000
2025-09-19,AbbVie,14,17,9,40,0.225000
2025-09-19,Abbott Laboratories,23,13,4,40,0.100000
2025-09-19,Abercrombie & Fitch,17,20,3,40,0.075000
2025-09-19,Academy Sports and Outdoors,17,21,2,40,0.050000
2025-09-19,Acadia Healthcare,9,22,9,40,0.225000
2025-09-19,Ace Hardware,13,19,8,40,0.200000
2025-09-19,Acuity Inc,23,15,2,40,0.050000
2025-09-19,Adams Resources & Energy,17,5,2,24,0.083333
2025-09-19,AdaptHealth,17,16,7,40,0.175000
2025-09-19,Adobe,18,21,1,40,0.025000
2025-09-19,Advance Auto Parts,12,23,5,40,0.125000
2025-09-19,Advanced Drainage Systems,36,1,3,40,0.075000
2025-09-19,Advanced Micro Devices,30,5,5,40,0.125000
2025-09-19,Advantage Solutions,36,1,3,40,0.075000
2025-09-19,Aflac,14,17,9,40,0.225000
2025-09-19,Agilent Technologies,28,11,1,40,0.025000
2025-09-19,Agilon Health,15,20,5,40,0.125000
2025-09-19,Air Lease,20,18,2,40,0.050000
2025-09-19,Air Products & Chemicals,14,22,4,40,0.100000
2025-09-19,Airbnb,17,20,3,40,0.075000
2025-09-19,Akamai Technologies,25,9,6,40,0.150000
2025-09-19,Alaska Air,20,12,8,40,0.200000
2025-09-19,Albemarle Corporation,18,17,5,40,0.125000
2025-09-19,Albertsons,19,17,4,40,0.100000
2025-09-19,Alcoa Corporation,8,26,6,40,0.150000
2025-09-19,Alexandria Real Estate Equities,22,16,2,40,0.050000
2025-09-19,Alight Solutions,14,22,4,40,0.100000
2025-09-19,Align Technology,10,20,10,40,0.250000
2025-09-19,Allegiant Travel Company,19,18,3,40,0.075000
2025-09-19,Alliance Resource Partners,15,18,7,40,0.175000
2025-09-19,Alliant Energy,33,5,2,40,0.050000
2025-09-19,Allison Transmission,11,23,6,40,0.150000
2025-09-19,Allstate,25,7,8,40,0.200000
2025-09-19,Ally Financial,13,25,2,40,0.050000
2025-09-19,Alpha Metallurgical Resources,17,15,8,40,0.200000
2025-09-19,Alphabet,17,18,5,40,0.125000
2025-09-19,Altice USA,16,18,6,40,0.150000
2025-09-19,Altria,24,14,2,40,0.050000
2025-09-19,Amazon,34,3,3,40,0.075000
2025-09-19,Ameren,14,23,3,40,0.075000
2025-09-19,American Airlines,9,20,11,40,0.275000
2025-09-19,American Axle & Manufacturing,15,21,4,40,0.100000
2025-09-19,American Eagle Outfitters,12,20,8,40,0.200000
2025-09-19,American Electric Power,20,15,5,40,0.125000
2025-09-19,American Express,17,17,6,40,0.150000
2025-09-19,American Family Insurance,20,16,4,40,0.100000
2025-09-19,American Financial Group,11,27,2,40,0.050000
2025-09-19,American Tower,21,17,2,40,0.050000
2025-09-19,American Water Works,23,14,3,40,0.075000
2025-09-19,Americold Realty Trust,37,2,1,40,0.025000
2025-09-19,Ameriprise Financial,23,17,0,40,0.000000
2025-09-19,Ametek,27,10,3,40,0.075000
2025-09-19,Amgen,24,15,1,40,0.025000
2025-09-19,Amica Mutual Insurance,13,25,2,40,0.050000
2025-09-19,Amkor Technology,14,24,2,40,0.050000
2025-09-19,Amphenol,24,16,0,40,0.000000
2025-09-19,Analog Devices,22,16,2,40,0.050000
2025-09-19,Antero Resources,16,21,3,40,0.075000
2025-09-19,Anywhere Real Estate Inc,19,17,4,40,0.100000
2025-09-19,Apollo Global Management,14,21,5,40,0.125000
2025-09-19,AppLovin,15,23,2,40,0.050000
2025-09-19,Apple,10,21,9,40,0.225000
2025-09-19,Applied Industrial Technologies,19,21,0,40,0.000000
2025-09-19,Applied Materials,9,18,13,40,0.325000
2025-09-19,AptarGroup,18,19,3,40,0.075000
2025-09-19,Aramark,23,16,1,40,0.025000
2025-09-19,ArcBest,17,18,5,40,0.125000
2025-09-19,Arch Resources,31,6,3,40,0.075000
2025-09-19,Archer Daniels Midland,11,19,10,40,0.250000
2025-09-19,Ares Management,24,16,0,40,0.000000
2025-09-19,Arista Networks,17,21,2,40,0.050000
2025-09-19,Arrow Electronics,16,21,3,40,0.075000
2025-09-19,Arthur J Gallagher,20,20,0,40,0.000000
2025-09-19,Asbury Automotive Group,8,27,5,40,0.125000
2025-09-19,Assurant,22,12,6,40,0.150000
2025-09-19,Atkore,22,15,3,40,0.075000
2025-09-19,Atlassian,9,11,20,40,0.500000
2025-09-19,Atmos Energy,33,4,3,40,0.075000
2025-09-19,Auto-Owners Insurance,16,18,6,40,0.150000
2025-09-19,AutoNation,19,16,5,40,0.125000
2025-09-19,AutoZone,12,20,8,40,0.200000
2025-09-19,Autodesk,15,25,0,40,0.000000
2025-09-19,Autoliv,23,13,4,40,0.100000
2025-09-19,Automatic Data Processing,27,9,4,40,0.100000
2025-09-19,AvalonBay Communities,8,28,4,40,0.100000
2025-09-19,Avantor,12,19,9,40,0.225000
2025-09-19,Avery Dennison,25,14,1,40,0.025000
2025-09-19,Avient,10,23,7,40,0.175000
2025-09-19,Avis Budget,13,18,9,40,0.225000
2025-09-19,Avnet,16,23,1,40,0.025000
2025-09-19,BJ's Wholesale Club,19,13,8,40,0.200000
2025-09-19,BOK Financial,23,13,4,40,0.100000
2025-09-19,BWX Technologies,26,12,2,40,0.050000
2025-09-19,Baker Hughes,24,14,2,40,0.050000
2025-09-19,Ball Corporation,19,20,1,40,0.025000
2025-09-19,Bank of America,14,26,0,40,0.000000
2025-09-19,Bank of New York Mellon,22,15,3,40,0.075000
2025-09-19,Bath & Body Works,20,13,7,40,0.175000
2025-09-19,Baxter International,19,17,4,40,0.100000
2025-09-19,Becton Dickinson,29,9,2,40,0.050000
2025-09-19,Belden,13,23,4,40,0.100000
2025-09-19,Benchmark Electronics,18,18,4,40,0.100000
2025-09-19,Berkshire Hathaway,17,13,10,40,0.250000
2025-09-19,Berry Global,9,22,9,40,0.225000
2025-09-19,Best Buy,38,0,2,40,0.050000
2025-09-19,Bio-Rad Laboratories,16,20,4,40,0.100000
2025-09-19,Biogen,18,17,5,40,0.125000
2025-09-19,BlackRock,20,16,4,40,0.100000
2025-09-19,Blackstone,18,18,4,40,0.100000
2025-09-19,Bloomin Brands,6,27,7,40,0.175000
2025-09-19,BlueLinx,13,22,5,40,0.125000
2025-09-19,Boeing,9,19,12,40,0.300000
2025-09-19,Boise Cascade,13,15,12,40,0.300000
2025-09-19,Booking Holdings,25,11,4,40,0.100000
2025-09-19,Booz Allen Hamilton,19,18,3,40,0.075000
2025-09-19,BorgWarner,23,15,2,40,0.050000
2025-09-19,Boston Properties,8,25,7,40,0.175000
2025-09-19,Boston Scientific,20,16,4,40,0.100000
2025-09-19,Boyd Gaming,19,21,0,40,0.000000
2025-09-19,Bread Financial,22,15,3,40,0.075000
2025-09-19,BrightSpring Health Services,12,24,4,40,0.100000
2025-09-19,BrightView Holdings,24,14,2,40,0.050000
2025-09-19,Brighthouse Financial,12,23,5,40,0.125000
2025-09-19,Brinker International,19,20,1,40,0.025000
2025-09-19,Brinks Company,17,4,7,28,0.250000
2025-09-19,Bristol-Myers Squibb,9,27,4,40,0.100000
2025-09-19,Broadcom,20,19,1,40,0.025000
2025-09-19,Broadridge Financial Solutions,36,4,0,40,0.000000
2025-09-19,Brookdale Senior Living,16,17,7,40,0.175000
2025-09-19,Brown & Brown,15,21,4,40,0.100000
2025-09-19,Brown-Forman,12,22,6,40,0.150000
2025-09-19,Bruker,15,17,8,40,0.200000
2025-09-19,Brunswick Corporation,24,15,1,40,0.025000
2025-09-19,Builders FirstSource,18,18,4,40,0.100000
2025-09-19,Burlington Stores,13,24,3,40,0.075000
2025-09-19,CACI International,28,12,0,40,0.000000
2025-09-19,CBRE Group,16,24,0,40,0.000000
2025-09-19,CDW,23,17,0,40,0.000000
2025-09-19,CF Industries,26,13,1,40,0.025000
2025-09-19,CH Robinson Worldwide,18,19,3,40,0.075000
2025-09-19,CHS,20,15,5,40,0.125000
2025-09-19,CIncinnati Financial,17,22,1,40,0.025000
2025-09-19,CME Group,15,23,2,40,0.050000
2025-09-19,CMS Energy,37,2,1,40,0.025000
2025-09-19,CNO Financial Group,17,23,0,40,0.000000
2025-09-19,CNX Resources,20,18,2,40,0.050000
2025-09-19,CSX,13,20,7,40,0.175000
2025-09-19,CVS Health,21,13,6,40,0.150000
2025-09-19,Cabot Corporation,21,18,1,40,0.025000
2025-09-19,Cadence,16,21,3,40,0.075000
2025-09-19,Caesars Entertainment,20,12,8,40,0.200000
2025-09-19,Cal-Maine Foods,29,10,1,40,0.025000
2025-09-19,Caleres Inc,22,14,4,40,0.100000
2025-09-19,California Resources,16,21,3,40,0.075000
2025-09-19,Calumet Inc,20,12,8,40,0.200000
2025-09-19,Campbell Soup,19,11,10,40,0.250000
2025-09-19,Camping World,9,23,8,40,0.200000
2025-09-19,Capital One,17,17,6,40,0.150000
2025-09-19,CarMax,10,28,2,40,0.050000
2025-09-19,Cardinal Health,22,15,3,40,0.075000
2025-09-19,Carlisle Companies,17,15,8,40,0.200000
2025-09-19,Carlyle Group,12,25,3,40,0.075000
2025-09-19,Carpenter Technology,29,11,0,40,0.000000
2025-09-19,Carrier Global,14,21,5,40,0.125000
2025-09-19,Carters Inc,17,17,3,37,0.081081
2025-09-19,Carvana,16,23,1,40,0.025000
2025-09-19,Caseys General Stores,14,20,6,40,0.150000
2025-09-19,Catalent,8,27,5,40,0.125000
2025-09-19,Caterpillar,30,6,4,40,0.100000
2025-09-19,Cboe Global Markets,19,17,4,40,0.100000
2025-09-19,Celanese,15,15,10,40,0.250000
2025-09-19,Cencora,30,5,5,40,0.125000
2025-09-19,Centene,20,18,2,40,0.050000
2025-09-19,CenterPoint Energy,32,2,6,40,0.150000
2025-09-19,Central Garden & Pet,9,29,2,40,0.050000
2025-09-19,Century Communities,17,22,1,40,0.025000
2025-09-19,ChampionX,22,18,0,40,0.000000
2025-09-19,Charles River Laboratories International,20,17,3,40,0.075000
2025-09-19,Charles Schwab,21,16,3,40,0.075000
2025-09-19,Chart Industries,15,23,2,40,0.050000
2025-09-19,Charter Communications,13,17,10,40,0.250000
2025-09-19,Cheesecake Factory,14,20,6,40,0.150000
2025-09-19,Chefs Warehouse,20,17,3,40,0.075000
2025-09-19,Chemours,15,14,11,40,0.275000
2025-09-19,Cheniere Energy,36,3,1,40,0.025000
2025-09-19,Chevron,13,16,11,40,0.275000
2025-09-19,Chewy,20,14,6,40,0.150000
2025-09-19,Chipotle Mexican Grill,12,22,6,40,0.150000
2025-09-19,Chord Energy,37,2,1,40,0.025000
2025-09-19,Church & Dwight,23,15,2,40,0.050000
2025-09-19,Ciena,22,17,1,40,0.025000
2025-09-19,Cigna,17,17,6,40,0.150000
2025-09-19,Cinemark,12,23,5,40,0.125000
2025-09-19,Cintas,23,15,2,40,0.050000
2025-09-19,Cisco Systems,19,19,2,40,0.050000
2025-09-19,Citigroup,16,20,4,40,0.100000
2025-09-19,Citizens Financial Group,18,21,1,40,0.025000
2025-09-19,Civitas Resources,14,16,10,40,0.250000
2025-09-19,Clean Harbors,34,1,5,40,0.125000
2025-09-19,Clear Channel Outdoor Hldgs,8,0,2,10,0.200000
2025-09-19,Cleveland-Cliffs,14,16,10,40,0.250000
2025-09-19,Clorox,21,15,4,40,0.100000
2025-09-19,Cognizant Technology Solutions,36,2,2,40,0.050000
2025-09-19,Coherent,17,21,2,40,0.050000
2025-09-19,Coinbase Global,10,28,2,40,0.050000
2025-09-19,Colgate-Palmolive,12,22,6,40,0.150000
2025-09-19,Columbia Banking System,18,22,0,40,0.000000
2025-09-19,Columbia Sportswear,10,19,11,40,0.275000
2025-09-19,Comcast,20,13,7,40,0.175000
2025-09-19,Comerica,18,16,6,40,0.150000
2025-09-19,Comfort Systems USA,40,0,0,40,0.000000
2025-09-19,CommScope,16,23,1,40,0.025000
2025-09-19,Commercial Metals,17,20,3,40,0.075000
2025-09-19,Community Health Systems,19,18,3,40,0.075000
2025-09-19,Compass Group,17,17,6,40,0.150000
2025-09-19,Conagra Brands,15,21,4,40,0.100000
2025-09-19,Concentrix,16,18,6,40,0.150000
2025-09-19,Conduent,14,18,8,40,0.200000
2025-09-19,ConocoPhillips,18,15,7,40,0.175000
2025-09-19,Consol Energy,33,6,1,40,0.025000
2025-09-19,Consolidated Edison,13,22,5,40,0.125000
2025-09-19,Constellation Brands,16,12,12,40,0.300000
2025-09-19,Constellation Energy,34,3,3,40,0.075000
2025-09-19,Continental Resources,18,12,10,40,0.250000
2025-09-19,Cooper Cos,6,21,6,33,0.181818
2025-09-19,Cooper-Standard,12,27,1,40,0.025000
2025-09-19,Copart,22,17,1,40,0.025000
2025-09-19,Core & Main,10,21,9,40,0.225000
2025-09-19,Corebridge Financial,20,16,4,40,0.100000
2025-09-19,Cornerstone Building Brands,16,17,7,40,0.175000
2025-09-19,Corning,11,23,6,40,0.150000
2025-09-19,Corpay,20,20,0,40,0.000000
2025-09-19,Corteva,14,23,3,40,0.075000
2025-09-19,Costco,11,17,12,40,0.300000
2025-09-19,Coterra Energy,37,2,1,40,0.025000
2025-09-19,Coty,10,18,12,40,0.300000
2025-09-19,Country Financial,14,23,3,40,0.075000
2025-09-19,Coupang,22,13,5,40,0.125000
2025-09-19,Cracker Barrel Old Country Store,10,15,15,40,0.375000
2025-09-19,Crocs,10,25,5,40,0.125000
2025-09-19,CrossAmerica Partners,13,24,3,40,0.075000
2025-09-19,CrowdStrike,15,15,10,40,0.250000
2025-09-19,Crown Castle,15,20,5,40,0.125000
2025-09-19,Crown Holdings,20,19,1,40,0.025000
2025-09-19,Cullen Frost Bankers,20,18,2,40,0.050000
2025-09-19,Cummins Inc,27,11,2,40,0.050000
2025-09-19,Curtiss-Wright,18,19,3,40,0.075000
2025-09-19,DR Horton,25,15,0,40,0.000000
2025-09-19,DTE Energy,33,4,3,40,0.075000
2025-09-19,DXC Technology,18,20,2,40,0.050000
2025-09-19,DaVita,20,9,11,40,0.275000
2025-09-19,Dana Incorporated,18,17,5,40,0.125000
2025-09-19,Danaher,29,9,2,40,0.050000
2025-09-19,Darden Restaurants,15,17,8,40,0.200000
2025-09-19,Darling Ingredients,38,1,1,40,0.025000
2025-09-19,Deckers Outdoor,15,20,5,40,0.125000
2025-09-19,Deere,11,26,3,40,0.075000
2025-09-19,Delek US,16,22,2,40,0.050000
2025-09-19,Dell Technologies,21,17,2,40,0.050000
2025-09-19,Delta Air Lines,3,28,9,40,0.225000
2025-09-19,Dentsply Sirona,11,28,1,40,0.025000
2025-09-19,Designer Brands,12,25,3,40,0.075000
2025-09-19,Devon Energy,38,1,1,40,0.025000
2025-09-19,DexCom,13,16,11,40,0.275000
2025-09-19,Diamondback Energy,35,1,4,40,0.100000
2025-09-19,Dicks Sporting Goods,12,25,3,40,0.075000
2025-09-19,Diebold Nixdorf,18,22,0,40,0.000000
2025-09-19,Digital Realty Trust,37,3,0,40,0.000000
2025-09-19,Dillards,10,24,6,40,0.150000
2025-09-19,Discover Financial,14,19,7,40,0.175000
2025-09-19,DocuSign,22,17,1,40,0.025000
2025-09-19,Dollar General,4,26,10,40,0.250000
2025-09-19,Dollar Tree,18,19,3,40,0.075000
2025-09-19,Dominion Energy,29,7,4,40,0.100000
2025-09-19,Dominos Pizza Inc,17,16,4,37,0.108108
2025-09-19,Domtar,9,24,7,40,0.175000
2025-09-19,Donaldson Company,25,12,3,40,0.075000
2025-09-19,DoorDash,14,25,1,40,0.025000
2025-09-19,Dover Corporation,24,16,0,40,0.000000
2025-09-19,DraftKings,25,10,5,40,0.125000
2025-09-19,Dream Finders Homes,38,0,2,40,0.050000
2025-09-19,Dropbox,13,23,4,40,0.100000
2025-09-19,DuPont,13,17,10,40,0.250000
2025-09-19,Duke Energy,37,1,2,40,0.050000
2025-09-19,Dycom Industries,18,17,5,40,0.125000
2025-09-19,EMCOR Group,12,25,3,40,0.075000
2025-09-19,EOG Resources,21,16,3,40,0.075000
2025-09-19,EPAM Systems,19,17,4,40,0.100000
2025-09-19,EQT,12,25,3,40,0.075000
2025-09-19,ESAB,10,27,3,40,0.075000
2025-09-19,East West Bancorp,22,16,2,40,0.050000
2025-09-19,Eastman Chemical,14,16,10,40,0.250000
2025-09-19,Ebay,16,17,7,40,0.175000
2025-09-19,EchoStar,9,23,8,40,0.200000
2025-09-19,Ecolab,18,18,4,40,0.100000
2025-09-19,Edison International,21,17,2,40,0.050000
2025-09-19,Edward Jones,18,17,5,40,0.125000
2025-09-19,Edwards Lifesciences,23,12,5,40,0.125000
2025-09-19,Elanco Animal Health,14,25,1,40,0.025000
2025-09-19,Electronic Arts,11,24,5,40,0.125000
2025-09-19,Elevance Health,23,12,5,40,0.125000
2025-09-19,Eli Lilly,13,22,5,40,0.125000
2025-09-19,Emerson Electric,22,16,2,40,0.050000
2025-09-19,EnLink Midstream,17,18,5,40,0.125000
2025-09-19,Encompass Health,15,23,2,40,0.050000
2025-09-19,Endeavor Group,10,25,5,40,0.125000
2025-09-19,Endeavor Group Holdings,11,23,6,40,0.150000
2025-09-19,EnerSys,19,21,0,40,0.000000
2025-09-19,Energizer Holdings,40,0,0,40,0.000000
2025-09-19,Energy Transfer,35,3,2,40,0.050000
2025-09-19,Ensign Group,22,15,3,40,0.075000
2025-09-19,Entegris,25,14,1,40,0.025000
2025-09-19,Entergy,18,17,5,40,0.125000
2025-09-19,Enterprise Products Partners,25,12,3,40,0.075000
2025-09-19,Envista,13,24,3,40,0.075000
2025-09-19,Equifax,22,8,10,40,0.250000
2025-09-19,Equinix,23,15,2,40,0.050000
2025-09-19,Equitable Holdings,15,20,5,40,0.125000
2025-09-19,Equity Residential,13,25,2,40,0.050000
2025-09-19,Erie Insurance,13,18,9,40,0.225000
2025-09-19,Estée Lauder,19,18,3,40,0.075000
2025-09-19,Etsy,14,10,16,40,0.400000
2025-09-19,Euronet Worldwide,19,20,1,40,0.025000
2025-09-19,Evergy,21,15,4,40,0.100000
2025-09-19,Eversource Energy,34,3,3,40,0.075000
2025-09-19,Exact Sciences,10,20,10,40,0.250000
2025-09-19,Exelon,16,22,2,40,0.050000
2025-09-19,Expand Energy Corporation,40,0,0,40,0.000000
2025-09-19,Expedia,20,18,2,40,0.050000
2025-09-19,Expeditors International of Washington,18,18,4,40,0.100000
2025-09-19,Extra Space Storage,14,23,3,40,0.075000
2025-09-19,Exxon Mobil,28,9,3,40,0.075000
2025-09-19,F5,25,14,1,40,0.025000
2025-09-19,FM Global,20,14,6,40,0.150000
2025-09-19,FMC Corporation,14,21,5,40,0.125000
2025-09-19,FTI Consulting,17,14,9,40,0.225000
2025-09-19,Fannie Mae,7,29,4,40,0.100000
2025-09-19,Farmers Insurance Exchange,10,18,12,40,0.300000
2025-09-19,Fastenal,17,21,2,40,0.050000
2025-09-19,FedEx,16,17,7,40,0.175000
2025-09-19,Federated Mutual Insurance,16,19,3,38,0.078947
2025-09-19,Ferguson Enterprises,16,21,3,40,0.075000
2025-09-19,Fidelity National Financial,19,15,6,40,0.150000
2025-09-19,Fidelity National Information Services,19,14,7,40,0.175000
2025-09-19,Fifth Third Bancorp,17,18,5,40,0.125000
2025-09-19,First American Financial,16,20,4,40,0.100000
2025-09-19,First Citizens BancShares,17,19,4,40,0.100000
2025-09-19,First Horizon,18,21,1,40,0.025000
2025-09-19,First National of Nebraska,16,24,0,40,0.000000
2025-09-19,First Solar,22,18,0,40,0.000000
2025-09-19,FirstCash,16,18,6,40,0.150000
2025-09-19,FirstEnergy,16,16,8,40,0.200000
2025-09-19,Fiserv,12,20,8,40,0.200000
2025-09-19,Five Below,12,17,11,40,0.275000
2025-09-19,Flagstar Financial,14,20,6,40,0.150000
2025-09-19,Flowers Foods,8,25,7,40,0.175000
2025-09-19,Flowserve,15,22,3,40,0.075000
2025-09-19,Fluor,18,7,15,40,0.375000
2025-09-19,Foot Locker,7,23,10,40,0.250000
2025-09-19,Ford Motor,9,23,8,40,0.200000
2025-09-19,Fortinet,15,15,10,40,0.250000
2025-09-19,Fortive,17,18,5,40,0.125000
2025-09-19,Fortune Brands Innovations,17,20,3,40,0.075000
2025-09-19,Franklin Resources,24,13,3,40,0.075000
2025-09-19,Freddie Mac,13,23,4,40,0.100000
2025-09-19,Freeport-McMoRan,21,13,6,40,0.150000
2025-09-19,Frontier Airlines,18,13,9,40,0.225000
2025-09-19,Frontier Communications,18,19,3,40,0.075000
2025-09-19,G-III Apparel Group,17,18,5,40,0.125000
2025-09-19,GE HealthCare Technologies,15,24,1,40,0.025000
2025-09-19,GE Vernova,23,17,0,40,0.000000
2025-09-19,GMS,15,21,4,40,0.100000
2025-09-19,GXO Logistics,12,23,5,40,0.125000
2025-09-19,GameStop,21,8,11,40,0.275000
2025-09-19,Gannett,19,15,6,40,0.150000
2025-09-19,Garrett Motion Inc,15,22,3,40,0.075000
2025-09-19,Gartner,12,24,4,40,0.100000
2025-09-19,Gen Digital,21,18,1,40,0.025000
2025-09-19,Generac,23,14,3,40,0.075000
2025-09-19,General Dynamics,38,0,2,40,0.050000
2025-09-19,General Mills,18,19,3,40,0.075000
2025-09-19,General Motors,16,18,6,40,0.150000
2025-09-19,Genesis Energy,33,5,2,40,0.050000
2025-09-19,Genuine Parts,20,20,0,40,0.000000
2025-09-19,Genworth Financial,23,16,1,40,0.025000
2025-09-19,Gilead Sciences,24,16,0,40,0.000000
2025-09-19,Global Partners,17,18,5,40,0.125000
2025-09-19,Global Payments,16,21,3,40,0.075000
2025-09-19,Globe Life,17,18,5,40,0.125000
2025-09-19,GoDaddy,15,22,3,40,0.075000
2025-09-19,Goldman Sachs,8,27,5,40,0.125000
2025-09-19,Goodyear Tire & Rubber,13,23,4,40,0.100000
2025-09-19,Graham Holdings Company,23,15,2,40,0.050000
2025-09-19,Granite Construction,23,14,3,40,0.075000
2025-09-19,Graphic Packaging,17,18,5,40,0.125000
2025-09-19,Gray Television,14,19,7,40,0.175000
2025-09-19,Graybar Electric,14,20,6,40,0.150000
2025-09-19,Green Plains Inc,22,13,5,40,0.125000
2025-09-19,Greenbrier,10,11,19,40,0.475000
2025-09-19,Greif,11,27,2,40,0.050000
2025-09-19,Griffon Corporation,20,18,2,40,0.050000
2025-09-19,Grocery Outlet Holding,18,20,2,40,0.050000
2025-09-19,Group 1 Automotive,11,24,5,40,0.125000
2025-09-19,Guardian Life insurance,20,20,0,40,0.000000
2025-09-19,Guess Inc,13,23,4,40,0.100000
2025-09-19,GuideWell Mutual,20,19,1,40,0.025000
2025-09-19,HB Fuller,15,20,5,40,0.125000
2025-09-19,HCA Healthcare,30,8,2,40,0.050000
2025-09-19,HEICO,19,17,4,40,0.100000
2025-09-19,HF SInclair,15,22,3,40,0.075000
2025-09-19,HP,14,19,7,40,0.175000
2025-09-19,Halliburton,12,18,10,40,0.250000
2025-09-19,Hanesbrands,13,24,3,40,0.075000
2025-09-19,Hanover Insurance Group,18,19,3,40,0.075000
2025-09-19,Harley-Davidson,12,22,6,40,0.150000
2025-09-19,Hasbro,20,15,5,40,0.125000
2025-09-19,Hawaiian Airlines Inc,14,26,0,40,0.000000
2025-09-19,Hawaiian Electric Industries,17,21,2,40,0.050000
2025-09-19,Helmerich & Payne,12,24,4,40,0.100000
2025-09-19,Henry Schein,20,19,1,40,0.025000
2025-09-19,Herc Rentals,18,16,6,40,0.150000
2025-09-19,Hershey,21,18,1,40,0.025000
2025-09-19,Hertz,25,9,6,40,0.150000
2025-09-19,Hewlett Packard Enterprise,18,22,0,40,0.000000
2025-09-19,Hillenbrand,16,22,2,40,0.050000
2025-09-19,Hilton Grand Vacations,38,2,0,40,0.000000
2025-09-19,Hilton Worldwide,23,16,1,40,0.025000
2025-09-19,Hologic,20,20,0,40,0.000000
2025-09-19,Home Depot,10,21,9,40,0.225000
2025-09-19,Honeywell,21,13,6,40,0.150000
2025-09-19,Hormel Foods,12,26,2,40,0.050000
2025-09-19,Host Hotels & Resorts,11,28,1,40,0.025000
2025-09-19,Hovnanian Enterprises,16,21,3,40,0.075000
2025-09-19,Howmet Aerospace,16,20,4,40,0.100000
2025-09-19,Hub Group,14,20,6,40,0.150000
2025-09-19,Hubbell,18,15,7,40,0.175000
2025-09-19,Humana,17,19,4,40,0.100000
2025-09-19,Huntington Bancshares,15,21,4,40,0.100000
2025-09-19,Huntington Ingalls Industries,19,13,8,40,0.200000
2025-09-19,Huntsman,8,19,13,40,0.325000
2025-09-19,Hyatt Hotels,13,26,1,40,0.025000
2025-09-19,Hyster-Yale,15,20,5,40,0.125000
2025-09-19,IAC,14,22,4,40,0.100000
2025-09-19,IBM,20,18,2,40,0.050000
2025-09-19,IDEX,22,14,4,40,0.100000
2025-09-19,IDEXX Laboratories,24,16,0,40,0.000000
2025-09-19,IQVIA,22,14,4,40,0.100000
2025-09-19,ITT,11,21,8,40,0.200000
2025-09-19,Icahn Enterprises,9,19,12,40,0.300000
2025-09-19,Illinois Tool Works,24,13,3,40,0.075000
2025-09-19,Illumina Inc,10,26,4,40,0.100000
2025-09-19,Incyte,27,13,0,40,0.000000
2025-09-19,Ingersoll Rand,18,17,5,40,0.125000
2025-09-19,Ingles Markets,10,18,12,40,0.300000
2025-09-19,Ingram Micro,13,15,12,40,0.300000
2025-09-19,Ingredion,20,17,3,40,0.075000
2025-09-19,Insight Enterprises,13,19,8,40,0.200000
2025-09-19,Insperity,19,18,3,40,0.075000
2025-09-19,Instacart,14,22,4,40,0.100000
2025-09-19,Installed Building Products,12,27,1,40,0.025000
2025-09-19,Intel,8,28,4,40,0.100000
2025-09-19,Interactive Brokers,20,19,1,40,0.025000
2025-09-19,Intercontinental Exchange,21,18,1,40,0.025000
2025-09-19,International Flavors & Fragrances,18,20,2,40,0.050000
2025-09-19,International Paper,15,20,5,40,0.125000
2025-09-19,Interpublic Group,20,16,4,40,0.100000
2025-09-19,Intuit,24,13,3,40,0.075000
2025-09-19,Intuitive Surgical,13,22,5,40,0.125000
2025-09-19,Iron Mountain,8,26,6,40,0.150000
2025-09-19,JB Hunt Transport Services,12,21,7,40,0.175000
2025-09-19,JELD-WEN Holding,13,21,6,40,0.150000
2025-09-19,JM Smucker,17,20,3,40,0.075000
2025-09-19,JPMorgan Chase,19,15,6,40,0.150000
2025-09-19,Jabil,14,23,3,40,0.075000
2025-09-19,Jackson Financial,22,16,2,40,0.050000
2025-09-19,Jacobs Solutions,30,3,7,40,0.175000
2025-09-19,Jefferies Financial,18,20,2,40,0.050000
2025-09-19,JetBlue Airways,18,20,2,40,0.050000
2025-09-19,Johnson & Johnson,20,19,1,40,0.025000
2025-09-19,Jones Lang LaSalle,16,23,1,40,0.025000
2025-09-19,Juniper Networks,13,24,3,40,0.075000
2025-09-19,KB Home,20,18,2,40,0.050000
2025-09-19,KBR,32,7,1,40,0.025000
2025-09-19,KKR & Co,25,13,2,40,0.050000
2025-09-19,KLA,16,14,10,40,0.250000
2025-09-19,Kaiser Aluminum,14,25,1,40,0.025000
2025-09-19,Kellanova,17,20,3,40,0.075000
2025-09-19,Kelly Services Inc,13,22,5,40,0.125000
2025-09-19,Kemper Corporation,20,14,6,40,0.150000
2025-09-19,Kenvue,17,19,4,40,0.100000
2025-09-19,Keurig Dr Pepper,7,27,6,40,0.150000
2025-09-19,KeyCorp,16,18,6,40,0.150000
2025-09-19,Keysight Technologies,25,13,2,40,0.050000
2025-09-19,Kimberly-Clark,13,21,6,40,0.150000
2025-09-19,Kinder Morgan,40,0,0,40,0.000000
2025-09-19,Kirby Corporation,18,18,4,40,0.100000
2025-09-19,Knife River Corporation,14,21,5,40,0.125000
2025-09-19,Knight Swift Transportation,16,19,5,40,0.125000
2025-09-19,Kohl's,13,18,9,40,0.225000
2025-09-19,Kontoor Brands,17,19,4,40,0.100000
2025-09-19,Korn Ferry,24,11,5,40,0.125000
2025-09-19,Kraft Heinz,16,15,9,40,0.225000
2025-09-19,Kroger,12,19,9,40,0.225000
2025-09-19,Kyndryl,17,22,1,40,0.025000
2025-09-19,L3Harris Technologies,27,10,3,40,0.075000
2025-09-19,LCI Industries,20,15,5,40,0.125000
2025-09-19,LKQ,14,23,3,40,0.075000
2025-09-19,LPL Financial,25,14,1,40,0.025000
2025-09-19,Labcorp Holdings,25,13,2,40,0.050000
2025-09-19,Lam Research,25,12,3,40,0.075000
2025-09-19,Lamb Weston,15,24,1,40,0.025000
2025-09-19,Land O'Lakes,12,25,3,40,0.075000
2025-09-19,Landstar System,17,14,9,40,0.225000
2025-09-19,Las Vegas Sands,11,28,1,40,0.025000
2025-09-19,Lear Corporation,22,15,3,40,0.075000
2025-09-19,Leggett & Platt,16,21,3,40,0.075000
2025-09-19,Leidos,23,15,2,40,0.050000
2025-09-19,Lennar,12,16,12,40,0.300000
2025-09-19,Lennox International,12,22,6,40,0.150000
2025-09-19,Levi Strauss,11,28,1,40,0.025000
2025-09-19,Liberty Energy,39,1,0,40,0.000000
2025-09-19,Liberty Media,38,2,0,40,0.000000
2025-09-19,Liberty Mutual Insurance,31,2,7,40,0.175000
2025-09-19,Light & Wonder,9,27,4,40,0.100000
2025-09-19,Lincoln Electric,16,24,0,40,0.000000
2025-09-19,Lincoln National,11,15,14,40,0.350000
2025-09-19,Lithia Motors,14,23,3,40,0.075000
2025-09-19,Live Nation Entertainment,10,15,15,40,0.375000
2025-09-19,Lockheed Martin,24,9,7,40,0.175000
2025-09-19,Loews,20,18,2,40,0.050000
2025-09-19,Louisiana-Pacific Corporation,13,21,6,40,0.150000
2025-09-19,Lowe's,14,13,13,40,0.325000
2025-09-19,Lululemon athletica,14,15,11,40,0.275000
2025-09-19,Lumen Technologies,9,24,7,40,0.175000
2025-09-19,Lyft,7,31,2,40,0.050000
2025-09-19,M&T Bank,7,26,7,40,0.175000
2025-09-19,M/I Homes,12,23,5,40,0.125000
2025-09-19,MDU Resources Group,19,19,2,40,0.050000
2025-09-19,MGM Resorts International,15,25,0,40,0.000000
2025-09-19,MKS Instruments,18,21,1,40,0.025000
2025-09-19,MRC Global,17,22,1,40,0.025000
2025-09-19,MSC Industrial Direct,14,22,4,40,0.100000
2025-09-19,MSCI,18,20,2,40,0.050000
2025-09-19,MYR Group,21,16,3,40,0.075000
2025-09-19,Macys,18,19,3,40,0.075000
2025-09-19,ManpowerGroup,19,14,7,40,0.175000
2025-09-19,Marathon Oil,15,21,4,40,0.100000
2025-09-19,Marathon Petroleum,20,18,2,40,0.050000
2025-09-19,Markel Group,25,15,0,40,0.000000
2025-09-19,Marriott International,25,12,3,40,0.075000
2025-09-19,Marriott Vacations Worldwide,19,18,3,40,0.075000
2025-09-19,Marsh & McLennan,23,11,6,40,0.150000
2025-09-19,Martin Marietta Materials,16,16,8,40,0.200000
2025-09-19,Marvell Technology,22,16,2,40,0.050000
2025-09-19,MasTec,20,19,1,40,0.025000
2025-09-19,Masco,15,23,2,40,0.050000
2025-09-19,Mass Mutual,13,24,3,40,0.075000
2025-09-19,MasterBrand,13,25,2,40,0.050000
2025-09-19,Mastercard,20,17,3,40,0.075000
2025-09-19,Matador Resources,22,17,1,40,0.025000
2025-09-19,Match Group,13,17,10,40,0.250000
2025-09-19,Mativ,17,18,5,40,0.125000
2025-09-19,Matson Inc,22,13,5,40,0.125000
2025-09-19,Mattel,15,19,6,40,0.150000
2025-09-19,Maximus,10,23,7,40,0.175000
2025-09-19,McCormick & Company,14,21,5,40,0.125000
2025-09-19,McDonalds,4,31,5,40,0.125000
2025-09-19,McKesson,24,15,1,40,0.025000
2025-09-19,Medical Mutual of Ohio,14,17,9,40,0.225000
2025-09-19,Merck,21,15,4,40,0.100000
2025-09-19,Mercury General,16,17,7,40,0.175000
2025-09-19,Meritage Homes,11,25,4,40,0.100000
2025-09-19,MetLife,24,14,2,40,0.050000
2025-09-19,Meta Platforms,20,10,10,40,0.250000
2025-09-19,Mettler-Toledo International,24,15,1,40,0.025000
2025-09-19,Microchip Technology,23,15,2,40,0.050000
2025-09-19,Micron Technology,17,19,4,40,0.100000
2025-09-19,Microsoft,18,13,9,40,0.225000
2025-09-19,Middleby,13,22,5,40,0.125000
2025-09-19,MillerKnoll,16,20,4,40,0.100000
2025-09-19,Moderna,17,17,6,40,0.150000
2025-09-19,ModivCare,12,19,9,40,0.225000
2025-09-19,Mohawk Industries,19,18,3,40,0.075000
2025-09-19,Molina Healthcare,21,14,5,40,0.125000
2025-09-19,Molson Coors Beverage,17,17,6,40,0.150000
2025-09-19,Mondelez,19,17,4,40,0.100000
2025-09-19,Monster Beverage,23,16,1,40,0.025000
2025-09-19,Moodys Corporation,4,13,4,21,0.190476
2025-09-19,Moog Inc,25,14,1,40,0.025000
2025-09-19,Morgan Stanley,11,15,14,40,0.350000
2025-09-19,Motorola Solutions,34,2,4,40,0.100000
2025-09-19,Mueller Industries,25,12,3,40,0.075000
2025-09-19,Murphy Oil,12,23,5,40,0.125000
2025-09-19,Murphy USA,18,20,2,40,0.050000
2025-09-19,Mutual of Omaha,21,17,2,40,0.050000
2025-09-19,NCR Atleos,13,25,2,40,0.050000
2025-09-19,NCR Voyix,16,20,4,40,0.100000
2025-09-19,NGL Energy Partners,34,2,4,40,0.100000
2025-09-19,NLV Financial,5,2,3,10,0.300000
2025-09-19,NOV,12,23,5,40,0.125000
2025-09-19,NRG Energy,35,3,2,40,0.050000
2025-09-19,NVR Inc,18,16,6,40,0.150000
2025-09-19,Nasdaq Inc,16,22,2,40,0.050000
2025-09-19,Nationwide Insurance,11,18,11,40,0.275000
2025-09-19,Navient,19,12,9,40,0.225000
2025-09-19,NetApp,16,22,2,40,0.050000
2025-09-19,Netflix,12,18,10,40,0.250000
2025-09-19,NeueHealth,15,23,2,40,0.050000
2025-09-19,New York Life Insurance,16,22,2,40,0.050000
2025-09-19,NewMarket Corporation,19,20,1,40,0.025000
2025-09-19,Newell Brands,9,22,9,40,0.225000
2025-09-19,Newmont,9,27,4,40,0.100000
2025-09-19,News Corp,12,19,9,40,0.225000
2025-09-19,Nexstar Media Group,8,20,12,40,0.300000
2025-09-19,NextEra Energy,40,0,0,40,0.000000
2025-09-19,NiSource,19,11,10,40,0.250000
2025-09-19,Nike,18,15,7,40,0.175000
2025-09-19,Nordson,19,20,1,40,0.025000
2025-09-19,Nordstrom,16,20,4,40,0.100000
2025-09-19,Norfolk Southern,16,16,8,40,0.200000
2025-09-19,Northern Trust,37,3,0,40,0.000000
2025-09-19,Northrop Grumman,15,20,5,40,0.125000
2025-09-19,Northwestern Mutual,16,13,11,40,0.275000
2025-09-19,Nucor,15,14,11,40,0.275000
2025-09-19,Nvidia,5,23,12,40,0.300000
2025-09-19,O'Reilly Automotive,8,19,13,40,0.325000
2025-09-19,O-I Glass,18,18,4,40,0.100000
2025-09-19,ODP Business Solutions,17,22,1,40,0.025000
2025-09-19,OGE Energy,38,1,1,40,0.025000
2025-09-19,ON Semiconductor,16,19,5,40,0.125000
2025-09-19,Occidental Petroleum,14,16,10,40,0.250000
2025-09-19,Old National Bancorp,17,22,1,40,0.025000
2025-09-19,Old Republic International,22,15,3,40,0.075000
2025-09-19,Olin,16,18,6,40,0.150000
2025-09-19,Omnicom Group,19,18,3,40,0.075000
2025-09-19,OneMain,18,22,0,40,0.000000
2025-09-19,Oneok,22,18,0,40,0.000000
2025-09-19,Opendoor Technologies,12,19,9,40,0.225000
2025-09-19,Option Care Health,39,1,0,40,0.000000
2025-09-19,Oracle,18,19,3,40,0.075000
2025-09-19,Organon,22,13,5,40,0.125000
2025-09-19,Oscar Health,15,23,2,40,0.050000
2025-09-19,Oshkosh Corporation,21,15,4,40,0.100000
2025-09-19,Otis Worldwide,13,20,7,40,0.175000
2025-09-19,Ovintiv,23,12,5,40,0.125000
2025-09-19,Owens & Minor,11,21,8,40,0.200000
2025-09-19,Owens Corning,14,24,2,40,0.050000
2025-09-19,PACS Group,16,14,10,40,0.250000
2025-09-19,PBF Energy,33,1,6,40,0.150000
2025-09-19,PC Connection Inc,26,13,1,40,0.025000
2025-09-19,PENN Entertainment,34,5,1,40,0.025000
2025-09-19,PG&E,19,10,11,40,0.275000
2025-09-19,PNC Financial Services,21,17,2,40,0.050000
2025-09-19,PPG Industries,14,20,6,40,0.150000
2025-09-19,PPL Corporation,16,21,3,40,0.075000
2025-09-19,PVH,17,17,6,40,0.150000
2025-09-19,Paccar,18,17,5,40,0.125000
2025-09-19,Pacific Life,20,20,0,40,0.000000
2025-09-19,Packaging Corp of America,9,29,2,40,0.050000
2025-09-19,Palo Alto Networks,13,19,8,40,0.200000
2025-09-19,Par Pacific,17,22,1,40,0.025000
2025-09-19,Paramount Global,6,28,6,40,0.150000
2025-09-19,Park Hotels & Resorts,17,20,3,40,0.075000
2025-09-19,Parker-Hannifin,24,15,1,40,0.025000
2025-09-19,Parsons Corporation,24,15,1,40,0.025000
2025-09-19,Patrick Industries,13,22,5,40,0.125000
2025-09-19,Patterson Companies Inc,8,30,2,40,0.050000
2025-09-19,Patterson-UTI Energy,36,3,1,40,0.025000
2025-09-19,PayPal,17,20,3,40,0.075000
2025-09-19,Paychex,20,14,6,40,0.150000
2025-09-19,Peabody Energy,34,4,2,40,0.050000
2025-09-19,Peloton Interactive,23,13,4,40,0.100000
2025-09-19,Penn Mutual Life Insurance,18,18,4,40,0.100000
2025-09-19,PennyMac Financial Services,17,19,4,40,0.100000
2025-09-19,Penske Automotive,10,29,1,40,0.025000
2025-09-19,PepsiCo,27,12,1,40,0.025000
2025-09-19,Performance Food,21,17,2,40,0.050000
2025-09-19,Permian Resources,23,14,3,40,0.075000
2025-09-19,Petco Health and Wellness,32,5,3,40,0.075000
2025-09-19,Peter Kiewit Sons',7,21,12,40,0.300000
2025-09-19,Pfizer,22,14,4,40,0.100000
2025-09-19,Philip Morris International,13,26,1,40,0.025000
2025-09-19,Phillips 66,13,25,2,40,0.050000
2025-09-19,Pinnacle West Capital,15,12,13,40,0.325000
2025-09-19,Pinterest,16,22,2,40,0.050000
2025-09-19,Pioneer Natural Resources,31,6,3,40,0.075000
2025-09-19,Pitney Bowes,22,18,0,40,0.000000
2025-09-19,Plains GP,16,9,15,40,0.375000
2025-09-19,Playtika Holding,13,18,9,40,0.225000
2025-09-19,Plexus Corp,16,21,3,40,0.075000
2025-09-19,Polaris Inc,23,16,1,40,0.025000
2025-09-19,Pool Corporation,18,20,2,40,0.050000
2025-09-19,Popular Inc,40,0,0,40,0.000000
2025-09-19,Portland General Electric,17,19,4,40,0.100000
2025-09-19,Post Holdings,13,27,0,40,0.000000
2025-09-19,PrIncipal Financial,17,22,1,40,0.025000
2025-09-19,PriceSmart,17,21,2,40,0.050000
2025-09-19,Primerica,23,13,4,40,0.100000
2025-09-19,Primoris Services,23,15,2,40,0.050000
2025-09-19,ProFrac Holding,15,19,6,40,0.150000
2025-09-19,Procter & Gamble,22,14,4,40,0.100000
2025-09-19,Progressive Insurance,13,21,6,40,0.150000
2025-09-19,Prologis,19,19,2,40,0.050000
2025-09-19,Prudential Financial,16,20,4,40,0.100000
2025-09-19,Public Service Enterprise Group,19,20,1,40,0.025000
2025-09-19,Public Storage,19,16,5,40,0.125000
2025-09-19,Publix Super Markets,22,15,3,40,0.075000
2025-09-19,Puget Sound Energy,31,7,2,40,0.050000
2025-09-19,PulteGroup,18,20,2,40,0.050000
2025-09-19,Pure Storage,17,20,3,40,0.075000
2025-09-19,QVC Group,12,24,4,40,0.100000
2025-09-19,QXO Building Products,1,6,3,10,0.300000
2025-09-19,Qorvo,18,17,5,40,0.125000
2025-09-19,Qualcomm,23,16,1,40,0.025000
2025-09-19,Quanta Services,19,18,3,40,0.075000
2025-09-19,Quest Diagnostics,10,27,3,40,0.075000
2025-09-19,QuidelOrtho,17,21,2,40,0.050000
2025-09-19,REV Group,22,12,6,40,0.150000
2025-09-19,RPM International,18,20,2,40,0.050000
2025-09-19,RTX,21,15,4,40,0.100000
2025-09-19,RXO Inc,20,19,1,40,0.025000
2025-09-19,Rackspace Technology,12,22,6,40,0.150000
2025-09-19,Radius Recycling,5,22,13,40,0.325000
2025-09-19,Ralph Lauren,10,29,1,40,0.025000
2025-09-19,Range Resources,18,17,5,40,0.125000
2025-09-19,Raymond James Financial,18,21,1,40,0.025000
2025-09-19,Realty Income,23,15,2,40,0.050000
2025-09-19,Regal Rexnord,12,21,7,40,0.175000
2025-09-19,Regeneron Pharmaceuticals,28,10,2,40,0.050000
2025-09-19,Regions Financial,20,18,2,40,0.050000
2025-09-19,Reinsurance Group of America,21,18,1,40,0.025000
2025-09-19,Reliance Inc,31,8,1,40,0.025000
2025-09-19,Republic Services,15,14,11,40,0.275000
2025-09-19,ResMed,15,23,2,40,0.050000
2025-09-19,Resideo Technologies,20,17,3,40,0.075000
2025-09-19,Restoration Hardware,11,22,7,40,0.175000
2025-09-19,Revvity,17,18,5,40,0.125000
2025-09-19,Rithm Capital,7,31,2,40,0.050000
2025-09-19,Rivian Automotive,9,27,4,40,0.100000
2025-09-19,Robert Half,23,16,1,40,0.025000
2025-09-19,Roblox,15,9,16,40,0.400000
2025-09-19,Rocket Companies,15,21,4,40,0.100000
2025-09-19,Rockwell Automation,21,18,1,40,0.025000
2025-09-19,Roku,25,13,2,40,0.050000
2025-09-19,Rollins Inc,17,21,2,40,0.050000
2025-09-19,Roper Technologies,11,28,1,40,0.025000
2025-09-19,Ross Stores,13,25,2,40,0.050000
2025-09-19,Rush Enterprises,19,18,3,40,0.075000
2025-09-19,Ryder System,21,16,3,40,0.075000
2025-09-19,Ryerson Holding,9,26,5,40,0.125000
2025-09-19,S&P Global,15,20,5,40,0.125000
2025-09-19,SBA Communications,12,17,11,40,0.275000
2025-09-19,SS&C Technologies,18,22,0,40,0.000000
2025-09-19,Sabre Corporation,18,16,6,40,0.150000
2025-09-19,Saia Inc,21,15,4,40,0.100000
2025-09-19,Salesforce,14,13,13,40,0.325000
2025-09-19,Sallie Mae,14,21,5,40,0.125000
2025-09-19,Sally Beauty,39,1,0,40,0.000000
2025-09-19,Sanmina,14,25,1,40,0.025000
2025-09-19,ScanSource,22,15,3,40,0.075000
2025-09-19,Schneider National,19,17,4,40,0.100000
2025-09-19,Science Applications International,15,18,7,40,0.175000
2025-09-19,Scotts Miracle-Gro,17,18,5,40,0.125000
2025-09-19,Seaboard,20,14,6,40,0.150000
2025-09-19,Sealed Air Corporation,14,22,4,40,0.100000
2025-09-19,Securian Financial,12,26,2,40,0.050000
2025-09-19,Select Medical Holdings,17,18,5,40,0.125000
2025-09-19,Selective Insurance Group,23,12,5,40,0.125000
2025-09-19,Sempra,26,14,0,40,0.000000
2025-09-19,Sentry Insurance Group,3,7,0,10,0.000000
2025-09-19,Service Corp International,8,11,5,24,0.208333
2025-09-19,ServiceNow,17,20,3,40,0.075000
2025-09-19,Sherwin-Williams,9,24,7,40,0.175000
2025-09-19,Shift4 Payments,14,20,6,40,0.150000
2025-09-19,Silgan,10,23,7,40,0.175000
2025-09-19,Simon Property Group,16,22,2,40,0.050000
2025-09-19,Sinclair,10,26,4,40,0.100000
2025-09-19,Sirius XM,14,22,4,40,0.100000
2025-09-19,SiteOne Landscape Supply,15,17,8,40,0.200000
2025-09-19,Skechers USA,15,23,2,40,0.050000
2025-09-19,SkyWest,12,20,8,40,0.200000
2025-09-19,Skyline Champion,33,5,2,40,0.050000
2025-09-19,Skyworks Solutions,32,3,5,40,0.125000
2025-09-19,Smurfit Westrock,8,25,7,40,0.175000
2025-09-19,Snap Inc,16,12,12,40,0.300000
2025-09-19,Snap-on,14,24,2,40,0.050000
2025-09-19,Snowflake Inc,25,14,1,40,0.025000
2025-09-19,Solventum,15,23,2,40,0.050000
2025-09-19,Sonic Automotive,10,24,6,40,0.150000
2025-09-19,Sonoco Products,21,16,3,40,0.075000
2025-09-19,Southern Company,27,12,1,40,0.025000
2025-09-19,Southwest Airlines,11,21,8,40,0.200000
2025-09-19,Southwest Gas Holdings,14,24,2,40,0.050000
2025-09-19,SpartanNash,15,24,1,40,0.025000
2025-09-19,Spectrum Brands,14,17,9,40,0.225000
2025-09-19,Spire Inc,25,13,2,40,0.050000
2025-09-19,Spirit AeroSystems,30,3,7,40,0.175000
2025-09-19,Spirit Airlines,16,3,21,40,0.525000
2025-09-19,Splunk,13,23,4,40,0.100000
2025-09-19,Sprouts Farmers Market,11,25,4,40,0.100000
2025-09-19,Stagwell,9,23,8,40,0.200000
2025-09-19,Stanley Black & Decker,12,26,2,40,0.050000
2025-09-19,Starbucks,12,21,7,40,0.175000
2025-09-19,State Farm Insurance,10,20,10,40,0.250000
2025-09-19,State Street,13,23,4,40,0.100000
2025-09-19,Steel Dynamics,36,1,3,40,0.075000
2025-09-19,Steelcase,17,21,2,40,0.050000
2025-09-19,Stericycle,11,8,21,40,0.525000
2025-09-19,Stifel Financial,21,18,1,40,0.025000
2025-09-19,StoneX Group,15,24,1,40,0.025000
2025-09-19,Stryker,17,22,1,40,0.025000
2025-09-19,Summit Materials,11,26,3,40,0.075000
2025-09-19,Sun Communities,24,16,0,40,0.000000
2025-09-19,Super Micro Computer,37,1,2,40,0.050000
2025-09-19,Surgery Partners,18,18,4,40,0.100000
2025-09-19,Sylvamo,12,24,4,40,0.100000
2025-09-19,Synchrony Financial,20,17,3,40,0.075000
2025-09-19,Synopsys,18,14,8,40,0.200000
2025-09-19,Synovus Financial,20,17,3,40,0.075000
2025-09-19,Sysco,23,16,1,40,0.025000
2025-09-19,T Rowe Price,18,22,0,40,0.000000
2025-09-19,TD Synnex,24,16,0,40,0.000000
2025-09-19,TEGNA,15,20,5,40,0.125000
2025-09-19,THOR Industries,12,22,6,40,0.150000
2025-09-19,TIAA,14,22,4,40,0.100000
2025-09-19,TJX,22,15,3,40,0.075000
2025-09-19,Take-Two Interactive Software,19,20,1,40,0.025000
2025-09-19,Talen Energy,39,0,1,40,0.025000
2025-09-19,Tapestry,11,18,11,40,0.275000
2025-09-19,Targa Resources,20,18,2,40,0.050000
2025-09-19,Target Corporation,11,23,6,40,0.150000
2025-09-19,Taylor Morrison Home,18,18,4,40,0.100000
2025-09-19,Teladoc Health,16,18,6,40,0.150000
2025-09-19,Teledyne Technologies,23,17,0,40,0.000000
2025-09-19,Teleflex,10,28,2,40,0.050000
2025-09-19,Telephone & Data Systems,13,20,2,35,0.057143
2025-09-19,TelevisaUnivision,11,18,11,40,0.275000
2025-09-19,Tempur Sealy International,12,23,5,40,0.125000
2025-09-19,Tenet Healthcare,23,16,1,40,0.025000
2025-09-19,Teradyne,21,17,2,40,0.050000
2025-09-19,Tesla,11,12,17,40,0.425000
2025-09-19,Tetra Tech,22,15,3,40,0.075000
2025-09-19,Texas Instruments,13,21,6,40,0.150000
2025-09-19,Texas Roadhouse,17,14,9,40,0.225000
2025-09-19,Textron,12,24,4,40,0.100000
2025-09-19,The Andersons Inc,14,24,2,40,0.050000
2025-09-19,The Coca-Cola Company,14,20,6,40,0.150000
2025-09-19,The Hartford,19,14,7,40,0.175000
2025-09-19,The Mosaic Company,17,15,8,40,0.200000
2025-09-19,Thermo Fisher Scientific,27,10,3,40,0.075000
2025-09-19,Thrivent Financial for Lutherans,15,20,5,40,0.125000
2025-09-19,Timken,14,23,3,40,0.075000
2025-09-19,Titan Machinery,11,23,6,40,0.150000
2025-09-19,Toast Inc,19,19,2,40,0.050000
2025-09-19,Toll Brothers,11,29,0,40,0.000000
2025-09-19,TopBuild,16,24,0,40,0.000000
2025-09-19,Topgolf Callaway Brands,15,21,4,40,0.100000
2025-09-19,Toro Company,16,22,2,40,0.050000
2025-09-19,Tractor Supply,12,26,2,40,0.050000
2025-09-19,TransDigm,19,16,5,40,0.125000
2025-09-19,TransUnion,18,10,12,40,0.300000
2025-09-19,Travelers Insurance,12,18,10,40,0.250000
2025-09-19,TreeHouse Foods,13,16,11,40,0.275000
2025-09-19,Tri Pointe Homes,14,25,1,40,0.025000
2025-09-19,TriNet Group,20,17,3,40,0.075000
2025-09-19,Trimble Inc,19,19,2,40,0.050000
2025-09-19,Trinity Industries,18,14,8,40,0.200000
2025-09-19,TruStage,27,11,2,40,0.050000
2025-09-19,Truist Financial,17,20,3,40,0.075000
2025-09-19,Tutor Perini Corporation,24,15,1,40,0.025000
2025-09-19,Twilio,21,18,1,40,0.025000
2025-09-19,Tyson Foods,13,17,10,40,0.250000
2025-09-19,U-Haul,9,13,18,40,0.450000
2025-09-19,UFP Industries,10,24,6,40,0.150000
2025-09-19,UGI Utilities Inc,18,13,9,40,0.225000
2025-09-19,UL Solutions,35,1,4,40,0.100000
2025-09-19,UPS,12,17,11,40,0.275000
2025-09-19,US Bancorp,16,18,6,40,0.150000
2025-09-19,US Foods,29,10,1,40,0.025000
2025-09-19,USAA,17,15,8,40,0.200000
2025-09-19,Uber,8,23,9,40,0.225000
2025-09-19,Ulta Beauty,35,4,1,40,0.025000
2025-09-19,Under Armour,6,27,7,40,0.175000
2025-09-19,Union Pacific,13,17,10,40,0.250000
2025-09-19,United Airlines,32,6,2,40,0.050000
2025-09-19,United Natural Foods,33,4,3,40,0.075000
2025-09-19,United Rentals,40,0,0,40,0.000000
2025-09-19,United States Steel,25,12,3,40,0.075000
2025-09-19,UnitedHealth,19,16,5,40,0.125000
2025-09-19,Universal Corporation,19,18,3,40,0.075000
2025-09-19,Universal Health Services,16,18,6,40,0.150000
2025-09-19,Unum Group,15,19,6,40,0.150000
2025-09-19,Upbound Group,25,15,0,40,0.000000
2025-09-19,Urban Outfitters,15,23,2,40,0.050000
2025-09-19,V2X,22,11,7,40,0.175000
2025-09-19,VF Corporation,14,12,14,40,0.350000
2025-09-19,VICI Properties,14,25,1,40,0.025000
2025-09-19,Vail Resorts,6,18,16,40,0.400000
2025-09-19,Valero Energy,34,5,1,40,0.025000
2025-09-19,Valley National Bancorp,12,24,4,40,0.100000
2025-09-19,Valmont Industries,24,16,0,40,0.000000
2025-09-19,Valvoline Inc,17,21,2,40,0.050000
2025-09-19,Ventas Inc,29,10,1,40,0.025000
2025-09-19,Verisk Analytics,14,16,10,40,0.250000
2025-09-19,Verizon,20,12,8,40,0.200000
2025-09-19,Vertex Pharmaceuticals,22,14,4,40,0.100000
2025-09-19,Vertiv,25,15,0,40,0.000000
2025-09-19,Viasat,13,27,0,40,0.000000
2025-09-19,Viatris,10,21,9,40,0.225000
2025-09-19,Victorias Secret,15,13,12,40,0.300000
2025-09-19,Visa Inc,24,14,2,40,0.050000
2025-09-19,Vishay Intertechnology,11,23,6,40,0.150000
2025-09-19,Vista Outdoor,14,22,4,40,0.100000
2025-09-19,Visteon,17,21,2,40,0.050000
2025-09-19,Vistra,26,13,1,40,0.025000
2025-09-19,Vontier,18,20,2,40,0.050000
2025-09-19,Voya Financial,26,12,2,40,0.050000
2025-09-19,Vulcan Materials,12,21,7,40,0.175000
2025-09-19,WEC Energy,39,0,1,40,0.025000
2025-09-19,WESCO International,17,20,3,40,0.075000
2025-09-19,WEX,25,12,3,40,0.075000
2025-09-19,WR Berkley,18,21,1,40,0.025000
2025-09-19,WW Grainger,24,12,4,40,0.100000
2025-09-19,Wabash National,18,9,13,40,0.325000
2025-09-19,Walmart,15,14,11,40,0.275000
2025-09-19,Walt Disney,16,17,7,40,0.175000
2025-09-19,Warner Bros Discovery,2,8,2,12,0.166667
2025-09-19,Warner Music Group,6,32,2,40,0.050000
2025-09-19,Waters Corporation,21,15,4,40,0.100000
2025-09-19,Watsco,9,20,11,40,0.275000
2025-09-19,Wayfair,16,20,4,40,0.100000
2025-09-19,Webster Financial,18,18,4,40,0.100000
2025-09-19,Weis Markets,10,23,7,40,0.175000
2025-09-19,Wells Fargo,34,2,4,40,0.100000
2025-09-19,Welltower,29,10,1,40,0.025000
2025-09-19,Werner Enterprises,19,13,8,40,0.200000
2025-09-19,West Pharmaceutical Services,20,16,4,40,0.100000
2025-09-19,Western & Southern Financial,13,23,4,40,0.100000
2025-09-19,Western Alliance Bancorp,16,15,9,40,0.225000
2025-09-19,Western Digital,15,19,6,40,0.150000
2025-09-19,Western Midstream Partners,23,15,2,40,0.050000
2025-09-19,Western Union,15,20,5,40,0.125000
2025-09-19,Westinghouse Air Brake Technologies,21,16,3,40,0.075000
2025-09-19,Weyerhaeuser,13,23,4,40,0.100000
2025-09-19,Whirlpool,13,18,9,40,0.225000
2025-09-19,Williams Companies,19,20,1,40,0.025000
2025-09-19,Williams-Sonoma,14,23,3,40,0.075000
2025-09-19,Winnebago Industries,11,24,5,40,0.125000
2025-09-19,Wintrust Financial,14,24,2,40,0.050000
2025-09-19,Woodward Inc,15,25,0,40,0.000000
2025-09-19,Workday,16,17,7,40,0.175000
2025-09-19,World Kinect,15,20,5,40,0.125000
2025-09-19,Worthington Enterprises,16,22,2,40,0.050000
2025-09-19,Wynn Resorts,14,16,10,40,0.250000
2025-09-19,XPO,16,21,3,40,0.075000
2025-09-19,Xcel Energy,33,6,1,40,0.025000
2025-09-19,Xerox,12,24,4,40,0.100000
2025-09-19,Xylem Inc,20,20,0,40,0.000000
2025-09-19,Yum Brands,11,27,2,40,0.050000
2025-09-19,Yum China,18,15,7,40,0.175000
2025-09-19,Zebra Technologies,19,19,2,40,0.050000
2025-09-19,Zimmer Biomet,13,24,3,40,0.075000
2025-09-19,Zions Bancorp,19,17,4,40,0.100000
2025-09-19,Zoetis,29,10,1,40,0.025000
2025-09-19,Zoom Video Communications,15,20,5,40,0.125000
2025-09-19,eXp World,14,22,4,40,0.100000
2025-09-19,iHeartMedia,11,26,3,40,0.075000
2025-09-20,3M,20,13,7,40,0.175000
2025-09-20,A O Smith,11,29,0,40,0.000000
2025-09-20,A-Mark Precious Metals,38,2,0,40,0.000000
2025-09-20,ABM Industries,8,21,11,40,0.275000
2025-09-20,ADT,18,20,2,40,0.050000
2025-09-20,AECOM,21,17,2,40,0.050000
2025-09-20,AES,18,18,4,40,0.100000
2025-09-20,AGCO,17,17,6,40,0.150000
2025-09-20,AGNC Investment,17,20,3,40,0.075000
2025-09-20,AIG,9,26,5,40,0.125000
2025-09-20,AMC Entertainment,35,2,3,40,0.075000
2025-09-20,AMC Networks,14,18,8,40,0.200000
2025-09-20,AMN Healthcare Services,15,19,6,40,0.150000
2025-09-20,APA,20,17,3,40,0.075000
2025-09-20,APi Group,22,15,3,40,0.075000
2025-09-20,ARKO,12,26,2,40,0.050000
2025-09-20,ASGN,15,17,8,40,0.200000
2025-09-20,AT&T,18,16,6,40,0.150000
2025-09-20,ATI Inc,20,18,2,40,0.050000
2025-09-20,AbbVie,16,19,5,40,0.125000
2025-09-20,Abbott Laboratories,27,10,3,40,0.075000
2025-09-20,Abercrombie & Fitch,20,18,2,40,0.050000
2025-09-20,Academy Sports and Outdoors,18,20,2,40,0.050000
2025-09-20,Acadia Healthcare,7,23,10,40,0.250000
2025-09-20,Ace Hardware,15,17,8,40,0.200000
2025-09-20,Acuity Inc,20,19,1,40,0.025000
2025-09-20,Adams Resources & Energy,17,5,2,24,0.083333
2025-09-20,AdaptHealth,15,19,6,40,0.150000
2025-09-20,Adobe,18,20,2,40,0.050000
2025-09-20,Advance Auto Parts,11,24,5,40,0.125000
2025-09-20,Advanced Drainage Systems,34,2,4,40,0.100000
2025-09-20,Advanced Micro Devices,27,5,8,40,0.200000
2025-09-20,Advantage Solutions,36,1,3,40,0.075000
2025-09-20,Aflac,15,16,9,40,0.225000
2025-09-20,Agilent Technologies,28,11,1,40,0.025000
2025-09-20,Agilon Health,14,19,7,40,0.175000
2025-09-20,Air Lease,17,20,3,40,0.075000
2025-09-20,Air Products & Chemicals,15,21,4,40,0.100000
2025-09-20,Airbnb,15,19,6,40,0.150000
2025-09-20,Akamai Technologies,24,11,5,40,0.125000
2025-09-20,Alaska Air,18,15,7,40,0.175000
2025-09-20,Albemarle Corporation,19,17,4,40,0.100000
2025-09-20,Albertsons,17,18,5,40,0.125000
2025-09-20,Alcoa Corporation,8,25,7,40,0.175000
2025-09-20,Alexandria Real Estate Equities,22,18,0,40,0.000000
2025-09-20,Alight Solutions,17,20,3,40,0.075000
2025-09-20,Align Technology,10,22,8,40,0.200000
2025-09-20,Allegiant Travel Company,12,25,3,40,0.075000
2025-09-20,Alliance Resource Partners,13,17,10,40,0.250000
2025-09-20,Alliant Energy,32,6,2,40,0.050000
2025-09-20,Allison Transmission,14,21,5,40,0.125000
2025-09-20,Allstate,28,5,7,40,0.175000
2025-09-20,Ally Financial,16,23,1,40,0.025000
2025-09-20,Alpha Metallurgical Resources,19,16,5,40,0.125000
2025-09-20,Alphabet,19,17,4,40,0.100000
2025-09-20,Altice USA,16,19,5,40,0.125000
2025-09-20,Altria,26,12,2,40,0.050000
2025-09-20,Amazon,32,3,5,40,0.125000
2025-09-20,Ameren,15,20,5,40,0.125000
2025-09-20,American Airlines,11,12,17,40,0.425000
2025-09-20,American Axle & Manufacturing,15,20,5,40,0.125000
2025-09-20,American Eagle Outfitters,11,21,8,40,0.200000
2025-09-20,American Electric Power,17,18,5,40,0.125000
2025-09-20,American Express,22,17,1,40,0.025000
2025-09-20,American Family Insurance,20,16,4,40,0.100000
2025-09-20,American Financial Group,11,26,3,40,0.075000
2025-09-20,American Tower,19,20,1,40,0.025000
2025-09-20,American Water Works,22,15,3,40,0.075000
2025-09-20,Americold Realty Trust,37,2,1,40,0.025000
2025-09-20,Ameriprise Financial,24,14,2,40,0.050000
2025-09-20,Ametek,25,12,3,40,0.075000
2025-09-20,Amgen,24,16,0,40,0.000000
2025-09-20,Amica Mutual Insurance,13,25,2,40,0.050000
2025-09-20,Amkor Technology,14,24,2,40,0.050000
2025-09-20,Amphenol,21,18,1,40,0.025000
2025-09-20,Analog Devices,23,17,0,40,0.000000
2025-09-20,Antero Resources,15,22,3,40,0.075000
2025-09-20,Anywhere Real Estate Inc,19,18,3,40,0.075000
2025-09-20,Apollo Global Management,19,18,3,40,0.075000
2025-09-20,AppLovin,22,17,1,40,0.025000
2025-09-20,Apple,16,19,5,40,0.125000
2025-09-20,Applied Industrial Technologies,17,23,0,40,0.000000
2025-09-20,Applied Materials,10,14,16,40,0.400000
2025-09-20,AptarGroup,18,19,3,40,0.075000
2025-09-20,Aramark,24,15,1,40,0.025000
2025-09-20,ArcBest,18,18,4,40,0.100000
2025-09-20,Arch Resources,30,7,3,40,0.075000
2025-09-20,Archer Daniels Midland,18,17,5,40,0.125000
2025-09-20,Ares Management,20,19,1,40,0.025000
2025-09-20,Arista Networks,19,19,2,40,0.050000
2025-09-20,Arrow Electronics,17,20,3,40,0.075000
2025-09-20,Arthur J Gallagher,18,20,2,40,0.050000
2025-09-20,Asbury Automotive Group,14,23,3,40,0.075000
2025-09-20,Assurant,21,15,4,40,0.100000
2025-09-20,Atkore,21,17,2,40,0.050000
2025-09-20,Atlassian,7,12,21,40,0.525000
2025-09-20,Atmos Energy,35,3,2,40,0.050000
2025-09-20,Auto-Owners Insurance,16,19,5,40,0.125000
2025-09-20,AutoNation,18,18,4,40,0.100000
2025-09-20,AutoZone,20,18,2,40,0.050000
2025-09-20,Autodesk,16,24,0,40,0.000000
2025-09-20,Autoliv,22,14,4,40,0.100000
2025-09-20,Automatic Data Processing,28,11,1,40,0.025000
2025-09-20,AvalonBay Communities,9,27,4,40,0.100000
2025-09-20,Avantor,11,22,7,40,0.175000
2025-09-20,Avery Dennison,22,17,1,40,0.025000
2025-09-20,Avient,10,22,8,40,0.200000
2025-09-20,Avis Budget,11,22,7,40,0.175000
2025-09-20,Avnet,15,24,1,40,0.025000
2025-09-20,BJ's Wholesale Club,20,13,7,40,0.175000
2025-09-20,BOK Financial,25,11,4,40,0.100000
2025-09-20,BWX Technologies,29,9,2,40,0.050000
2025-09-20,Baker Hughes,21,14,5,40,0.125000
2025-09-20,Ball Corporation,16,22,2,40,0.050000
2025-09-20,Bank of America,17,19,4,40,0.100000
2025-09-20,Bank of New York Mellon,22,16,2,40,0.050000
2025-09-20,Bath & Body Works,18,13,9,40,0.225000
2025-09-20,Baxter International,13,23,4,40,0.100000
2025-09-20,Becton Dickinson,26,10,4,40,0.100000
2025-09-20,Belden,13,24,3,40,0.075000
2025-09-20,Benchmark Electronics,17,20,3,40,0.075000
2025-09-20,Berkshire Hathaway,11,15,14,40,0.350000
2025-09-20,Berry Global,9,24,7,40,0.175000
2025-09-20,Best Buy,38,2,0,40,0.000000
2025-09-20,Bio-Rad Laboratories,16,20,4,40,0.100000
2025-09-20,Biogen,15,18,7,40,0.175000
2025-09-20,BlackRock,19,16,5,40,0.125000
2025-09-20,Blackstone,17,17,6,40,0.150000
2025-09-20,Bloomin Brands,6,26,8,40,0.200000
2025-09-20,BlueLinx,14,20,6,40,0.150000
2025-09-20,Boeing,9,12,19,40,0.475000
2025-09-20,Boise Cascade,11,15,14,40,0.350000
2025-09-20,Booking Holdings,20,17,3,40,0.075000
2025-09-20,Booz Allen Hamilton,16,21,3,40,0.075000
2025-09-20,BorgWarner,25,14,1,40,0.025000
2025-09-20,Boston Properties,9,24,7,40,0.175000
2025-09-20,Boston Scientific,21,15,4,40,0.100000
2025-09-20,Boyd Gaming,18,22,0,40,0.000000
2025-09-20,Bread Financial,20,18,2,40,0.050000
2025-09-20,BrightSpring Health Services,12,24,4,40,0.100000
2025-09-20,BrightView Holdings,26,12,2,40,0.050000
2025-09-20,Brighthouse Financial,13,24,3,40,0.075000
2025-09-20,Brinker International,17,21,2,40,0.050000
2025-09-20,Brinks Company,16,3,6,25,0.240000
2025-09-20,Bristol-Myers Squibb,11,23,6,40,0.150000
2025-09-20,Broadcom,16,19,5,40,0.125000
2025-09-20,Broadridge Financial Solutions,36,4,0,40,0.000000
2025-09-20,Brookdale Senior Living,16,17,7,40,0.175000
2025-09-20,Brown & Brown,15,19,6,40,0.150000
2025-09-20,Brown-Forman,12,20,8,40,0.200000
2025-09-20,Bruker,16,17,7,40,0.175000
2025-09-20,Brunswick Corporation,23,16,1,40,0.025000
2025-09-20,Builders FirstSource,13,22,5,40,0.125000
2025-09-20,Burlington Stores,18,19,3,40,0.075000
2025-09-20,CACI International,30,10,0,40,0.000000
2025-09-20,CBRE Group,23,17,0,40,0.000000
2025-09-20,CDW,23,17,0,40,0.000000
2025-09-20,CF Industries,26,12,2,40,0.050000
2025-09-20,CH Robinson Worldwide,21,16,3,40,0.075000
2025-09-20,CHS,21,16,3,40,0.075000
2025-09-20,CIncinnati Financial,14,23,3,40,0.075000
2025-09-20,CME Group,16,20,4,40,0.100000
2025-09-20,CMS Energy,36,4,0,40,0.000000
2025-09-20,CNO Financial Group,17,23,0,40,0.000000
2025-09-20,CNX Resources,21,17,2,40,0.050000
2025-09-20,CSX,16,18,6,40,0.150000
2025-09-20,CVS Health,21,14,5,40,0.125000
2025-09-20,Cabot Corporation,21,17,2,40,0.050000
2025-09-20,Cadence,15,23,2,40,0.050000
2025-09-20,Caesars Entertainment,19,12,9,40,0.225000
2025-09-20,Cal-Maine Foods,29,11,0,40,0.000000
2025-09-20,Caleres Inc,20,15,5,40,0.125000
2025-09-20,California Resources,13,24,3,40,0.075000
2025-09-20,Calumet Inc,19,13,8,40,0.200000
2025-09-20,Campbell Soup,20,11,9,40,0.225000
2025-09-20,Camping World,8,27,5,40,0.125000
2025-09-20,Capital One,20,15,5,40,0.125000
2025-09-20,CarMax,8,29,3,40,0.075000
2025-09-20,Cardinal Health,15,16,9,40,0.225000
2025-09-20,Carlisle Companies,18,14,8,40,0.200000
2025-09-20,Carlyle Group,13,24,3,40,0.075000
2025-09-20,Carpenter Technology,24,16,0,40,0.000000
2025-09-20,Carrier Global,16,16,8,40,0.200000
2025-09-20,Carters Inc,20,17,3,40,0.075000
2025-09-20,Carvana,16,23,1,40,0.025000
2025-09-20,Caseys General Stores,13,21,6,40,0.150000
2025-09-20,Catalent,9,26,5,40,0.125000
2025-09-20,Caterpillar,28,11,1,40,0.025000
2025-09-20,Cboe Global Markets,17,21,2,40,0.050000
2025-09-20,Celanese,16,17,7,40,0.175000
2025-09-20,Cencora,29,8,3,40,0.075000
2025-09-20,Centene,20,16,4,40,0.100000
2025-09-20,CenterPoint Energy,30,3,7,40,0.175000
2025-09-20,Central Garden & Pet,10,27,3,40,0.075000
2025-09-20,Century Communities,17,22,1,40,0.025000
2025-09-20,ChampionX,23,17,0,40,0.000000
2025-09-20,Charles River Laboratories International,17,19,4,40,0.100000
2025-09-20,Charles Schwab,20,17,3,40,0.075000
2025-09-20,Chart Industries,15,22,3,40,0.075000
2025-09-20,Charter Communications,12,19,9,40,0.225000
2025-09-20,Cheesecake Factory,16,16,8,40,0.200000
2025-09-20,Chefs Warehouse,22,15,3,40,0.075000
2025-09-20,Chemours,17,13,10,40,0.250000
2025-09-20,Cheniere Energy,38,1,1,40,0.025000
2025-09-20,Chevron,12,17,11,40,0.275000
2025-09-20,Chewy,19,12,9,40,0.225000
2025-09-20,Chipotle Mexican Grill,12,24,4,40,0.100000
2025-09-20,Chord Energy,37,1,2,40,0.050000
2025-09-20,Church & Dwight,19,16,5,40,0.125000
2025-09-20,Ciena,20,18,2,40,0.050000
2025-09-20,Cigna,15,18,7,40,0.175000
2025-09-20,Cinemark,21,16,3,40,0.075000
2025-09-20,Cintas,23,15,2,40,0.050000
2025-09-20,Cisco Systems,20,19,1,40,0.025000
2025-09-20,Citigroup,19,18,3,40,0.075000
2025-09-20,Citizens Financial Group,17,21,2,40,0.050000
2025-09-20,Civitas Resources,14,18,8,40,0.200000
2025-09-20,Clean Harbors,35,0,5,40,0.125000
2025-09-20,Clear Channel Outdoor Hldgs,8,0,2,10,0.200000
2025-09-20,Cleveland-Cliffs,17,16,7,40,0.175000
2025-09-20,Clorox,20,15,5,40,0.125000
2025-09-20,Cognizant Technology Solutions,32,4,4,40,0.100000
2025-09-20,Coherent,16,21,3,40,0.075000
2025-09-20,Coinbase Global,9,28,3,40,0.075000
2025-09-20,Colgate-Palmolive,16,20,4,40,0.100000
2025-09-20,Columbia Banking System,19,21,0,40,0.000000
2025-09-20,Columbia Sportswear,11,18,11,40,0.275000
2025-09-20,Comcast,24,11,5,40,0.125000
2025-09-20,Comerica,18,17,5,40,0.125000
2025-09-20,Comfort Systems USA,40,0,0,40,0.000000
2025-09-20,CommScope,15,24,1,40,0.025000
2025-09-20,Commercial Metals,17,20,3,40,0.075000
2025-09-20,Community Health Systems,17,17,6,40,0.150000
2025-09-20,Compass Group,15,19,6,40,0.150000
2025-09-20,Conagra Brands,18,17,5,40,0.125000
2025-09-20,Concentrix,13,20,7,40,0.175000
2025-09-20,Conduent,14,18,8,40,0.200000
2025-09-20,ConocoPhillips,16,19,5,40,0.125000
2025-09-20,Consol Energy,32,7,1,40,0.025000
2025-09-20,Consolidated Edison,13,22,5,40,0.125000
2025-09-20,Constellation Brands,14,10,16,40,0.400000
2025-09-20,Constellation Energy,34,3,3,40,0.075000
2025-09-20,Continental Resources,18,12,10,40,0.250000
2025-09-20,Cooper Cos,5,20,6,31,0.193548
2025-09-20,Cooper-Standard,12,27,1,40,0.025000
2025-09-20,Copart,19,21,0,40,0.000000
2025-09-20,Core & Main,11,20,9,40,0.225000
2025-09-20,Corebridge Financial,20,15,5,40,0.125000
2025-09-20,Cornerstone Building Brands,17,16,7,40,0.175000
2025-09-20,Corning,13,24,3,40,0.075000
2025-09-20,Corpay,19,20,1,40,0.025000
2025-09-20,Corteva,14,23,3,40,0.075000
2025-09-20,Costco,15,19,6,40,0.150000
2025-09-20,Coterra Energy,36,3,1,40,0.025000
2025-09-20,Coty,8,18,14,40,0.350000
2025-09-20,Country Financial,13,24,3,40,0.075000
2025-09-20,Coupang,21,17,2,40,0.050000
2025-09-20,Cracker Barrel Old Country Store,8,20,12,40,0.300000
2025-09-20,Crocs,8,25,7,40,0.175000
2025-09-20,CrossAmerica Partners,13,23,4,40,0.100000
2025-09-20,CrowdStrike,19,13,8,40,0.200000
2025-09-20,Crown Castle,14,21,5,40,0.125000
2025-09-20,Crown Holdings,20,18,2,40,0.050000
2025-09-20,Cullen Frost Bankers,19,19,2,40,0.050000
2025-09-20,Cummins Inc,25,14,1,40,0.025000
2025-09-20,Curtiss-Wright,21,18,1,40,0.025000
2025-09-20,DR Horton,21,18,1,40,0.025000
2025-09-20,DTE Energy,34,2,4,40,0.100000
2025-09-20,DXC Technology,21,17,2,40,0.050000
2025-09-20,DaVita,20,9,11,40,0.275000
2025-09-20,Dana Incorporated,19,16,5,40,0.125000
2025-09-20,Danaher,29,10,1,40,0.025000
2025-09-20,Darden Restaurants,17,13,10,40,0.250000
2025-09-20,Darling Ingredients,38,1,1,40,0.025000
2025-09-20,Deckers Outdoor,18,20,2,40,0.050000
2025-09-20,Deere,11,23,6,40,0.150000
2025-09-20,Delek US,13,24,3,40,0.075000
2025-09-20,Dell Technologies,20,19,1,40,0.025000
2025-09-20,Delta Air Lines,8,25,7,40,0.175000
2025-09-20,Dentsply Sirona,12,26,2,40,0.050000
2025-09-20,Designer Brands,16,21,3,40,0.075000
2025-09-20,Devon Energy,37,1,2,40,0.050000
2025-09-20,DexCom,12,19,9,40,0.225000
2025-09-20,Diamondback Energy,35,2,3,40,0.075000
2025-09-20,Dicks Sporting Goods,11,27,2,40,0.050000
2025-09-20,Diebold Nixdorf,16,24,0,40,0.000000
2025-09-20,Digital Realty Trust,36,4,0,40,0.000000
2025-09-20,Dillards,12,20,8,40,0.200000
2025-09-20,Discover Financial,13,20,7,40,0.175000
2025-09-20,DocuSign,18,15,7,40,0.175000
2025-09-20,Dollar General,7,22,11,40,0.275000
2025-09-20,Dollar Tree,18,16,6,40,0.150000
2025-09-20,Dominion Energy,28,10,2,40,0.050000
2025-09-20,Dominos Pizza Inc,19,15,5,39,0.128205
2025-09-20,Domtar,9,23,8,40,0.200000
2025-09-20,Donaldson Company,26,10,4,40,0.100000
2025-09-20,DoorDash,16,20,4,40,0.100000
2025-09-20,Dover Corporation,24,16,0,40,0.000000
2025-09-20,DraftKings,31,7,2,40,0.050000
2025-09-20,Dream Finders Homes,38,0,2,40,0.050000
2025-09-20,Dropbox,14,21,5,40,0.125000
2025-09-20,DuPont,11,18,11,40,0.275000
2025-09-20,Duke Energy,34,3,3,40,0.075000
2025-09-20,Dycom Industries,16,20,4,40,0.100000
2025-09-20,EMCOR Group,9,27,4,40,0.100000
2025-09-20,EOG Resources,19,18,3,40,0.075000
2025-09-20,EPAM Systems,21,15,4,40,0.100000
2025-09-20,EQT,14,19,7,40,0.175000
2025-09-20,ESAB,10,27,3,40,0.075000
2025-09-20,East West Bancorp,21,17,2,40,0.050000
2025-09-20,Eastman Chemical,17,16,7,40,0.175000
2025-09-20,Ebay,18,18,4,40,0.100000
2025-09-20,EchoStar,14,20,6,40,0.150000
2025-09-20,Ecolab,23,17,0,40,0.000000
2025-09-20,Edison International,18,16,6,40,0.150000
2025-09-20,Edward Jones,20,16,4,40,0.100000
2025-09-20,Edwards Lifesciences,23,12,5,40,0.125000
2025-09-20,Elanco Animal Health,12,27,1,40,0.025000
2025-09-20,Electronic Arts,11,22,7,40,0.175000
2025-09-20,Elevance Health,21,17,2,40,0.050000
2025-09-20,Eli Lilly,14,21,5,40,0.125000
2025-09-20,Emerson Electric,25,14,1,40,0.025000
2025-09-20,EnLink Midstream,18,17,5,40,0.125000
2025-09-20,Encompass Health,15,25,0,40,0.000000
2025-09-20,Endeavor Group,10,24,6,40,0.150000
2025-09-20,Endeavor Group Holdings,11,23,6,40,0.150000
2025-09-20,EnerSys,19,20,1,40,0.025000
2025-09-20,Energizer Holdings,40,0,0,40,0.000000
2025-09-20,Energy Transfer,34,4,2,40,0.050000
2025-09-20,Ensign Group,23,15,2,40,0.050000
2025-09-20,Entegris,24,15,1,40,0.025000
2025-09-20,Entergy,18,18,4,40,0.100000
2025-09-20,Enterprise Products Partners,25,11,4,40,0.100000
2025-09-20,Envista,11,22,7,40,0.175000
2025-09-20,Equifax,23,10,7,40,0.175000
2025-09-20,Equinix,17,22,1,40,0.025000
2025-09-20,Equitable Holdings,22,14,4,40,0.100000
2025-09-20,Equity Residential,16,20,4,40,0.100000
2025-09-20,Erie Insurance,13,18,9,40,0.225000
2025-09-20,Estée Lauder,20,17,3,40,0.075000
2025-09-20,Etsy,14,14,12,40,0.300000
2025-09-20,Euronet Worldwide,18,21,1,40,0.025000
2025-09-20,Evergy,17,19,4,40,0.100000
2025-09-20,Eversource Energy,35,3,2,40,0.050000
2025-09-20,Exact Sciences,13,16,11,40,0.275000
2025-09-20,Exelon,19,19,2,40,0.050000
2025-09-20,Expand Energy Corporation,40,0,0,40,0.000000
2025-09-20,Expedia,18,20,2,40,0.050000
2025-09-20,Expeditors International of Washington,15,20,5,40,0.125000
2025-09-20,Extra Space Storage,17,20,3,40,0.075000
2025-09-20,Exxon Mobil,26,13,1,40,0.025000
2025-09-20,F5,24,14,2,40,0.050000
2025-09-20,FM Global,18,14,8,40,0.200000
2025-09-20,FMC Corporation,15,23,2,40,0.050000
2025-09-20,FTI Consulting,17,16,7,40,0.175000
2025-09-20,Fannie Mae,6,30,4,40,0.100000
2025-09-20,Farmers Insurance Exchange,11,17,12,40,0.300000
2025-09-20,Fastenal,31,8,1,40,0.025000
2025-09-20,FedEx,18,16,6,40,0.150000
2025-09-20,Federated Mutual Insurance,16,18,6,40,0.150000
2025-09-20,Ferguson Enterprises,14,23,3,40,0.075000
2025-09-20,Fidelity National Financial,20,16,4,40,0.100000
2025-09-20,Fidelity National Information Services,23,10,7,40,0.175000
2025-09-20,Fifth Third Bancorp,20,15,5,40,0.125000
2025-09-20,First American Financial,16,19,5,40,0.125000
2025-09-20,First Citizens BancShares,17,18,5,40,0.125000
2025-09-20,First Horizon,20,18,2,40,0.050000
2025-09-20,First National of Nebraska,16,24,0,40,0.000000
2025-09-20,First Solar,21,18,1,40,0.025000
2025-09-20,FirstCash,16,19,5,40,0.125000
2025-09-20,FirstEnergy,17,16,7,40,0.175000
2025-09-20,Fiserv,21,11,8,40,0.200000
2025-09-20,Five Below,11,18,11,40,0.275000
2025-09-20,Flagstar Financial,12,20,8,40,0.200000
2025-09-20,Floor & Decor,15,18,7,40,0.175000
2025-09-20,Flowers Foods,7,21,12,40,0.300000
2025-09-20,Flowserve,15,21,4,40,0.100000
2025-09-20,Fluor,21,7,12,40,0.300000
2025-09-20,Foot Locker,7,24,9,40,0.225000
2025-09-20,Ford Motor,14,17,9,40,0.225000
2025-09-20,Fortinet,14,13,13,40,0.325000
2025-09-20,Fortive,16,19,5,40,0.125000
2025-09-20,Fortune Brands Innovations,18,17,5,40,0.125000
2025-09-20,Franklin Resources,22,15,3,40,0.075000
2025-09-20,Freddie Mac,14,20,6,40,0.150000
2025-09-20,Freeport-McMoRan,22,14,4,40,0.100000
2025-09-20,Frontier Airlines,16,15,9,40,0.225000
2025-09-20,Frontier Communications,20,18,2,40,0.050000
2025-09-20,G-III Apparel Group,16,21,3,40,0.075000
2025-09-20,GE HealthCare Technologies,14,24,2,40,0.050000
2025-09-20,GE Vernova,24,15,1,40,0.025000
2025-09-20,GMS,17,20,3,40,0.075000
2025-09-20,GXO Logistics,15,21,4,40,0.100000
2025-09-20,GameStop,24,9,7,40,0.175000
2025-09-20,Gannett,19,15,6,40,0.150000
2025-09-20,Garrett Motion Inc,13,24,3,40,0.075000
2025-09-20,Gartner,9,26,5,40,0.125000
2025-09-20,Gen Digital,21,18,1,40,0.025000
2025-09-20,Generac,22,15,3,40,0.075000
2025-09-20,General Dynamics,37,1,2,40,0.050000
2025-09-20,General Mills,23,14,3,40,0.075000
2025-09-20,General Motors,20,14,6,40,0.150000
2025-09-20,Genesis Energy,33,5,2,40,0.050000
2025-09-20,Genuine Parts,22,18,0,40,0.000000
2025-09-20,Genworth Financial,21,18,1,40,0.025000
2025-09-20,Gilead Sciences,20,19,1,40,0.025000
2025-09-20,Global Partners,14,20,6,40,0.150000
2025-09-20,Global Payments,16,21,3,40,0.075000
2025-09-20,Globe Life,17,18,5,40,0.125000
2025-09-20,GoDaddy,16,21,3,40,0.075000
2025-09-20,Goldman Sachs,16,16,8,40,0.200000
2025-09-20,Goodyear Tire & Rubber,14,21,5,40,0.125000
2025-09-20,Graham Holdings Company,23,15,2,40,0.050000
2025-09-20,Granite Construction,23,15,2,40,0.050000
2025-09-20,Graphic Packaging,16,18,6,40,0.150000
2025-09-20,Gray Television,14,20,6,40,0.150000
2025-09-20,Graybar Electric,14,20,6,40,0.150000
2025-09-20,Green Plains Inc,21,14,5,40,0.125000
2025-09-20,Greenbrier,10,12,18,40,0.450000
2025-09-20,Greif,13,25,2,40,0.050000
2025-09-20,Griffon Corporation,22,16,2,40,0.050000
2025-09-20,Grocery Outlet Holding,16,21,3,40,0.075000
2025-09-20,Group 1 Automotive,14,22,4,40,0.100000
2025-09-20,Guardian Life insurance,20,20,0,40,0.000000
2025-09-20,Guess Inc,13,25,2,40,0.050000
2025-09-20,GuideWell Mutual,20,19,1,40,0.025000
2025-09-20,HB Fuller,14,22,4,40,0.100000
2025-09-20,HCA Healthcare,29,9,2,40,0.050000
2025-09-20,HEICO,18,20,2,40,0.050000
2025-09-20,HF SInclair,14,22,4,40,0.100000
2025-09-20,HP,14,21,5,40,0.125000
2025-09-20,Halliburton,10,17,13,40,0.325000
2025-09-20,Hanesbrands,14,23,3,40,0.075000
2025-09-20,Hanover Insurance Group,15,22,3,40,0.075000
2025-09-20,Harley-Davidson,10,22,8,40,0.200000
2025-09-20,Hasbro,16,19,5,40,0.125000
2025-09-20,Hawaiian Airlines Inc,14,25,1,40,0.025000
2025-09-20,Hawaiian Electric Industries,17,20,3,40,0.075000
2025-09-20,Helmerich & Payne,7,22,11,40,0.275000
2025-09-20,Henry Schein,19,20,1,40,0.025000
2025-09-20,Herc Rentals,18,17,5,40,0.125000
2025-09-20,Hershey,18,18,4,40,0.100000
2025-09-20,Hertz,23,12,5,40,0.125000
2025-09-20,Hewlett Packard Enterprise,19,21,0,40,0.000000
2025-09-20,Hillenbrand,16,20,4,40,0.100000
2025-09-20,Hilton Grand Vacations,39,1,0,40,0.000000
2025-09-20,Hilton Worldwide,24,16,0,40,0.000000
2025-09-20,Hologic,18,22,0,40,0.000000
2025-09-20,Home Depot,22,13,5,40,0.125000
2025-09-20,Honeywell,16,13,11,40,0.275000
2025-09-20,Hormel Foods,15,23,2,40,0.050000
2025-09-20,Host Hotels & Resorts,11,27,2,40,0.050000
2025-09-20,Hovnanian Enterprises,16,20,4,40,0.100000
2025-09-20,Howmet Aerospace,26,10,4,40,0.100000
2025-09-20,Hub Group,12,22,6,40,0.150000
2025-09-20,Hubbell,15,19,6,40,0.150000
2025-09-20,Humana,17,18,5,40,0.125000
2025-09-20,Huntington Bancshares,17,19,4,40,0.100000
2025-09-20,Huntington Ingalls Industries,18,17,5,40,0.125000
2025-09-20,Huntsman,7,18,15,40,0.375000
2025-09-20,Hyatt Hotels,13,26,1,40,0.025000
2025-09-20,Hyster-Yale,13,21,6,40,0.150000
2025-09-20,IAC,11,23,6,40,0.150000
2025-09-20,IBM,19,18,3,40,0.075000
2025-09-20,IDEX,23,14,3,40,0.075000
2025-09-20,IDEXX Laboratories,29,11,0,40,0.000000
2025-09-20,IQVIA,29,10,1,40,0.025000
2025-09-20,ITT,13,21,6,40,0.150000
2025-09-20,Icahn Enterprises,8,21,11,40,0.275000
2025-09-20,Illinois Tool Works,24,13,3,40,0.075000
2025-09-20,Illumina Inc,19,19,2,40,0.050000
2025-09-20,Incyte,27,11,2,40,0.050000
2025-09-20,Ingersoll Rand,21,16,3,40,0.075000
2025-09-20,Ingles Markets,11,18,11,40,0.275000
2025-09-20,Ingram Micro,12,16,12,40,0.300000
2025-09-20,Ingredion,22,16,2,40,0.050000
2025-09-20,Insight Enterprises,16,19,5,40,0.125000
2025-09-20,Insperity,19,16,5,40,0.125000
2025-09-20,Instacart,12,24,4,40,0.100000
2025-09-20,Installed Building Products,11,27,2,40,0.050000
2025-09-20,Intel,8,27,5,40,0.125000
2025-09-20,Interactive Brokers,19,18,3,40,0.075000
2025-09-20,Intercontinental Exchange,22,17,1,40,0.025000
2025-09-20,International Flavors & Fragrances,18,20,2,40,0.050000
2025-09-20,International Paper,19,18,3,40,0.075000
2025-09-20,Interpublic Group,21,14,5,40,0.125000
2025-09-20,Intuit,18,19,3,40,0.075000
2025-09-20,Intuitive Surgical,21,14,5,40,0.125000
2025-09-20,Iron Mountain,9,25,6,40,0.150000
2025-09-20,JB Hunt Transport Services,8,24,8,40,0.200000
2025-09-20,JELD-WEN Holding,13,21,6,40,0.150000
2025-09-20,JM Smucker,17,20,3,40,0.075000
2025-09-20,JPMorgan Chase,23,13,4,40,0.100000
2025-09-20,Jabil,15,23,2,40,0.050000
2025-09-20,Jackson Financial,23,14,3,40,0.075000
2025-09-20,Jacobs Solutions,33,1,6,40,0.150000
2025-09-20,Jefferies Financial,18,19,3,40,0.075000
2025-09-20,JetBlue Airways,14,21,5,40,0.125000
2025-09-20,Johnson & Johnson,21,14,5,40,0.125000
2025-09-20,Jones Lang LaSalle,14,24,2,40,0.050000
2025-09-20,Juniper Networks,14,24,2,40,0.050000
2025-09-20,KB Home,21,18,1,40,0.025000
2025-09-20,KBR,30,8,2,40,0.050000
2025-09-20,KKR & Co,23,15,2,40,0.050000
2025-09-20,KLA,15,15,10,40,0.250000
2025-09-20,Kaiser Aluminum,15,24,1,40,0.025000
2025-09-20,Kellanova,14,22,4,40,0.100000
2025-09-20,Kelly Services Inc,11,23,6,40,0.150000
2025-09-20,Kemper Corporation,18,16,6,40,0.150000
2025-09-20,Kenvue,18,16,6,40,0.150000
2025-09-20,Keurig Dr Pepper,11,23,6,40,0.150000
2025-09-20,KeyCorp,16,15,9,40,0.225000
2025-09-20,Keysight Technologies,24,13,3,40,0.075000
2025-09-20,Kimberly-Clark,16,20,4,40,0.100000
2025-09-20,Kinder Morgan,39,1,0,40,0.000000
2025-09-20,Kirby Corporation,19,18,3,40,0.075000
2025-09-20,Knife River Corporation,14,21,5,40,0.125000
2025-09-20,Knight Swift Transportation,18,18,4,40,0.100000
2025-09-20,Kohl's,16,18,6,40,0.150000
2025-09-20,Kontoor Brands,18,20,2,40,0.050000
2025-09-20,Korn Ferry,24,12,4,40,0.100000
2025-09-20,Kraft Heinz,15,18,7,40,0.175000
2025-09-20,Kroger,15,17,8,40,0.200000
2025-09-20,Kyndryl,16,22,2,40,0.050000
2025-09-20,L3Harris Technologies,25,12,3,40,0.075000
2025-09-20,LCI Industries,19,17,4,40,0.100000
2025-09-20,LKQ,16,23,1,40,0.025000
2025-09-20,LPL Financial,26,13,1,40,0.025000
2025-09-20,Labcorp Holdings,28,10,2,40,0.050000
2025-09-20,Lam Research,23,15,2,40,0.050000
2025-09-20,Lamb Weston,12,26,2,40,0.050000
2025-09-20,Land O'Lakes,13,24,3,40,0.075000
2025-09-20,Landstar System,14,17,9,40,0.225000
2025-09-20,Las Vegas Sands,13,25,2,40,0.050000
2025-09-20,Lear Corporation,23,14,3,40,0.075000
2025-09-20,Leggett & Platt,10,25,5,40,0.125000
2025-09-20,Leidos,20,17,3,40,0.075000
2025-09-20,Lennar,10,17,13,40,0.325000
2025-09-20,Lennox International,16,19,5,40,0.125000
2025-09-20,Levi Strauss,11,28,1,40,0.025000
2025-09-20,Liberty Energy,40,0,0,40,0.000000
2025-09-20,Liberty Media,38,1,1,40,0.025000
2025-09-20,Liberty Mutual Insurance,32,1,7,40,0.175000
2025-09-20,Light & Wonder,9,27,4,40,0.100000
2025-09-20,Lincoln Electric,18,22,0,40,0.000000
2025-09-20,Lincoln National,10,19,11,40,0.275000
2025-09-20,Lithia Motors,18,20,2,40,0.050000
2025-09-20,Live Nation Entertainment,8,12,20,40,0.500000
2025-09-20,Lockheed Martin,23,10,7,40,0.175000
2025-09-20,Loews,21,18,1,40,0.025000
2025-09-20,Louisiana-Pacific Corporation,15,21,4,40,0.100000
2025-09-20,Lowe's,13,6,21,40,0.525000
2025-09-20,Lululemon athletica,10,16,14,40,0.350000
2025-09-20,Lumen Technologies,9,26,5,40,0.125000
2025-09-20,Lyft,6,27,7,40,0.175000
2025-09-20,M&T Bank,9,22,9,40,0.225000
2025-09-20,M/I Homes,17,19,4,40,0.100000
2025-09-20,MDU Resources Group,12,26,2,40,0.050000
2025-09-20,MGM Resorts International,13,27,0,40,0.000000
2025-09-20,MKS Instruments,21,18,1,40,0.025000
2025-09-20,MRC Global,16,24,0,40,0.000000
2025-09-20,MSC Industrial Direct,16,22,2,40,0.050000
2025-09-20,MSCI,19,19,2,40,0.050000
2025-09-20,MYR Group,22,15,3,40,0.075000
2025-09-20,Macys,20,19,1,40,0.025000
2025-09-20,ManpowerGroup,19,14,7,40,0.175000
2025-09-20,Marathon Oil,16,19,5,40,0.125000
2025-09-20,Marathon Petroleum,22,16,2,40,0.050000
2025-09-20,Markel Group,26,14,0,40,0.000000
2025-09-20,Marriott International,23,14,3,40,0.075000
2025-09-20,Marriott Vacations Worldwide,19,17,4,40,0.100000
2025-09-20,Marsh & McLennan,24,13,3,40,0.075000
2025-09-20,Martin Marietta Materials,15,18,7,40,0.175000
2025-09-20,Marvell Technology,14,22,4,40,0.100000
2025-09-20,MasTec,19,19,2,40,0.050000
2025-09-20,Masco,13,22,5,40,0.125000
2025-09-20,Mass Mutual,12,24,4,40,0.100000
2025-09-20,MasterBrand,14,23,3,40,0.075000
2025-09-20,Mastercard,18,20,2,40,0.050000
2025-09-20,Matador Resources,19,19,2,40,0.050000
2025-09-20,Match Group,14,13,13,40,0.325000
2025-09-20,Mativ,16,18,6,40,0.150000
2025-09-20,Matson Inc,20,16,4,40,0.100000
2025-09-20,Mattel,17,18,5,40,0.125000
2025-09-20,Maximus,9,26,5,40,0.125000
2025-09-20,McCormick & Company,15,20,5,40,0.125000
2025-09-20,McDonalds,8,27,5,40,0.125000
2025-09-20,McKesson,24,14,2,40,0.050000
2025-09-20,Medical Mutual of Ohio,14,16,10,40,0.250000
2025-09-20,Merck,22,12,6,40,0.150000
2025-09-20,Mercury General,14,18,8,40,0.200000
2025-09-20,Meritage Homes,10,26,4,40,0.100000
2025-09-20,MetLife,23,13,4,40,0.100000
2025-09-20,Meta Platforms,17,14,9,40,0.225000
2025-09-20,Mettler-Toledo International,23,17,0,40,0.000000
2025-09-20,Microchip Technology,25,14,1,40,0.025000
2025-09-20,Micron Technology,17,18,5,40,0.125000
2025-09-20,Microsoft,18,17,5,40,0.125000
2025-09-20,Middleby,15,22,3,40,0.075000
2025-09-20,MillerKnoll,15,22,3,40,0.075000
2025-09-20,Moderna,13,20,7,40,0.175000
2025-09-20,ModivCare,12,19,9,40,0.225000
2025-09-20,Mohawk Industries,15,21,4,40,0.100000
2025-09-20,Molina Healthcare,19,14,7,40,0.175000
2025-09-20,Molson Coors Beverage,15,18,7,40,0.175000
2025-09-20,Mondelez,21,17,2,40,0.050000
2025-09-20,Monster Beverage,23,16,1,40,0.025000
2025-09-20,Moodys Corporation,5,14,3,22,0.136364
2025-09-20,Moog Inc,24,14,2,40,0.050000
2025-09-20,Morgan Stanley,16,13,11,40,0.275000
2025-09-20,Motorola Solutions,34,2,4,40,0.100000
2025-09-20,Mueller Industries,24,14,2,40,0.050000
2025-09-20,Murphy Oil,9,26,5,40,0.125000
2025-09-20,Murphy USA,14,25,1,40,0.025000
2025-09-20,Mutual of Omaha,21,16,3,40,0.075000
2025-09-20,NCR Atleos,14,25,1,40,0.025000
2025-09-20,NCR Voyix,16,19,5,40,0.125000
2025-09-20,NGL Energy Partners,34,2,4,40,0.100000
2025-09-20,NLV Financial,5,2,3,10,0.300000
2025-09-20,NOV,15,22,3,40,0.075000
2025-09-20,NRG Energy,34,4,2,40,0.050000
2025-09-20,NVR Inc,22,15,3,40,0.075000
2025-09-20,Nasdaq Inc,15,23,2,40,0.050000
2025-09-20,Nationwide Insurance,11,18,11,40,0.275000
2025-09-20,Navient,20,13,7,40,0.175000
2025-09-20,NetApp,24,13,3,40,0.075000
2025-09-20,Netflix,17,13,10,40,0.250000
2025-09-20,NeueHealth,15,23,2,40,0.050000
2025-09-20,New York Life Insurance,15,23,2,40,0.050000
2025-09-20,NewMarket Corporation,24,15,1,40,0.025000
2025-09-20,Newell Brands,11,23,6,40,0.150000
2025-09-20,Newmont,12,27,1,40,0.025000
2025-09-20,News Corp,15,18,7,40,0.175000
2025-09-20,Nexstar Media Group,11,21,8,40,0.200000
2025-09-20,NextEra Energy,38,2,0,40,0.000000
2025-09-20,NiSource,24,8,8,40,0.200000
2025-09-20,Nike,17,17,6,40,0.150000
2025-09-20,Nordson,20,19,1,40,0.025000
2025-09-20,Nordstrom,14,22,4,40,0.100000
2025-09-20,Norfolk Southern,21,15,4,40,0.100000
2025-09-20,Northern Trust,38,2,0,40,0.000000
2025-09-20,Northrop Grumman,13,20,7,40,0.175000
2025-09-20,Northwestern Mutual,15,14,11,40,0.275000
2025-09-20,Nucor,17,14,9,40,0.225000
2025-09-20,Nvidia,10,24,6,40,0.150000
2025-09-20,O'Reilly Automotive,29,10,1,40,0.025000
2025-09-20,O-I Glass,19,18,3,40,0.075000
2025-09-20,ODP Business Solutions,17,23,0,40,0.000000
2025-09-20,OGE Energy,38,1,1,40,0.025000
2025-09-20,ON Semiconductor,19,18,3,40,0.075000
2025-09-20,Occidental Petroleum,15,15,10,40,0.250000
2025-09-20,Old Dominion Freight Line,19,14,7,40,0.175000
2025-09-20,Old National Bancorp,17,22,1,40,0.025000
2025-09-20,Old Republic International,23,15,2,40,0.050000
2025-09-20,Olin,16,17,7,40,0.175000
2025-09-20,Omnicom Group,18,18,4,40,0.100000
2025-09-20,OneMain,16,24,0,40,0.000000
2025-09-20,Oneok,23,16,1,40,0.025000
2025-09-20,Opendoor Technologies,13,19,8,40,0.200000
2025-09-20,Option Care Health,39,1,0,40,0.000000
2025-09-20,Oracle,14,21,5,40,0.125000
2025-09-20,Organon,22,15,3,40,0.075000
2025-09-20,Oscar Health,16,18,6,40,0.150000
2025-09-20,Oshkosh Corporation,25,12,3,40,0.075000
2025-09-20,Otis Worldwide,17,18,5,40,0.125000
2025-09-20,Ovintiv,22,12,6,40,0.150000
2025-09-20,Owens & Minor,9,23,8,40,0.200000
2025-09-20,Owens Corning,11,29,0,40,0.000000
2025-09-20,PACS Group,15,15,10,40,0.250000
2025-09-20,PBF Energy,33,1,6,40,0.150000
2025-09-20,PC Connection Inc,28,11,1,40,0.025000
2025-09-20,PENN Entertainment,35,4,1,40,0.025000
2025-09-20,PG&E,16,17,7,40,0.175000
2025-09-20,PNC Financial Services,24,15,1,40,0.025000
2025-09-20,PPG Industries,23,14,3,40,0.075000
2025-09-20,PPL Corporation,16,21,3,40,0.075000
2025-09-20,PVH,13,19,8,40,0.200000
2025-09-20,Paccar,19,17,4,40,0.100000
2025-09-20,Pacific Life,17,22,1,40,0.025000
2025-09-20,Packaging Corp of America,9,27,4,40,0.100000
2025-09-20,Palo Alto Networks,17,14,9,40,0.225000
2025-09-20,Par Pacific,17,22,1,40,0.025000
2025-09-20,Paramount Global,12,19,9,40,0.225000
2025-09-20,Park Hotels & Resorts,18,19,3,40,0.075000
2025-09-20,Parker-Hannifin,25,15,0,40,0.000000
2025-09-20,Parsons Corporation,21,18,1,40,0.025000
2025-09-20,Patrick Industries,15,22,3,40,0.075000
2025-09-20,Patterson Companies Inc,8,29,3,40,0.075000
2025-09-20,Patterson-UTI Energy,31,5,4,40,0.100000
2025-09-20,PayPal,17,20,3,40,0.075000
2025-09-20,Paychex,21,14,5,40,0.125000
2025-09-20,Peabody Energy,33,6,1,40,0.025000
2025-09-20,Peloton Interactive,22,14,4,40,0.100000
2025-09-20,Penn Mutual Life Insurance,19,17,4,40,0.100000
2025-09-20,PennyMac Financial Services,16,21,3,40,0.075000
2025-09-20,Penske Automotive,12,25,3,40,0.075000
2025-09-20,PepsiCo,25,13,2,40,0.050000
2025-09-20,Performance Food,24,16,0,40,0.000000
2025-09-20,Permian Resources,21,17,2,40,0.050000
2025-09-20,Petco Health and Wellness,32,4,4,40,0.100000
2025-09-20,Peter Kiewit Sons',9,20,11,40,0.275000
2025-09-20,Pfizer,19,17,4,40,0.100000
2025-09-20,Philip Morris International,23,16,1,40,0.025000
2025-09-20,Phillips 66,20,17,3,40,0.075000
2025-09-20,Pinnacle West Capital,17,14,9,40,0.225000
2025-09-20,Pinterest,14,24,2,40,0.050000
2025-09-20,Pioneer Natural Resources,19,11,10,40,0.250000
2025-09-20,Pitney Bowes,19,20,1,40,0.025000
2025-09-20,Plains GP,16,9,15,40,0.375000
2025-09-20,Playtika Holding,12,18,10,40,0.250000
2025-09-20,Plexus Corp,15,22,3,40,0.075000
2025-09-20,Polaris Inc,24,14,2,40,0.050000
2025-09-20,Pool Corporation,19,19,2,40,0.050000
2025-09-20,Popular Inc,40,0,0,40,0.000000
2025-09-20,Portland General Electric,14,23,3,40,0.075000
2025-09-20,Post Holdings,13,26,1,40,0.025000
2025-09-20,PrIncipal Financial,18,21,1,40,0.025000
2025-09-20,PriceSmart,19,20,1,40,0.025000
2025-09-20,Primerica,19,17,4,40,0.100000
2025-09-20,Primoris Services,20,19,1,40,0.025000
2025-09-20,ProFrac Holding,16,19,5,40,0.125000
2025-09-20,Procter & Gamble,28,9,3,40,0.075000
2025-09-20,Progressive Insurance,15,21,4,40,0.100000
2025-09-20,Prologis,21,18,1,40,0.025000
2025-09-20,Prudential Financial,18,18,4,40,0.100000
2025-09-20,Public Service Enterprise Group,20,19,1,40,0.025000
2025-09-20,Public Storage,18,15,7,40,0.175000
2025-09-20,Publix Super Markets,22,15,3,40,0.075000
2025-09-20,Puget Sound Energy,31,7,2,40,0.050000
2025-09-20,PulteGroup,15,22,3,40,0.075000
2025-09-20,Pure Storage,11,23,6,40,0.150000
2025-09-20,QVC Group,12,24,4,40,0.100000
2025-09-20,QXO Building Products,1,6,3,10,0.300000
2025-09-20,Qorvo,23,14,3,40,0.075000
2025-09-20,Qualcomm,25,13,2,40,0.050000
2025-09-20,Quanta Services,26,10,4,40,0.100000
2025-09-20,Quest Diagnostics,7,29,4,40,0.100000
2025-09-20,QuidelOrtho,19,19,2,40,0.050000
2025-09-20,REV Group,22,13,5,40,0.125000
2025-09-20,RPM International,18,18,4,40,0.100000
2025-09-20,RTX,18,17,5,40,0.125000
2025-09-20,RXO Inc,17,21,2,40,0.050000
2025-09-20,Rackspace Technology,13,21,6,40,0.150000
2025-09-20,Radius Recycling,5,22,13,40,0.325000
2025-09-20,Ralph Lauren,10,29,1,40,0.025000
2025-09-20,Range Resources,15,18,7,40,0.175000
2025-09-20,Raymond James Financial,13,27,0,40,0.000000
2025-09-20,Realty Income,21,15,4,40,0.100000
2025-09-20,Regal Rexnord,12,21,7,40,0.175000
2025-09-20,Regeneron Pharmaceuticals,23,13,4,40,0.100000
2025-09-20,Regions Financial,15,23,2,40,0.050000
2025-09-20,Reinsurance Group of America,22,17,1,40,0.025000
2025-09-20,Reliance Inc,28,11,1,40,0.025000
2025-09-20,Republic Services,19,7,14,40,0.350000
2025-09-20,ResMed,15,23,2,40,0.050000
2025-09-20,Resideo Technologies,17,19,4,40,0.100000
2025-09-20,Restoration Hardware,11,22,7,40,0.175000
2025-09-20,Revvity,18,17,5,40,0.125000
2025-09-20,Rithm Capital,12,25,3,40,0.075000
2025-09-20,Rivian Automotive,12,24,4,40,0.100000
2025-09-20,Robert Half,22,16,2,40,0.050000
2025-09-20,Roblox,11,12,17,40,0.425000
2025-09-20,Rocket Companies,14,20,6,40,0.150000
2025-09-20,Rockwell Automation,20,18,2,40,0.050000
2025-09-20,Roku,24,15,1,40,0.025000
2025-09-20,Rollins Inc,18,20,2,40,0.050000
2025-09-20,Roper Technologies,25,13,2,40,0.050000
2025-09-20,Ross Stores,21,15,4,40,0.100000
2025-09-20,Rush Enterprises,21,17,2,40,0.050000
2025-09-20,Ryder System,23,14,3,40,0.075000
2025-09-20,Ryerson Holding,10,25,5,40,0.125000
2025-09-20,S&P Global,12,21,7,40,0.175000
2025-09-20,SBA Communications,14,15,11,40,0.275000
2025-09-20,SS&C Technologies,16,24,0,40,0.000000
2025-09-20,Sabre Corporation,15,16,9,40,0.225000
2025-09-20,Saia Inc,23,13,4,40,0.100000
2025-09-20,Salesforce,17,8,15,40,0.375000
2025-09-20,Sallie Mae,15,21,4,40,0.100000
2025-09-20,Sally Beauty,39,1,0,40,0.000000
2025-09-20,Sanmina,16,23,1,40,0.025000
2025-09-20,ScanSource,20,17,3,40,0.075000
2025-09-20,Schneider National,18,19,3,40,0.075000
2025-09-20,Science Applications International,14,18,8,40,0.200000
2025-09-20,Scotts Miracle-Gro,13,22,5,40,0.125000
2025-09-20,Seaboard,19,15,6,40,0.150000
2025-09-20,Sealed Air Corporation,11,27,2,40,0.050000
2025-09-20,Securian Financial,13,25,2,40,0.050000
2025-09-20,Select Medical Holdings,14,19,7,40,0.175000
2025-09-20,Selective Insurance Group,20,13,7,40,0.175000
2025-09-20,Sempra,28,12,0,40,0.000000
2025-09-20,Sentry Insurance Group,3,6,0,9,0.000000
2025-09-20,Service Corp International,7,11,5,23,0.217391
2025-09-20,ServiceNow,22,16,2,40,0.050000
2025-09-20,Sherwin-Williams,10,23,7,40,0.175000
2025-09-20,Shift4 Payments,16,20,4,40,0.100000
2025-09-20,Silgan,8,24,8,40,0.200000
2025-09-20,Simon Property Group,20,18,2,40,0.050000
2025-09-20,Sinclair,12,24,4,40,0.100000
2025-09-20,Sirius XM,16,21,3,40,0.075000
2025-09-20,SiteOne Landscape Supply,16,21,3,40,0.075000
2025-09-20,Skechers USA,17,21,2,40,0.050000
2025-09-20,SkyWest,10,21,9,40,0.225000
2025-09-20,Skyline Champion,32,6,2,40,0.050000
2025-09-20,Skyworks Solutions,34,2,4,40,0.100000
2025-09-20,Smurfit Westrock,13,21,6,40,0.150000
2025-09-20,Snap Inc,11,16,13,40,0.325000
2025-09-20,Snap-on,13,24,3,40,0.075000
2025-09-20,Snowflake Inc,24,16,0,40,0.000000
2025-09-20,Solventum,13,27,0,40,0.000000
2025-09-20,Sonic Automotive,13,24,3,40,0.075000
2025-09-20,Sonoco Products,18,19,3,40,0.075000
2025-09-20,Southern Company,24,14,2,40,0.050000
2025-09-20,Southwest Airlines,12,19,9,40,0.225000
2025-09-20,Southwest Gas Holdings,16,24,0,40,0.000000
2025-09-20,SpartanNash,19,21,0,40,0.000000
2025-09-20,Spectrum Brands,15,17,8,40,0.200000
2025-09-20,Spire Inc,23,14,3,40,0.075000
2025-09-20,Spirit AeroSystems,31,3,6,40,0.150000
2025-09-20,Spirit Airlines,18,2,20,40,0.500000
2025-09-20,Splunk,11,25,4,40,0.100000
2025-09-20,Sprouts Farmers Market,12,25,3,40,0.075000
2025-09-20,Stagwell,9,24,7,40,0.175000
2025-09-20,Stanley Black & Decker,10,28,2,40,0.050000
2025-09-20,Starbucks,9,23,8,40,0.200000
2025-09-20,State Farm Insurance,12,20,8,40,0.200000
2025-09-20,State Street,14,24,2,40,0.050000
2025-09-20,Steel Dynamics,37,0,3,40,0.075000
2025-09-20,Steelcase,13,25,2,40,0.050000
2025-09-20,Stericycle,12,7,21,40,0.525000
2025-09-20,Stifel Financial,21,17,2,40,0.050000
2025-09-20,StoneX Group,13,24,3,40,0.075000
2025-09-20,Stryker,20,20,0,40,0.000000
2025-09-20,Summit Materials,11,26,3,40,0.075000
2025-09-20,Sun Communities,23,17,0,40,0.000000
2025-09-20,Super Micro Computer,37,0,3,40,0.075000
2025-09-20,Surgery Partners,18,19,3,40,0.075000
2025-09-20,Sylvamo,16,21,3,40,0.075000
2025-09-20,Synchrony Financial,22,15,3,40,0.075000
2025-09-20,Synopsys,17,16,7,40,0.175000
2025-09-20,Synovus Financial,17,20,3,40,0.075000
2025-09-20,Sysco,25,15,0,40,0.000000
2025-09-20,T Rowe Price,19,21,0,40,0.000000
2025-09-20,TD Synnex,23,17,0,40,0.000000
2025-09-20,TEGNA,15,18,7,40,0.175000
2025-09-20,THOR Industries,14,22,4,40,0.100000
2025-09-20,TIAA,14,22,4,40,0.100000
2025-09-20,TJX,21,17,2,40,0.050000
2025-09-20,Take-Two Interactive Software,22,18,0,40,0.000000
2025-09-20,Talen Energy,38,1,1,40,0.025000
2025-09-20,Tapestry,14,23,3,40,0.075000
2025-09-20,Targa Resources,19,19,2,40,0.050000
2025-09-20,Target Corporation,23,17,0,40,0.000000
2025-09-20,Taylor Morrison Home,20,17,3,40,0.075000
2025-09-20,Teladoc Health,16,18,6,40,0.150000
2025-09-20,Teledyne Technologies,23,17,0,40,0.000000
2025-09-20,Teleflex,11,24,5,40,0.125000
2025-09-20,Telephone & Data Systems,12,18,3,33,0.090909
2025-09-20,TelevisaUnivision,10,19,11,40,0.275000
2025-09-20,Tempur Sealy International,11,25,4,40,0.100000
2025-09-20,Tenet Healthcare,20,19,1,40,0.025000
2025-09-20,Teradyne,23,17,0,40,0.000000
2025-09-20,Terex,15,22,3,40,0.075000
2025-09-20,Tesla,11,15,14,40,0.350000
2025-09-20,Tetra Tech,23,13,4,40,0.100000
2025-09-20,Texas Instruments,15,19,6,40,0.150000
2025-09-20,Texas Roadhouse,18,14,8,40,0.200000
2025-09-20,Textron,16,20,4,40,0.100000
2025-09-20,The Andersons Inc,19,19,2,40,0.050000
2025-09-20,The Coca-Cola Company,12,22,6,40,0.150000
2025-09-20,The Hartford,12,12,16,40,0.400000
2025-09-20,The Mosaic Company,14,19,7,40,0.175000
2025-09-20,Thermo Fisher Scientific,27,10,3,40,0.075000
2025-09-20,Thrivent Financial for Lutherans,17,20,3,40,0.075000
2025-09-20,Timken,16,20,4,40,0.100000
2025-09-20,Titan Machinery,15,20,5,40,0.125000
2025-09-20,Toast Inc,16,20,4,40,0.100000
2025-09-20,Toll Brothers,16,23,1,40,0.025000
2025-09-20,TopBuild,12,28,0,40,0.000000
2025-09-20,Topgolf Callaway Brands,14,22,4,40,0.100000
2025-09-20,Toro Company,14,25,1,40,0.025000
2025-09-20,Tractor Supply,13,25,2,40,0.050000
2025-09-20,TransDigm,20,17,3,40,0.075000
2025-09-20,TransUnion,17,12,11,40,0.275000
2025-09-20,Travelers Insurance,13,17,10,40,0.250000
2025-09-20,TreeHouse Foods,12,17,11,40,0.275000
2025-09-20,Tri Pointe Homes,17,21,2,40,0.050000
2025-09-20,TriNet Group,20,16,4,40,0.100000
2025-09-20,Trimble Inc,19,18,3,40,0.075000
2025-09-20,Trinity Industries,19,14,7,40,0.175000
2025-09-20,TruStage,26,12,2,40,0.050000
2025-09-20,Truist Financial,19,19,2,40,0.050000
2025-09-20,Tutor Perini Corporation,23,16,1,40,0.025000
2025-09-20,Twilio,23,15,2,40,0.050000
2025-09-20,Tyson Foods,14,19,7,40,0.175000
2025-09-20,U-Haul,8,12,20,40,0.500000
2025-09-20,UFP Industries,14,24,2,40,0.050000
2025-09-20,UGI Utilities Inc,18,13,9,40,0.225000
2025-09-20,UL Solutions,35,2,3,40,0.075000
2025-09-20,UPS,14,17,9,40,0.225000
2025-09-20,US Bancorp,12,23,5,40,0.125000
2025-09-20,US Foods,28,10,2,40,0.050000
2025-09-20,USAA,21,15,4,40,0.100000
2025-09-20,Uber,12,20,8,40,0.200000
2025-09-20,Ulta Beauty,33,5,2,40,0.050000
2025-09-20,Under Armour,7,24,9,40,0.225000
2025-09-20,Union Pacific,22,13,5,40,0.125000
2025-09-20,United Airlines,33,4,3,40,0.075000
2025-09-20,United Natural Foods,37,2,1,40,0.025000
2025-09-20,United Rentals,40,0,0,40,0.000000
2025-09-20,United States Steel,23,12,5,40,0.125000
2025-09-20,UnitedHealth,19,15,6,40,0.150000
2025-09-20,Universal Corporation,17,20,3,40,0.075000
2025-09-20,Universal Health Services,17,17,6,40,0.150000
2025-09-20,Unum Group,19,17,4,40,0.100000
2025-09-20,Upbound Group,21,19,0,40,0.000000
2025-09-20,Urban Outfitters,18,20,2,40,0.050000
2025-09-20,V2X,24,10,6,40,0.150000
2025-09-20,VF Corporation,13,12,15,40,0.375000
2025-09-20,VICI Properties,22,18,0,40,0.000000
2025-09-20,Vail Resorts,9,17,14,40,0.350000
2025-09-20,Valero Energy,36,4,0,40,0.000000
2025-09-20,Valley National Bancorp,9,26,5,40,0.125000
2025-09-20,Valmont Industries,25,14,1,40,0.025000
2025-09-20,Valvoline Inc,16,22,2,40,0.050000
2025-09-20,Ventas Inc,25,14,1,40,0.025000
2025-09-20,Verisk Analytics,15,16,9,40,0.225000
2025-09-20,Verizon,14,11,15,40,0.375000
2025-09-20,Vertex Pharmaceuticals,22,13,5,40,0.125000
2025-09-20,Vertiv,23,17,0,40,0.000000
2025-09-20,Viasat,15,24,1,40,0.025000
2025-09-20,Viatris,12,18,10,40,0.250000
2025-09-20,Victorias Secret,14,15,11,40,0.275000
2025-09-20,Visa Inc,23,12,5,40,0.125000
2025-09-20,Vishay Intertechnology,12,23,5,40,0.125000
2025-09-20,Vista Outdoor,9,23,8,40,0.200000
2025-09-20,Visteon,18,20,2,40,0.050000
2025-09-20,Vistra,20,17,3,40,0.075000
2025-09-20,Vontier,17,21,2,40,0.050000
2025-09-20,Voya Financial,25,13,2,40,0.050000
2025-09-20,Vulcan Materials,13,20,7,40,0.175000
2025-09-20,WEC Energy,39,0,1,40,0.025000
2025-09-20,WESCO International,19,18,3,40,0.075000
2025-09-20,WEX,22,14,4,40,0.100000
2025-09-20,WR Berkley,17,22,1,40,0.025000
2025-09-20,WW Grainger,19,16,5,40,0.125000
2025-09-20,Wabash National,16,10,14,40,0.350000
2025-09-20,Walmart,17,14,9,40,0.225000
2025-09-20,Walt Disney,14,18,8,40,0.200000
2025-09-20,Warner Bros Discovery,15,19,6,40,0.150000
2025-09-20,Warner Music Group,9,29,2,40,0.050000
2025-09-20,Waters Corporation,20,18,2,40,0.050000
2025-09-20,Watsco,15,21,4,40,0.100000
2025-09-20,Wayfair,17,19,4,40,0.100000
2025-09-20,Webster Financial,16,20,4,40,0.100000
2025-09-20,Weis Markets,12,22,6,40,0.150000
2025-09-20,Wells Fargo,29,1,10,40,0.250000
2025-09-20,Welltower,26,13,1,40,0.025000
2025-09-20,Werner Enterprises,18,14,8,40,0.200000
2025-09-20,West Pharmaceutical Services,17,20,3,40,0.075000
2025-09-20,Western & Southern Financial,14,22,4,40,0.100000
2025-09-20,Western Alliance Bancorp,14,17,9,40,0.225000
2025-09-20,Western Digital,17,19,4,40,0.100000
2025-09-20,Western Midstream Partners,21,16,3,40,0.075000
2025-09-20,Western Union,9,26,5,40,0.125000
2025-09-20,Westinghouse Air Brake Technologies,21,15,4,40,0.100000
2025-09-20,Weyerhaeuser,10,25,5,40,0.125000
2025-09-20,Whirlpool,11,20,9,40,0.225000
2025-09-20,Williams Companies,21,17,2,40,0.050000
2025-09-20,Williams-Sonoma,12,25,3,40,0.075000
2025-09-20,Winnebago Industries,12,22,6,40,0.150000
2025-09-20,Wintrust Financial,14,25,1,40,0.025000
2025-09-20,Woodward Inc,16,23,1,40,0.025000
2025-09-20,Workday,15,19,6,40,0.150000
2025-09-20,World Kinect,15,21,4,40,0.100000
2025-09-20,Worthington Enterprises,17,22,1,40,0.025000
2025-09-20,Wynn Resorts,14,20,6,40,0.150000
2025-09-20,XPO,15,23,2,40,0.050000
2025-09-20,Xcel Energy,33,5,2,40,0.050000
2025-09-20,Xerox,11,26,3,40,0.075000
2025-09-20,Xylem Inc,23,15,2,40,0.050000
2025-09-20,Yum Brands,16,23,1,40,0.025000
2025-09-20,Yum China,23,14,3,40,0.075000
2025-09-20,Zebra Technologies,16,23,1,40,0.025000
2025-09-20,Zimmer Biomet,11,28,1,40,0.025000
2025-09-20,Zions Bancorp,18,18,4,40,0.100000
2025-09-20,Zoetis,26,13,1,40,0.025000
2025-09-20,Zoom Video Communications,16,19,5,40,0.125000
2025-09-20,eXp World,13,23,4,40,0.100000
2025-09-20,iHeartMedia,14,24,2,40,0.050000
2025-09-21,3M,21,13,6,40,0.150000
2025-09-21,A O Smith,13,27,0,40,0.000000
2025-09-21,A-Mark Precious Metals,38,2,0,40,0.000000
2025-09-21,ABM Industries,12,16,12,40,0.300000
2025-09-21,ADT,18,17,5,40,0.125000
2025-09-21,AECOM,21,18,1,40,0.025000
2025-09-21,AES,17,18,5,40,0.125000
2025-09-21,AGCO,12,22,6,40,0.150000
2025-09-21,AIG,9,27,4,40,0.100000
2025-09-21,AMC Entertainment,36,1,3,40,0.075000
2025-09-21,AMC Networks,12,20,8,40,0.200000
2025-09-21,AMN Healthcare Services,15,19,6,40,0.150000
2025-09-21,APA,16,20,4,40,0.100000
2025-09-21,APi Group,20,17,3,40,0.075000
2025-09-21,ARKO,11,25,4,40,0.100000
2025-09-21,ASGN,13,20,7,40,0.175000
2025-09-21,AT&T,21,13,6,40,0.150000
2025-09-21,ATI Inc,18,20,2,40,0.050000
2025-09-21,AbbVie,18,17,5,40,0.125000
2025-09-21,Abbott Laboratories,26,12,2,40,0.050000
2025-09-21,Abercrombie & Fitch,18,20,2,40,0.050000
2025-09-21,Academy Sports and Outdoors,15,23,2,40,0.050000
2025-09-21,Acadia Healthcare,10,20,10,40,0.250000
2025-09-21,Ace Hardware,16,16,8,40,0.200000
2025-09-21,Acuity Inc,22,17,1,40,0.025000
2025-09-21,Adams Resources & Energy,16,5,2,23,0.086957
2025-09-21,AdaptHealth,17,18,5,40,0.125000
2025-09-21,Adobe,15,21,4,40,0.100000
2025-09-21,Advance Auto Parts,9,24,7,40,0.175000
2025-09-21,Advanced Drainage Systems,36,1,3,40,0.075000
2025-09-21,Advanced Micro Devices,24,7,9,40,0.225000
2025-09-21,Advantage Solutions,35,2,3,40,0.075000
2025-09-21,Aflac,13,17,10,40,0.250000
2025-09-21,Agilent Technologies,24,15,1,40,0.025000
2025-09-21,Agilon Health,14,21,5,40,0.125000
2025-09-21,Air Lease,14,24,2,40,0.050000
2025-09-21,Air Products & Chemicals,16,20,4,40,0.100000
2025-09-21,Airbnb,13,23,4,40,0.100000
2025-09-21,Akamai Technologies,25,11,4,40,0.100000
2025-09-21,Alaska Air,16,18,6,40,0.150000
2025-09-21,Albemarle Corporation,18,18,4,40,0.100000
2025-09-21,Albertsons,17,17,6,40,0.150000
2025-09-21,Alcoa Corporation,8,25,7,40,0.175000
2025-09-21,Alexandria Real Estate Equities,25,14,1,40,0.025000
2025-09-21,Alight Solutions,17,20,3,40,0.075000
2025-09-21,Align Technology,9,25,6,40,0.150000
2025-09-21,Allegiant Travel Company,13,25,2,40,0.050000
2025-09-21,Alliance Resource Partners,11,19,10,40,0.250000
2025-09-21,Alliant Energy,32,6,2,40,0.050000
2025-09-21,Allison Transmission,16,18,6,40,0.150000
2025-09-21,Allstate,27,6,7,40,0.175000
2025-09-21,Ally Financial,12,26,2,40,0.050000
2025-09-21,Alpha Metallurgical Resources,22,15,3,40,0.075000
2025-09-21,Alphabet,17,17,6,40,0.150000
2025-09-21,Altice USA,15,20,5,40,0.125000
2025-09-21,Altria,27,12,1,40,0.025000
2025-09-21,Amazon,29,3,8,40,0.200000
2025-09-21,Ameren,18,19,3,40,0.075000
2025-09-21,American Airlines,9,14,17,40,0.425000
2025-09-21,American Axle & Manufacturing,16,20,4,40,0.100000
2025-09-21,American Eagle Outfitters,14,19,7,40,0.175000
2025-09-21,American Electric Power,22,14,4,40,0.100000
2025-09-21,American Express,20,16,4,40,0.100000
2025-09-21,American Family Insurance,20,16,4,40,0.100000
2025-09-21,American Financial Group,11,27,2,40,0.050000
2025-09-21,American Tower,22,17,1,40,0.025000
2025-09-21,American Water Works,21,15,4,40,0.100000
2025-09-21,Americold Realty Trust,37,2,1,40,0.025000
2025-09-21,Ameriprise Financial,22,15,3,40,0.075000
2025-09-21,Ametek,26,13,1,40,0.025000
2025-09-21,Amgen,26,11,3,40,0.075000
2025-09-21,Amica Mutual Insurance,11,27,2,40,0.050000
2025-09-21,Amkor Technology,15,23,2,40,0.050000
2025-09-21,Amphenol,22,16,2,40,0.050000
2025-09-21,Analog Devices,22,18,0,40,0.000000
2025-09-21,Antero Resources,15,22,3,40,0.075000
2025-09-21,Anywhere Real Estate Inc,17,19,4,40,0.100000
2025-09-21,Apollo Global Management,21,17,2,40,0.050000
2025-09-21,AppLovin,23,15,2,40,0.050000
2025-09-21,Apple,12,23,5,40,0.125000
2025-09-21,Applied Industrial Technologies,16,24,0,40,0.000000
2025-09-21,Applied Materials,11,13,16,40,0.400000
2025-09-21,AptarGroup,19,19,2,40,0.050000
2025-09-21,Aramark,25,14,1,40,0.025000
2025-09-21,ArcBest,15,21,4,40,0.100000
2025-09-21,Arch Resources,30,6,4,40,0.100000
2025-09-21,Archer Daniels Midland,15,18,7,40,0.175000
2025-09-21,Ares Management,22,17,1,40,0.025000
2025-09-21,Arista Networks,19,18,3,40,0.075000
2025-09-21,Arrow Electronics,19,19,2,40,0.050000
2025-09-21,Arthur J Gallagher,19,19,2,40,0.050000
2025-09-21,Asbury Automotive Group,13,24,3,40,0.075000
2025-09-21,Assurant,21,15,4,40,0.100000
2025-09-21,Atkore,22,17,1,40,0.025000
2025-09-21,Atlassian,6,14,20,40,0.500000
2025-09-21,Atmos Energy,36,2,2,40,0.050000
2025-09-21,Auto-Owners Insurance,17,18,5,40,0.125000
2025-09-21,AutoNation,18,17,5,40,0.125000
2025-09-21,AutoZone,13,22,5,40,0.125000
2025-09-21,Autodesk,17,23,0,40,0.000000
2025-09-21,Autoliv,23,14,3,40,0.075000
2025-09-21,Automatic Data Processing,28,10,2,40,0.050000
2025-09-21,AvalonBay Communities,11,26,3,40,0.075000
2025-09-21,Avantor,13,19,8,40,0.200000
2025-09-21,Avery Dennison,23,15,2,40,0.050000
2025-09-21,Avient,9,24,7,40,0.175000
2025-09-21,Avis Budget,12,19,9,40,0.225000
2025-09-21,Avnet,13,26,1,40,0.025000
2025-09-21,BJ's Wholesale Club,18,17,5,40,0.125000
2025-09-21,BOK Financial,22,14,4,40,0.100000
2025-09-21,BWX Technologies,28,10,2,40,0.050000
2025-09-21,Baker Hughes,24,11,5,40,0.125000
2025-09-21,Ball Corporation,17,21,2,40,0.050000
2025-09-21,Bank of America,14,24,2,40,0.050000
2025-09-21,Bank of New York Mellon,22,16,2,40,0.050000
2025-09-21,Bath & Body Works,18,13,9,40,0.225000
2025-09-21,Baxter International,16,18,6,40,0.150000
2025-09-21,Becton Dickinson,23,13,4,40,0.100000
2025-09-21,Belden,10,26,4,40,0.100000
2025-09-21,Benchmark Electronics,16,22,2,40,0.050000
2025-09-21,Berkshire Hathaway,13,14,13,40,0.325000
2025-09-21,Berry Global,9,24,7,40,0.175000
2025-09-21,Best Buy,38,1,1,40,0.025000
2025-09-21,Bio-Rad Laboratories,17,20,3,40,0.075000
2025-09-21,Biogen,15,21,4,40,0.100000
2025-09-21,BlackRock,18,18,4,40,0.100000
2025-09-21,Blackstone,17,20,3,40,0.075000
2025-09-21,Bloomin Brands,7,24,9,40,0.225000
2025-09-21,BlueLinx,16,19,5,40,0.125000
2025-09-21,Boeing,11,14,15,40,0.375000
2025-09-21,Boise Cascade,13,15,12,40,0.300000
2025-09-21,Booking Holdings,20,15,5,40,0.125000
2025-09-21,Booz Allen Hamilton,19,18,3,40,0.075000
2025-09-21,BorgWarner,25,14,1,40,0.025000
2025-09-21,Boston Properties,9,25,6,40,0.150000
2025-09-21,Boston Scientific,21,16,3,40,0.075000
2025-09-21,Boyd Gaming,19,21,0,40,0.000000
2025-09-21,Bread Financial,19,19,2,40,0.050000
2025-09-21,BrightSpring Health Services,14,22,4,40,0.100000
2025-09-21,BrightView Holdings,23,15,2,40,0.050000
2025-09-21,Brighthouse Financial,13,26,1,40,0.025000
2025-09-21,Brinker International,18,20,2,40,0.050000
2025-09-21,Brinks Company,14,3,6,23,0.260870
2025-09-21,Bristol-Myers Squibb,13,22,5,40,0.125000
2025-09-21,Broadcom,11,21,8,40,0.200000
2025-09-21,Broadridge Financial Solutions,35,5,0,40,0.000000
2025-09-21,Brookdale Senior Living,17,16,7,40,0.175000
2025-09-21,Brown & Brown,13,22,5,40,0.125000
2025-09-21,Brown-Forman,11,20,9,40,0.225000
2025-09-21,Bruker,14,17,9,40,0.225000
2025-09-21,Brunswick Corporation,25,13,2,40,0.050000
2025-09-21,Builders FirstSource,16,20,4,40,0.100000
2025-09-21,Burlington Stores,14,22,4,40,0.100000
2025-09-21,CACI International,26,13,1,40,0.025000
2025-09-21,CBRE Group,22,16,2,40,0.050000
2025-09-21,CDW,23,17,0,40,0.000000
2025-09-21,CF Industries,26,12,2,40,0.050000
2025-09-21,CH Robinson Worldwide,18,20,2,40,0.050000
2025-09-21,CHS,20,16,4,40,0.100000
2025-09-21,CIncinnati Financial,16,20,4,40,0.100000
2025-09-21,CME Group,17,22,1,40,0.025000
2025-09-21,CMS Energy,38,2,0,40,0.000000
2025-09-21,CNO Financial Group,15,24,1,40,0.025000
2025-09-21,CNX Resources,22,17,1,40,0.025000
2025-09-21,CSX,17,17,6,40,0.150000
2025-09-21,CVS Health,21,14,5,40,0.125000
2025-09-21,Cabot Corporation,23,15,2,40,0.050000
2025-09-21,Cadence,12,25,3,40,0.075000
2025-09-21,Caesars Entertainment,23,11,6,40,0.150000
2025-09-21,Cal-Maine Foods,25,14,1,40,0.025000
2025-09-21,Caleres Inc,21,14,5,40,0.125000
2025-09-21,California Resources,14,22,4,40,0.100000
2025-09-21,Calumet Inc,22,10,8,40,0.200000
2025-09-21,Campbell Soup,20,9,11,40,0.275000
2025-09-21,Camping World,6,26,8,40,0.200000
2025-09-21,Capital One,21,14,5,40,0.125000
2025-09-21,CarMax,7,29,4,40,0.100000
2025-09-21,Cardinal Health,18,18,4,40,0.100000
2025-09-21,Carlisle Companies,16,14,10,40,0.250000
2025-09-21,Carlyle Group,14,23,3,40,0.075000
2025-09-21,Carpenter Technology,29,11,0,40,0.000000
2025-09-21,Carrier Global,19,14,7,40,0.175000
2025-09-21,Carters Inc,20,17,3,40,0.075000
2025-09-21,Carvana,20,19,1,40,0.025000
2025-09-21,Caseys General Stores,13,21,6,40,0.150000
2025-09-21,Catalent,10,26,4,40,0.100000
2025-09-21,Caterpillar,21,16,3,40,0.075000
2025-09-21,Cboe Global Markets,16,22,2,40,0.050000
2025-09-21,Celanese,14,17,9,40,0.225000
2025-09-21,Cencora,30,9,1,40,0.025000
2025-09-21,Centene,19,17,4,40,0.100000
2025-09-21,CenterPoint Energy,31,3,6,40,0.150000
2025-09-21,Central Garden & Pet,9,28,3,40,0.075000
2025-09-21,Century Communities,15,23,2,40,0.050000
2025-09-21,ChampionX,22,18,0,40,0.000000
2025-09-21,Charles River Laboratories International,19,18,3,40,0.075000
2025-09-21,Charles Schwab,20,17,3,40,0.075000
2025-09-21,Chart Industries,15,23,2,40,0.050000
2025-09-21,Charter Communications,17,17,6,40,0.150000
2025-09-21,Cheesecake Factory,17,18,5,40,0.125000
2025-09-21,Chefs Warehouse,22,15,3,40,0.075000
2025-09-21,Chemours,15,12,13,40,0.325000
2025-09-21,Cheniere Energy,37,1,2,40,0.050000
2025-09-21,Chevron,13,14,13,40,0.325000
2025-09-21,Chewy,18,16,6,40,0.150000
2025-09-21,Chipotle Mexican Grill,14,23,3,40,0.075000
2025-09-21,Chord Energy,37,1,2,40,0.050000
2025-09-21,Church & Dwight,20,16,4,40,0.100000
2025-09-21,Ciena,23,14,3,40,0.075000
2025-09-21,Cigna,20,14,6,40,0.150000
2025-09-21,Cinemark,26,12,2,40,0.050000
2025-09-21,Cintas,22,15,3,40,0.075000
2025-09-21,Cisco Systems,15,25,0,40,0.000000
2025-09-21,Citigroup,15,20,5,40,0.125000
2025-09-21,Citizens Financial Group,23,16,1,40,0.025000
2025-09-21,Civitas Resources,15,19,6,40,0.150000
2025-09-21,Clean Harbors,34,0,6,40,0.150000
2025-09-21,Clear Channel Outdoor Hldgs,8,0,2,10,0.200000
2025-09-21,Cleveland-Cliffs,18,15,7,40,0.175000
2025-09-21,Clorox,19,15,6,40,0.150000
2025-09-21,Cognizant Technology Solutions,33,3,4,40,0.100000
2025-09-21,Coherent,17,21,2,40,0.050000
2025-09-21,Coinbase Global,10,28,2,40,0.050000
2025-09-21,Colgate-Palmolive,20,16,4,40,0.100000
2025-09-21,Columbia Banking System,18,22,0,40,0.000000
2025-09-21,Columbia Sportswear,9,18,13,40,0.325000
2025-09-21,Comcast,22,14,4,40,0.100000
2025-09-21,Comerica,18,19,3,40,0.075000
2025-09-21,Comfort Systems USA,40,0,0,40,0.000000
2025-09-21,CommScope,14,24,2,40,0.050000
2025-09-21,Commercial Metals,16,21,3,40,0.075000
2025-09-21,Community Health Systems,17,17,6,40,0.150000
2025-09-21,Compass Group,16,18,6,40,0.150000
2025-09-21,Conagra Brands,19,17,4,40,0.100000
2025-09-21,Concentrix,14,20,6,40,0.150000
2025-09-21,Conduent,14,19,7,40,0.175000
2025-09-21,ConocoPhillips,15,19,6,40,0.150000
2025-09-21,Consol Energy,35,4,1,40,0.025000
2025-09-21,Consolidated Edison,14,22,4,40,0.100000
2025-09-21,Constellation Brands,14,10,16,40,0.400000
2025-09-21,Constellation Energy,34,2,4,40,0.100000
2025-09-21,Continental Resources,18,12,10,40,0.250000
2025-09-21,Cooper Cos,5,19,6,30,0.200000
2025-09-21,Cooper-Standard,14,26,0,40,0.000000
2025-09-21,Copart,25,14,1,40,0.025000
2025-09-21,Core & Main,14,19,7,40,0.175000
2025-09-21,Corebridge Financial,18,19,3,40,0.075000
2025-09-21,Cornerstone Building Brands,18,16,6,40,0.150000
2025-09-21,Corning,12,26,2,40,0.050000
2025-09-21,Corpay,19,19,2,40,0.050000
2025-09-21,Corteva,11,24,5,40,0.125000
2025-09-21,Costco,15,19,6,40,0.150000
2025-09-21,Coterra Energy,35,3,2,40,0.050000
2025-09-21,Coty,10,22,8,40,0.200000
2025-09-21,Country Financial,13,24,3,40,0.075000
2025-09-21,Coupang,22,15,3,40,0.075000
2025-09-21,Cracker Barrel Old Country Store,7,20,13,40,0.325000
2025-09-21,Crocs,8,26,6,40,0.150000
2025-09-21,CrossAmerica Partners,14,22,4,40,0.100000
2025-09-21,CrowdStrike,19,13,8,40,0.200000
2025-09-21,Crown Castle,17,18,5,40,0.125000
2025-09-21,Crown Holdings,20,17,3,40,0.075000
2025-09-21,Cullen Frost Bankers,17,21,2,40,0.050000
2025-09-21,Cummins Inc,24,15,1,40,0.025000
2025-09-21,Curtiss-Wright,21,18,1,40,0.025000
2025-09-21,DR Horton,21,16,3,40,0.075000
2025-09-21,DTE Energy,30,5,5,40,0.125000
2025-09-21,DXC Technology,17,21,2,40,0.050000
2025-09-21,DaVita,20,7,13,40,0.325000
2025-09-21,Dana Incorporated,19,17,4,40,0.100000
2025-09-21,Danaher,29,10,1,40,0.025000
2025-09-21,Darden Restaurants,14,14,12,40,0.300000
2025-09-21,Darling Ingredients,37,2,1,40,0.025000
2025-09-21,Deckers Outdoor,18,20,2,40,0.050000
2025-09-21,Deere,10,25,5,40,0.125000
2025-09-21,Delek US,14,22,4,40,0.100000
2025-09-21,Dell Technologies,20,19,1,40,0.025000
2025-09-21,Delta Air Lines,6,26,8,40,0.200000
2025-09-21,Dentsply Sirona,13,26,1,40,0.025000
2025-09-21,Designer Brands,15,23,2,40,0.050000
2025-09-21,Devon Energy,38,1,1,40,0.025000
2025-09-21,DexCom,10,23,7,40,0.175000
2025-09-21,Diamondback Energy,35,2,3,40,0.075000
2025-09-21,Dicks Sporting Goods,13,23,4,40,0.100000
2025-09-21,Diebold Nixdorf,14,26,0,40,0.000000
2025-09-21,Digital Realty Trust,36,4,0,40,0.000000
2025-09-21,Dillards,12,24,4,40,0.100000
2025-09-21,Discover Financial,13,20,7,40,0.175000
2025-09-21,DocuSign,22,18,0,40,0.000000
2025-09-21,Dollar General,5,21,14,40,0.350000
2025-09-21,Dollar Tree,16,20,4,40,0.100000
2025-09-21,Dominion Energy,32,7,1,40,0.025000
2025-09-21,Dominos Pizza Inc,19,16,5,40,0.125000
2025-09-21,Domtar,10,23,7,40,0.175000
2025-09-21,Donaldson Company,26,12,2,40,0.050000
2025-09-21,DoorDash,17,21,2,40,0.050000
2025-09-21,Dover Corporation,24,16,0,40,0.000000
2025-09-21,DraftKings,29,9,2,40,0.050000
2025-09-21,Dream Finders Homes,36,1,3,40,0.075000
2025-09-21,Dropbox,14,21,5,40,0.125000
2025-09-21,DuPont,10,19,11,40,0.275000
2025-09-21,Duke Energy,36,2,2,40,0.050000
2025-09-21,Dycom Industries,17,19,4,40,0.100000
2025-09-21,EMCOR Group,11,25,4,40,0.100000
2025-09-21,EOG Resources,22,13,5,40,0.125000
2025-09-21,EPAM Systems,22,14,4,40,0.100000
2025-09-21,EQT,13,22,5,40,0.125000
2025-09-21,ESAB,8,28,4,40,0.100000
2025-09-21,East West Bancorp,20,18,2,40,0.050000
2025-09-21,Eastman Chemical,17,16,7,40,0.175000
2025-09-21,Ebay,21,14,5,40,0.125000
2025-09-21,EchoStar,10,23,7,40,0.175000
2025-09-21,Ecolab,25,13,2,40,0.050000
2025-09-21,Edison International,18,17,5,40,0.125000
2025-09-21,Edward Jones,19,17,4,40,0.100000
2025-09-21,Edwards Lifesciences,18,13,9,40,0.225000
2025-09-21,Elanco Animal Health,13,24,3,40,0.075000
2025-09-21,Electronic Arts,14,20,6,40,0.150000
2025-09-21,Elevance Health,25,13,2,40,0.050000
2025-09-21,Eli Lilly,15,19,6,40,0.150000
2025-09-21,Emerson Electric,22,17,1,40,0.025000
2025-09-21,EnLink Midstream,17,18,5,40,0.125000
2025-09-21,Encompass Health,16,22,2,40,0.050000
2025-09-21,Endeavor Group,12,23,5,40,0.125000
2025-09-21,Endeavor Group Holdings,13,21,6,40,0.150000
2025-09-21,EnerSys,19,20,1,40,0.025000
2025-09-21,Energizer Holdings,39,0,1,40,0.025000
2025-09-21,Energy Transfer,34,5,1,40,0.025000
2025-09-21,Ensign Group,26,13,1,40,0.025000
2025-09-21,Entegris,24,14,2,40,0.050000
2025-09-21,Entergy,21,14,5,40,0.125000
2025-09-21,Enterprise Products Partners,23,12,5,40,0.125000
2025-09-21,Envista,12,20,8,40,0.200000
2025-09-21,Equifax,21,13,6,40,0.150000
2025-09-21,Equinix,24,15,1,40,0.025000
2025-09-21,Equitable Holdings,22,15,3,40,0.075000
2025-09-21,Equity Residential,17,20,3,40,0.075000
2025-09-21,Erie Insurance,12,19,9,40,0.225000
2025-09-21,Estée Lauder,16,20,4,40,0.100000
2025-09-21,Etsy,15,13,12,40,0.300000
2025-09-21,Euronet Worldwide,17,22,1,40,0.025000
2025-09-21,Evergy,21,15,4,40,0.100000
2025-09-21,Eversource Energy,34,3,3,40,0.075000
2025-09-21,Exact Sciences,10,17,13,40,0.325000
2025-09-21,Exelon,18,21,1,40,0.025000
2025-09-21,Expand Energy Corporation,40,0,0,40,0.000000
2025-09-21,Expedia,16,22,2,40,0.050000
2025-09-21,Expeditors International of Washington,15,21,4,40,0.100000
2025-09-21,Extra Space Storage,16,21,3,40,0.075000
2025-09-21,Exxon Mobil,25,13,2,40,0.050000
2025-09-21,F5,22,14,4,40,0.100000
2025-09-21,FM Global,19,14,7,40,0.175000
2025-09-21,FMC Corporation,18,21,1,40,0.025000
2025-09-21,FTI Consulting,17,17,6,40,0.150000
2025-09-21,Fannie Mae,7,30,3,40,0.075000
2025-09-21,Farmers Insurance Exchange,11,17,12,40,0.300000
2025-09-21,Fastenal,29,11,0,40,0.000000
2025-09-21,FedEx,20,13,7,40,0.175000
2025-09-21,Federated Mutual Insurance,17,18,3,38,0.078947
2025-09-21,Ferguson Enterprises,19,18,3,40,0.075000
2025-09-21,Fidelity National Financial,20,18,2,40,0.050000
2025-09-21,Fidelity National Information Services,19,14,7,40,0.175000
2025-09-21,Fifth Third Bancorp,24,13,3,40,0.075000
2025-09-21,First American Financial,17,19,4,40,0.100000
2025-09-21,First Citizens BancShares,16,20,4,40,0.100000
2025-09-21,First Horizon,21,18,1,40,0.025000
2025-09-21,First National of Nebraska,17,23,0,40,0.000000
2025-09-21,First Solar,20,19,1,40,0.025000
2025-09-21,FirstCash,16,19,5,40,0.125000
2025-09-21,FirstEnergy,16,16,8,40,0.200000
2025-09-21,Fiserv,17,19,4,40,0.100000
2025-09-21,Five Below,11,18,11,40,0.275000
2025-09-21,Flagstar Financial,8,25,7,40,0.175000
2025-09-21,Floor & Decor,16,19,5,40,0.125000
2025-09-21,Flowers Foods,8,19,13,40,0.325000
2025-09-21,Flowserve,13,24,3,40,0.075000
2025-09-21,Fluor,20,7,13,40,0.325000
2025-09-21,Foot Locker,7,24,9,40,0.225000
2025-09-21,Ford Motor,12,24,4,40,0.100000
2025-09-21,Fortinet,13,11,16,40,0.400000
2025-09-21,Fortive,17,19,4,40,0.100000
2025-09-21,Fortune Brands Innovations,17,17,6,40,0.150000
2025-09-21,Franklin Resources,23,14,3,40,0.075000
2025-09-21,Freddie Mac,13,21,6,40,0.150000
2025-09-21,Freeport-McMoRan,26,10,4,40,0.100000
2025-09-21,Frontier Airlines,18,14,8,40,0.200000
2025-09-21,Frontier Communications,17,19,4,40,0.100000
2025-09-21,G-III Apparel Group,16,20,4,40,0.100000
2025-09-21,GE HealthCare Technologies,13,26,1,40,0.025000
2025-09-21,GE Vernova,26,13,1,40,0.025000
2025-09-21,GMS,16,22,2,40,0.050000
2025-09-21,GXO Logistics,15,21,4,40,0.100000
2025-09-21,GameStop,22,16,2,40,0.050000
2025-09-21,Gannett,20,13,7,40,0.175000
2025-09-21,Garrett Motion Inc,14,24,2,40,0.050000
2025-09-21,Gartner,12,22,6,40,0.150000
2025-09-21,Gen Digital,22,16,2,40,0.050000
2025-09-21,Generac,23,14,3,40,0.075000
2025-09-21,General Dynamics,38,1,1,40,0.025000
2025-09-21,General Mills,21,15,4,40,0.100000
2025-09-21,General Motors,16,20,4,40,0.100000
2025-09-21,Genesis Energy,33,5,2,40,0.050000
2025-09-21,Genuine Parts,20,19,1,40,0.025000
2025-09-21,Genworth Financial,20,19,1,40,0.025000
2025-09-21,Gilead Sciences,21,18,1,40,0.025000
2025-09-21,Global Partners,14,20,6,40,0.150000
2025-09-21,Global Payments,17,20,3,40,0.075000
2025-09-21,Globe Life,17,19,4,40,0.100000
2025-09-21,GoDaddy,17,20,3,40,0.075000
2025-09-21,Goldman Sachs,19,16,5,40,0.125000
2025-09-21,Goodyear Tire & Rubber,14,23,3,40,0.075000
2025-09-21,Graham Holdings Company,22,15,3,40,0.075000
2025-09-21,Granite Construction,22,16,2,40,0.050000
2025-09-21,Graphic Packaging,16,19,5,40,0.125000
2025-09-21,Gray Television,12,20,8,40,0.200000
2025-09-21,Graybar Electric,15,20,5,40,0.125000
2025-09-21,Green Plains Inc,20,16,4,40,0.100000
2025-09-21,Greenbrier,12,14,14,40,0.350000
2025-09-21,Greif,10,28,2,40,0.050000
2025-09-21,Griffon Corporation,18,20,2,40,0.050000
2025-09-21,Grocery Outlet Holding,15,21,4,40,0.100000
2025-09-21,Group 1 Automotive,15,20,5,40,0.125000
2025-09-21,Guardian Life insurance,20,20,0,40,0.000000
2025-09-21,Guess Inc,13,25,2,40,0.050000
2025-09-21,GuideWell Mutual,20,19,1,40,0.025000
2025-09-21,HB Fuller,12,24,4,40,0.100000
2025-09-21,HCA Healthcare,26,10,4,40,0.100000
2025-09-21,HEICO,17,19,4,40,0.100000
2025-09-21,HF SInclair,14,22,4,40,0.100000
2025-09-21,HP,14,22,4,40,0.100000
2025-09-21,Halliburton,12,15,13,40,0.325000
2025-09-21,Hanesbrands,15,22,3,40,0.075000
2025-09-21,Hanover Insurance Group,18,20,2,40,0.050000
2025-09-21,Harley-Davidson,10,22,8,40,0.200000
2025-09-21,Hasbro,15,20,5,40,0.125000
2025-09-21,Hawaiian Airlines Inc,18,21,1,40,0.025000
2025-09-21,Hawaiian Electric Industries,17,20,3,40,0.075000
2025-09-21,Helmerich & Payne,12,24,4,40,0.100000
2025-09-21,Henry Schein,20,19,1,40,0.025000
2025-09-21,Herc Rentals,18,17,5,40,0.125000
2025-09-21,Hershey,19,17,4,40,0.100000
2025-09-21,Hertz,25,9,6,40,0.150000
2025-09-21,Hewlett Packard Enterprise,17,23,0,40,0.000000
2025-09-21,Hillenbrand,15,21,4,40,0.100000
2025-09-21,Hilton Grand Vacations,39,1,0,40,0.000000
2025-09-21,Hilton Worldwide,20,19,1,40,0.025000
2025-09-21,Hologic,16,24,0,40,0.000000
2025-09-21,Home Depot,16,20,4,40,0.100000
2025-09-21,Honeywell,14,14,12,40,0.300000
2025-09-21,Hormel Foods,12,25,3,40,0.075000
2025-09-21,Host Hotels & Resorts,11,27,2,40,0.050000
2025-09-21,Hovnanian Enterprises,15,22,3,40,0.075000
2025-09-21,Howmet Aerospace,25,11,4,40,0.100000
2025-09-21,Hub Group,12,22,6,40,0.150000
2025-09-21,Hubbell,17,17,6,40,0.150000
2025-09-21,Humana,19,17,4,40,0.100000
2025-09-21,Huntington Bancshares,16,21,3,40,0.075000
2025-09-21,Huntington Ingalls Industries,21,13,6,40,0.150000
2025-09-21,Huntsman,6,18,16,40,0.400000
2025-09-21,Hyatt Hotels,15,24,1,40,0.025000
2025-09-21,Hyster-Yale,12,22,6,40,0.150000
2025-09-21,IAC,14,21,5,40,0.125000
2025-09-21,IBM,16,20,4,40,0.100000
2025-09-21,IDEX,19,17,4,40,0.100000
2025-09-21,IDEXX Laboratories,25,15,0,40,0.000000
2025-09-21,IQVIA,27,12,1,40,0.025000
2025-09-21,ITT,20,16,4,40,0.100000
2025-09-21,Icahn Enterprises,12,17,11,40,0.275000
2025-09-21,Illinois Tool Works,25,12,3,40,0.075000
2025-09-21,Illumina Inc,23,15,2,40,0.050000
2025-09-21,Incyte,23,15,2,40,0.050000
2025-09-21,Ingersoll Rand,20,17,3,40,0.075000
2025-09-21,Ingles Markets,11,18,11,40,0.275000
2025-09-21,Ingredion,21,17,2,40,0.050000
2025-09-21,Insight Enterprises,15,19,6,40,0.150000
2025-09-21,Insperity,23,14,3,40,0.075000
2025-09-21,Instacart,11,25,4,40,0.100000
2025-09-21,Installed Building Products,11,27,2,40,0.050000
2025-09-21,Intel,7,25,8,40,0.200000
2025-09-21,Interactive Brokers,24,14,2,40,0.050000
2025-09-21,Intercontinental Exchange,24,15,1,40,0.025000
2025-09-21,International Flavors & Fragrances,18,19,3,40,0.075000
2025-09-21,International Paper,17,19,4,40,0.100000
2025-09-21,Interpublic Group,19,17,4,40,0.100000
2025-09-21,Intuit,24,13,3,40,0.075000
2025-09-21,Intuitive Surgical,21,14,5,40,0.125000
2025-09-21,Iron Mountain,8,25,7,40,0.175000
2025-09-21,JB Hunt Transport Services,8,24,8,40,0.200000
2025-09-21,JELD-WEN Holding,12,21,7,40,0.175000
2025-09-21,JM Smucker,20,16,4,40,0.100000
2025-09-21,JPMorgan Chase,22,16,2,40,0.050000
2025-09-21,Jabil,14,24,2,40,0.050000
2025-09-21,Jackson Financial,23,15,2,40,0.050000
2025-09-21,Jacobs Solutions,34,1,5,40,0.125000
2025-09-21,Jefferies Financial,19,19,2,40,0.050000
2025-09-21,JetBlue Airways,14,22,4,40,0.100000
2025-09-21,Johnson & Johnson,24,14,2,40,0.050000
2025-09-21,Jones Lang LaSalle,18,22,0,40,0.000000
2025-09-21,Juniper Networks,14,23,3,40,0.075000
2025-09-21,KB Home,22,17,1,40,0.025000
2025-09-21,KBR,31,8,1,40,0.025000
2025-09-21,KKR & Co,23,16,1,40,0.025000
2025-09-21,KLA,15,17,8,40,0.200000
2025-09-21,Kaiser Aluminum,14,25,1,40,0.025000
2025-09-21,Kellanova,17,18,5,40,0.125000
2025-09-21,Kelly Services Inc,13,22,5,40,0.125000
2025-09-21,Kemper Corporation,18,16,6,40,0.150000
2025-09-21,Kenvue,18,17,5,40,0.125000
2025-09-21,Keurig Dr Pepper,10,27,3,40,0.075000
2025-09-21,KeyCorp,17,16,7,40,0.175000
2025-09-21,Keysight Technologies,27,12,1,40,0.025000
2025-09-21,Kimberly-Clark,17,18,5,40,0.125000
2025-09-21,Kinder Morgan,40,0,0,40,0.000000
2025-09-21,Kirby Corporation,17,19,4,40,0.100000
2025-09-21,Knife River Corporation,14,21,5,40,0.125000
2025-09-21,Knight Swift Transportation,18,18,4,40,0.100000
2025-09-21,Kohl's,16,18,6,40,0.150000
2025-09-21,Kontoor Brands,17,21,2,40,0.050000
2025-09-21,Korn Ferry,25,11,4,40,0.100000
2025-09-21,Kraft Heinz,14,20,6,40,0.150000
2025-09-21,Kroger,15,22,3,40,0.075000
2025-09-21,Kyndryl,14,23,3,40,0.075000
2025-09-21,L3Harris Technologies,22,15,3,40,0.075000
2025-09-21,LCI Industries,18,19,3,40,0.075000
2025-09-21,LKQ,16,23,1,40,0.025000
2025-09-21,LPL Financial,22,16,2,40,0.050000
2025-09-21,Labcorp Holdings,27,12,1,40,0.025000
2025-09-21,Lam Research,16,22,2,40,0.050000
2025-09-21,Lamb Weston,14,25,1,40,0.025000
2025-09-21,Land O'Lakes,14,23,3,40,0.075000
2025-09-21,Landstar System,14,16,10,40,0.250000
2025-09-21,Las Vegas Sands,13,25,2,40,0.050000
2025-09-21,Lear Corporation,22,14,4,40,0.100000
2025-09-21,Leggett & Platt,13,23,4,40,0.100000
2025-09-21,Leidos,20,17,3,40,0.075000
2025-09-21,Lennar,11,19,10,40,0.250000
2025-09-21,Lennox International,15,20,5,40,0.125000
2025-09-21,Levi Strauss,10,29,1,40,0.025000
2025-09-21,Liberty Energy,40,0,0,40,0.000000
2025-09-21,Liberty Media,38,1,1,40,0.025000
2025-09-21,Liberty Mutual Insurance,31,2,7,40,0.175000
2025-09-21,Light & Wonder,9,25,6,40,0.150000
2025-09-21,Lincoln Electric,19,18,3,40,0.075000
2025-09-21,Lincoln National,12,19,9,40,0.225000
2025-09-21,Lithia Motors,17,21,2,40,0.050000
2025-09-21,Live Nation Entertainment,14,11,15,40,0.375000
2025-09-21,Lockheed Martin,23,10,7,40,0.175000
2025-09-21,Loews,22,17,1,40,0.025000
2025-09-21,Louisiana-Pacific Corporation,17,19,4,40,0.100000
2025-09-21,Lowe's,14,6,20,40,0.500000
2025-09-21,Lululemon athletica,11,21,8,40,0.200000
2025-09-21,Lumen Technologies,9,26,5,40,0.125000
2025-09-21,Lyft,9,27,4,40,0.100000
2025-09-21,M&T Bank,13,19,8,40,0.200000
2025-09-21,M/I Homes,13,24,3,40,0.075000
2025-09-21,MDU Resources Group,14,24,2,40,0.050000
2025-09-21,MGM Resorts International,11,29,0,40,0.000000
2025-09-21,MKS Instruments,20,20,0,40,0.000000
2025-09-21,MRC Global,18,22,0,40,0.000000
2025-09-21,MSC Industrial Direct,14,23,3,40,0.075000
2025-09-21,MSCI,17,21,2,40,0.050000
2025-09-21,MYR Group,20,17,3,40,0.075000
2025-09-21,Macys,21,18,1,40,0.025000
2025-09-21,ManpowerGroup,18,14,8,40,0.200000
2025-09-21,Marathon Oil,16,20,4,40,0.100000
2025-09-21,Marathon Petroleum,21,16,3,40,0.075000
2025-09-21,Markel Group,24,16,0,40,0.000000
2025-09-21,Marriott International,21,15,4,40,0.100000
2025-09-21,Marriott Vacations Worldwide,18,17,5,40,0.125000
2025-09-21,Marsh & McLennan,21,14,5,40,0.125000
2025-09-21,Martin Marietta Materials,14,19,7,40,0.175000
2025-09-21,Marvell Technology,13,21,6,40,0.150000
2025-09-21,MasTec,21,17,2,40,0.050000
2025-09-21,Masco,11,23,6,40,0.150000
2025-09-21,Mass Mutual,12,25,3,40,0.075000
2025-09-21,MasterBrand,13,25,2,40,0.050000
2025-09-21,Mastercard,23,15,2,40,0.050000
2025-09-21,Matador Resources,15,23,2,40,0.050000
2025-09-21,Match Group,10,17,13,40,0.325000
2025-09-21,Mativ,17,18,5,40,0.125000
2025-09-21,Matson Inc,20,15,5,40,0.125000
2025-09-21,Mattel,16,17,7,40,0.175000
2025-09-21,Maximus,8,25,7,40,0.175000
2025-09-21,McCormick & Company,17,17,6,40,0.150000
2025-09-21,McDonalds,12,25,3,40,0.075000
2025-09-21,McKesson,21,17,2,40,0.050000
2025-09-21,Medical Mutual of Ohio,14,17,9,40,0.225000
2025-09-21,Merck,25,12,3,40,0.075000
2025-09-21,Mercury General,14,17,9,40,0.225000
2025-09-21,Meritage Homes,11,25,4,40,0.100000
2025-09-21,MetLife,24,12,4,40,0.100000
2025-09-21,Meta Platforms,25,6,9,40,0.225000
2025-09-21,Mettler-Toledo International,20,20,0,40,0.000000
2025-09-21,Microchip Technology,24,14,2,40,0.050000
2025-09-21,Micron Technology,15,18,7,40,0.175000
2025-09-21,Microsoft,11,22,7,40,0.175000
2025-09-21,Middleby,13,23,4,40,0.100000
2025-09-21,MillerKnoll,12,24,4,40,0.100000
2025-09-21,Moderna,17,16,7,40,0.175000
2025-09-21,ModivCare,13,18,9,40,0.225000
2025-09-21,Mohawk Industries,13,23,4,40,0.100000
2025-09-21,Molina Healthcare,19,13,8,40,0.200000
2025-09-21,Molson Coors Beverage,13,19,8,40,0.200000
2025-09-21,Mondelez,20,18,2,40,0.050000
2025-09-21,Monster Beverage,22,17,1,40,0.025000
2025-09-21,Moodys Corporation,5,15,3,23,0.130435
2025-09-21,Moog Inc,23,15,2,40,0.050000
2025-09-21,Morgan Stanley,18,14,8,40,0.200000
2025-09-21,Motorola Solutions,33,2,5,40,0.125000
2025-09-21,Mueller Industries,26,12,2,40,0.050000
2025-09-21,Murphy Oil,10,25,5,40,0.125000
2025-09-21,Murphy USA,16,23,1,40,0.025000
2025-09-21,Mutual of Omaha,21,16,3,40,0.075000
2025-09-21,NCR Atleos,13,25,2,40,0.050000
2025-09-21,NCR Voyix,15,20,5,40,0.125000
2025-09-21,NGL Energy Partners,35,1,4,40,0.100000
2025-09-21,NLV Financial,4,3,3,10,0.300000
2025-09-21,NOV,16,22,2,40,0.050000
2025-09-21,NVR Inc,23,14,3,40,0.075000
2025-09-21,Nasdaq Inc,16,23,1,40,0.025000
2025-09-21,Nationwide Insurance,11,17,12,40,0.300000
2025-09-21,Navient,18,14,8,40,0.200000
2025-09-21,NetApp,22,17,1,40,0.025000
2025-09-21,Netflix,18,15,7,40,0.175000
2025-09-21,NeueHealth,16,23,1,40,0.025000
2025-09-21,New York Life Insurance,16,22,2,40,0.050000
2025-09-21,NewMarket Corporation,24,15,1,40,0.025000
2025-09-21,Newell Brands,12,23,5,40,0.125000
2025-09-21,Newmont,16,20,4,40,0.100000
2025-09-21,News Corp,12,21,7,40,0.175000
2025-09-21,Nexstar Media Group,17,16,7,40,0.175000
2025-09-21,NextEra Energy,39,1,0,40,0.000000
2025-09-21,NiSource,21,12,7,40,0.175000
2025-09-21,Nike,14,18,8,40,0.200000
2025-09-21,Nordson,20,19,1,40,0.025000
2025-09-21,Nordstrom,13,23,4,40,0.100000
2025-09-21,Norfolk Southern,21,13,6,40,0.150000
2025-09-21,Northern Trust,37,3,0,40,0.000000
2025-09-21,Northrop Grumman,15,21,4,40,0.100000
2025-09-21,Northwestern Mutual,18,13,9,40,0.225000
2025-09-21,Nucor,17,12,11,40,0.275000
2025-09-21,Nvidia,9,24,7,40,0.175000
2025-09-21,O'Reilly Automotive,25,13,2,40,0.050000
2025-09-21,O-I Glass,22,14,4,40,0.100000
2025-09-21,ODP Business Solutions,19,21,0,40,0.000000
2025-09-21,OGE Energy,37,2,1,40,0.025000
2025-09-21,ON Semiconductor,17,18,5,40,0.125000
2025-09-21,Occidental Petroleum,16,16,8,40,0.200000
2025-09-21,Old Dominion Freight Line,19,12,9,40,0.225000
2025-09-21,Old National Bancorp,17,22,1,40,0.025000
2025-09-21,Old Republic International,25,13,2,40,0.050000
2025-09-21,Olin,14,18,8,40,0.200000
2025-09-21,Omnicom Group,17,20,3,40,0.075000
2025-09-21,OneMain,17,23,0,40,0.000000
2025-09-21,Oneok,21,18,1,40,0.025000
2025-09-21,Opendoor Technologies,12,18,10,40,0.250000
2025-09-21,Option Care Health,39,1,0,40,0.000000
2025-09-21,Oracle,12,22,6,40,0.150000
2025-09-21,Organon,21,15,4,40,0.100000
2025-09-21,Oscar Health,18,16,6,40,0.150000
2025-09-21,Oshkosh Corporation,26,10,4,40,0.100000
2025-09-21,Otis Worldwide,17,18,5,40,0.125000
2025-09-21,Ovintiv,22,12,6,40,0.150000
2025-09-21,Owens & Minor,10,21,9,40,0.225000
2025-09-21,Owens Corning,12,28,0,40,0.000000
2025-09-21,PACS Group,15,14,11,40,0.275000
2025-09-21,PBF Energy,36,1,3,40,0.075000
2025-09-21,PC Connection Inc,25,14,1,40,0.025000
2025-09-21,PENN Entertainment,33,6,1,40,0.025000
2025-09-21,PG&E,18,16,6,40,0.150000
2025-09-21,PNC Financial Services,23,15,2,40,0.050000
2025-09-21,PPG Industries,22,15,3,40,0.075000
2025-09-21,PPL Corporation,16,22,2,40,0.050000
2025-09-21,PVH,15,17,8,40,0.200000
2025-09-21,Paccar,21,15,4,40,0.100000
2025-09-21,Pacific Life,17,23,0,40,0.000000
2025-09-21,Packaging Corp of America,9,28,3,40,0.075000
2025-09-21,Palo Alto Networks,15,14,11,40,0.275000
2025-09-21,Par Pacific,15,25,0,40,0.000000
2025-09-21,Paramount Global,12,20,8,40,0.200000
2025-09-21,Park Hotels & Resorts,17,20,3,40,0.075000
2025-09-21,Parker-Hannifin,28,12,0,40,0.000000
2025-09-21,Parsons Corporation,22,17,1,40,0.025000
2025-09-21,Patrick Industries,15,21,4,40,0.100000
2025-09-21,Patterson Companies Inc,9,28,3,40,0.075000
2025-09-21,Patterson-UTI Energy,31,5,4,40,0.100000
2025-09-21,PayPal,18,19,3,40,0.075000
2025-09-21,Paychex,24,12,4,40,0.100000
2025-09-21,Peabody Energy,34,5,1,40,0.025000
2025-09-21,Peloton Interactive,21,18,1,40,0.025000
2025-09-21,Penn Mutual Life Insurance,20,16,4,40,0.100000
2025-09-21,PennyMac Financial Services,16,22,2,40,0.050000
2025-09-21,Penske Automotive,16,22,2,40,0.050000
2025-09-21,PepsiCo,19,16,5,40,0.125000
2025-09-21,Performance Food,23,17,0,40,0.000000
2025-09-21,Permian Resources,20,18,2,40,0.050000
2025-09-21,Petco Health and Wellness,34,2,4,40,0.100000
2025-09-21,Peter Kiewit Sons',9,20,11,40,0.275000
2025-09-21,Pfizer,19,18,3,40,0.075000
2025-09-21,Philip Morris International,22,15,3,40,0.075000
2025-09-21,Phillips 66,24,16,0,40,0.000000
2025-09-21,Pinnacle West Capital,19,12,9,40,0.225000
2025-09-21,Pinterest,12,25,3,40,0.075000
2025-09-21,Pioneer Natural Resources,18,11,11,40,0.275000
2025-09-21,Pitney Bowes,17,21,2,40,0.050000
2025-09-21,Plains GP,18,7,15,40,0.375000
2025-09-21,Playtika Holding,12,18,10,40,0.250000
2025-09-21,Plexus Corp,14,23,3,40,0.075000
2025-09-21,Polaris Inc,22,16,2,40,0.050000
2025-09-21,Pool Corporation,19,19,2,40,0.050000
2025-09-21,Popular Inc,39,1,0,40,0.000000
2025-09-21,Portland General Electric,14,23,3,40,0.075000
2025-09-21,Post Holdings,13,25,2,40,0.050000
2025-09-21,PrIncipal Financial,19,20,1,40,0.025000
2025-09-21,PriceSmart,17,23,0,40,0.000000
2025-09-21,Primerica,20,16,4,40,0.100000
2025-09-21,Primoris Services,16,23,1,40,0.025000
2025-09-21,ProFrac Holding,14,21,5,40,0.125000
2025-09-21,Procter & Gamble,26,11,3,40,0.075000
2025-09-21,Progressive Insurance,16,20,4,40,0.100000
2025-09-21,Prologis,20,18,2,40,0.050000
2025-09-21,Prudential Financial,20,17,3,40,0.075000
2025-09-21,Public Service Enterprise Group,20,19,1,40,0.025000
2025-09-21,Public Storage,19,15,6,40,0.150000
2025-09-21,Publix Super Markets,24,13,3,40,0.075000
2025-09-21,Puget Sound Energy,31,7,2,40,0.050000
2025-09-21,PulteGroup,16,20,4,40,0.100000
2025-09-21,Pure Storage,14,22,4,40,0.100000
2025-09-21,QVC Group,14,22,4,40,0.100000
2025-09-21,QXO Building Products,1,7,2,10,0.200000
2025-09-21,Qorvo,24,12,4,40,0.100000
2025-09-21,Qualcomm,21,17,2,40,0.050000
2025-09-21,Quanta Services,23,14,3,40,0.075000
2025-09-21,Quest Diagnostics,8,29,3,40,0.075000
2025-09-21,QuidelOrtho,19,19,2,40,0.050000
2025-09-21,REV Group,22,12,6,40,0.150000
2025-09-21,RPM International,16,21,3,40,0.075000
2025-09-21,RTX,18,18,4,40,0.100000
2025-09-21,RXO Inc,17,21,2,40,0.050000
2025-09-21,Rackspace Technology,13,21,6,40,0.150000
2025-09-21,Radius Recycling,4,22,14,40,0.350000
2025-09-21,Ralph Lauren,8,32,0,40,0.000000
2025-09-21,Range Resources,15,18,7,40,0.175000
2025-09-21,Raymond James Financial,12,27,1,40,0.025000
2025-09-21,Realty Income,22,12,6,40,0.150000
2025-09-21,Regal Rexnord,11,22,7,40,0.175000
2025-09-21,Regeneron Pharmaceuticals,23,14,3,40,0.075000
2025-09-21,Regions Financial,19,19,2,40,0.050000
2025-09-21,Reinsurance Group of America,21,17,2,40,0.050000
2025-09-21,Reliance Inc,30,9,1,40,0.025000
2025-09-21,Republic Services,22,9,9,40,0.225000
2025-09-21,ResMed,16,22,2,40,0.050000
2025-09-21,Resideo Technologies,17,19,4,40,0.100000
2025-09-21,Restoration Hardware,13,20,7,40,0.175000
2025-09-21,Revvity,17,18,5,40,0.125000
2025-09-21,Rithm Capital,12,26,2,40,0.050000
2025-09-21,Rivian Automotive,16,22,2,40,0.050000
2025-09-21,Robert Half,20,18,2,40,0.050000
2025-09-21,Roblox,6,16,18,40,0.450000
2025-09-21,Rocket Companies,18,16,6,40,0.150000
2025-09-21,Rockwell Automation,20,17,3,40,0.075000
2025-09-21,Roku,24,14,2,40,0.050000
2025-09-21,Rollins Inc,18,22,0,40,0.000000
2025-09-21,Roper Technologies,22,16,2,40,0.050000
2025-09-21,Ross Stores,23,14,3,40,0.075000
2025-09-21,Rush Enterprises,21,16,3,40,0.075000
2025-09-21,Ryder System,21,15,4,40,0.100000
2025-09-21,Ryerson Holding,10,25,5,40,0.125000
2025-09-21,S&P Global,15,18,7,40,0.175000
2025-09-21,SBA Communications,17,15,8,40,0.200000
2025-09-21,SS&C Technologies,16,24,0,40,0.000000
2025-09-21,Sabre Corporation,16,18,6,40,0.150000
2025-09-21,Saia Inc,22,15,3,40,0.075000
2025-09-21,Salesforce,22,6,12,40,0.300000
2025-09-21,Sallie Mae,16,21,3,40,0.075000
2025-09-21,Sally Beauty,40,0,0,40,0.000000
2025-09-21,Sanmina,15,23,2,40,0.050000
2025-09-21,ScanSource,21,17,2,40,0.050000
2025-09-21,Schneider National,15,22,3,40,0.075000
2025-09-21,Science Applications International,13,19,8,40,0.200000
2025-09-21,Scotts Miracle-Gro,18,19,3,40,0.075000
2025-09-21,Seaboard,18,17,5,40,0.125000
2025-09-21,Sealed Air Corporation,10,27,3,40,0.075000
2025-09-21,Securian Financial,13,25,2,40,0.050000
2025-09-21,Select Medical Holdings,10,22,8,40,0.200000
2025-09-21,Selective Insurance Group,21,12,7,40,0.175000
2025-09-21,Sempra,27,13,0,40,0.000000
2025-09-21,Sentry Insurance Group,3,6,0,9,0.000000
2025-09-21,Service Corp International,7,10,5,22,0.227273
2025-09-21,ServiceNow,18,17,5,40,0.125000
2025-09-21,Sherwin-Williams,9,24,7,40,0.175000
2025-09-21,Shift4 Payments,14,22,4,40,0.100000
2025-09-21,Silgan,12,20,8,40,0.200000
2025-09-21,Simon Property Group,15,21,4,40,0.100000
2025-09-21,Sinclair,16,17,7,40,0.175000
2025-09-21,Sirius XM,15,22,3,40,0.075000
2025-09-21,SiteOne Landscape Supply,14,19,7,40,0.175000
2025-09-21,Skechers USA,17,21,2,40,0.050000
2025-09-21,SkyWest,9,20,11,40,0.275000
2025-09-21,Skyline Champion,32,6,2,40,0.050000
2025-09-21,Skyworks Solutions,34,2,4,40,0.100000
2025-09-21,Smurfit Westrock,14,23,3,40,0.075000
2025-09-21,Snap Inc,17,15,8,40,0.200000
2025-09-21,Snap-on,10,21,9,40,0.225000
2025-09-21,Snowflake Inc,27,13,0,40,0.000000
2025-09-21,Solventum,16,22,2,40,0.050000
2025-09-21,Sonic Automotive,13,24,3,40,0.075000
2025-09-21,Sonoco Products,19,18,3,40,0.075000
2025-09-21,Southern Company,24,15,1,40,0.025000
2025-09-21,Southwest Airlines,12,22,6,40,0.150000
2025-09-21,Southwest Gas Holdings,14,25,1,40,0.025000
2025-09-21,SpartanNash,18,22,0,40,0.000000
2025-09-21,Spectrum Brands,13,19,8,40,0.200000
2025-09-21,Spire Inc,26,12,2,40,0.050000
2025-09-21,Spirit AeroSystems,31,2,7,40,0.175000
2025-09-21,Spirit Airlines,20,2,18,40,0.450000
2025-09-21,Splunk,12,25,3,40,0.075000
2025-09-21,Sprouts Farmers Market,9,29,2,40,0.050000
2025-09-21,Stagwell,8,24,8,40,0.200000
2025-09-21,Stanley Black & Decker,10,27,3,40,0.075000
2025-09-21,Starbucks,12,23,5,40,0.125000
2025-09-21,State Farm Insurance,11,20,9,40,0.225000
2025-09-21,State Street,17,22,1,40,0.025000
2025-09-21,Steel Dynamics,36,2,2,40,0.050000
2025-09-21,Steelcase,16,22,2,40,0.050000
2025-09-21,Stericycle,11,8,21,40,0.525000
2025-09-21,Stifel Financial,20,18,2,40,0.050000
2025-09-21,StoneX Group,13,25,2,40,0.050000
2025-09-21,Stryker,15,23,2,40,0.050000
2025-09-21,Summit Materials,12,25,3,40,0.075000
2025-09-21,Sun Communities,27,13,0,40,0.000000
2025-09-21,Super Micro Computer,37,1,2,40,0.050000
2025-09-21,Surgery Partners,19,18,3,40,0.075000
2025-09-21,Sylvamo,15,21,4,40,0.100000
2025-09-21,Synchrony Financial,19,18,3,40,0.075000
2025-09-21,Synopsys,18,14,8,40,0.200000
2025-09-21,Synovus Financial,15,21,4,40,0.100000
2025-09-21,Sysco,23,17,0,40,0.000000
2025-09-21,T Rowe Price,19,21,0,40,0.000000
2025-09-21,TD Synnex,22,18,0,40,0.000000
2025-09-21,TEGNA,14,19,7,40,0.175000
2025-09-21,THOR Industries,13,22,5,40,0.125000
2025-09-21,TIAA,13,23,4,40,0.100000
2025-09-21,TJX,24,15,1,40,0.025000
2025-09-21,Take-Two Interactive Software,20,19,1,40,0.025000
2025-09-21,Talen Energy,38,1,1,40,0.025000
2025-09-21,Tapestry,10,24,6,40,0.150000
2025-09-21,Targa Resources,17,21,2,40,0.050000
2025-09-21,Target Corporation,26,13,1,40,0.025000
2025-09-21,Taylor Morrison Home,21,16,3,40,0.075000
2025-09-21,Teladoc Health,16,18,6,40,0.150000
2025-09-21,Teledyne Technologies,20,20,0,40,0.000000
2025-09-21,Teleflex,10,26,4,40,0.100000
2025-09-21,Telephone & Data Systems,12,18,3,33,0.090909
2025-09-21,TelevisaUnivision,10,20,10,40,0.250000
2025-09-21,Tempur Sealy International,9,26,5,40,0.125000
2025-09-21,Tenet Healthcare,21,17,2,40,0.050000
2025-09-21,Teradyne,24,16,0,40,0.000000
2025-09-21,Terex,14,23,3,40,0.075000
2025-09-21,Tesla,14,15,11,40,0.275000
2025-09-21,Tetra Tech,22,15,3,40,0.075000
2025-09-21,Texas Instruments,15,21,4,40,0.100000
2025-09-21,Texas Roadhouse,19,14,7,40,0.175000
2025-09-21,Textron,15,21,4,40,0.100000
2025-09-21,The Andersons Inc,18,20,2,40,0.050000
2025-09-21,The Coca-Cola Company,11,23,6,40,0.150000
2025-09-21,The Hartford,14,15,11,40,0.275000
2025-09-21,The Mosaic Company,16,17,7,40,0.175000
2025-09-21,Thermo Fisher Scientific,25,14,1,40,0.025000
2025-09-21,Thrivent Financial for Lutherans,16,20,4,40,0.100000
2025-09-21,Timken,16,21,3,40,0.075000
2025-09-21,Titan Machinery,13,21,6,40,0.150000
2025-09-21,Toast Inc,17,21,2,40,0.050000
2025-09-21,Toll Brothers,13,26,1,40,0.025000
2025-09-21,TopBuild,14,26,0,40,0.000000
2025-09-21,Topgolf Callaway Brands,11,23,6,40,0.150000
2025-09-21,Toro Company,16,23,1,40,0.025000
2025-09-21,Tractor Supply,13,25,2,40,0.050000
2025-09-21,TransDigm,25,13,2,40,0.050000
2025-09-21,TransUnion,18,14,8,40,0.200000
2025-09-21,Travelers Insurance,14,18,8,40,0.200000
2025-09-21,TreeHouse Foods,9,20,11,40,0.275000
2025-09-21,Tri Pointe Homes,18,19,3,40,0.075000
2025-09-21,TriNet Group,20,16,4,40,0.100000
2025-09-21,Trimble Inc,16,21,3,40,0.075000
2025-09-21,Trinity Industries,20,13,7,40,0.175000
2025-09-21,TruStage,25,12,3,40,0.075000
2025-09-21,Truist Financial,19,18,3,40,0.075000
2025-09-21,Tutor Perini Corporation,23,16,1,40,0.025000
2025-09-21,Twilio,21,16,3,40,0.075000
2025-09-21,Tyson Foods,13,19,8,40,0.200000
2025-09-21,U-Haul,8,10,22,40,0.550000
2025-09-21,UFP Industries,16,21,3,40,0.075000
2025-09-21,UGI Utilities Inc,18,12,10,40,0.250000
2025-09-21,UL Solutions,36,1,3,40,0.075000
2025-09-21,UPS,9,21,10,40,0.250000
2025-09-21,US Bancorp,14,21,5,40,0.125000
2025-09-21,US Foods,29,10,1,40,0.025000
2025-09-21,USAA,18,16,6,40,0.150000
2025-09-21,Uber,6,26,8,40,0.200000
2025-09-21,Ulta Beauty,34,4,2,40,0.050000
2025-09-21,Under Armour,11,23,6,40,0.150000
2025-09-21,Union Pacific,19,16,5,40,0.125000
2025-09-21,United Airlines,32,4,4,40,0.100000
2025-09-21,United Natural Foods,37,2,1,40,0.025000
2025-09-21,United Rentals,39,0,1,40,0.025000
2025-09-21,United States Steel,21,12,7,40,0.175000
2025-09-21,UnitedHealth,20,15,5,40,0.125000
2025-09-21,Universal Corporation,18,19,3,40,0.075000
2025-09-21,Universal Health Services,19,17,4,40,0.100000
2025-09-21,Unum Group,17,19,4,40,0.100000
2025-09-21,Upbound Group,18,22,0,40,0.000000
2025-09-21,Urban Outfitters,13,24,3,40,0.075000
2025-09-21,V2X,24,11,5,40,0.125000
2025-09-21,VF Corporation,13,13,14,40,0.350000
2025-09-21,VICI Properties,22,18,0,40,0.000000
2025-09-21,Vail Resorts,8,17,15,40,0.375000
2025-09-21,Valero Energy,36,4,0,40,0.000000
2025-09-21,Valley National Bancorp,9,26,5,40,0.125000
2025-09-21,Valmont Industries,24,15,1,40,0.025000
2025-09-21,Valvoline Inc,17,21,2,40,0.050000
2025-09-21,Ventas Inc,25,14,1,40,0.025000
2025-09-21,Verisk Analytics,17,13,10,40,0.250000
2025-09-21,Verizon,21,12,7,40,0.175000
2025-09-21,Vertex Pharmaceuticals,19,16,5,40,0.125000
2025-09-21,Vertiv,22,17,1,40,0.025000
2025-09-21,Viasat,14,25,1,40,0.025000
2025-09-21,Viatris,13,19,8,40,0.200000
2025-09-21,Victorias Secret,16,16,8,40,0.200000
2025-09-21,Visa Inc,26,11,3,40,0.075000
2025-09-21,Vishay Intertechnology,11,24,5,40,0.125000
2025-09-21,Vista Outdoor,14,22,4,40,0.100000
2025-09-21,Visteon,18,19,3,40,0.075000
2025-09-21,Vistra,23,14,3,40,0.075000
2025-09-21,Vontier,18,19,3,40,0.075000
2025-09-21,Voya Financial,20,18,2,40,0.050000
2025-09-21,Vulcan Materials,13,23,4,40,0.100000
2025-09-21,WEC Energy,38,0,2,40,0.050000
2025-09-21,WESCO International,20,19,1,40,0.025000
2025-09-21,WEX,20,16,4,40,0.100000
2025-09-21,WR Berkley,21,19,0,40,0.000000
2025-09-21,WW Grainger,20,16,4,40,0.100000
2025-09-21,Wabash National,14,11,15,40,0.375000
2025-09-21,Walmart,21,11,8,40,0.200000
2025-09-21,Walt Disney,12,18,10,40,0.250000
2025-09-21,Warner Bros Discovery,16,18,6,40,0.150000
2025-09-21,Warner Music Group,7,30,3,40,0.075000
2025-09-21,Waters Corporation,22,15,3,40,0.075000
2025-09-21,Watsco,12,23,5,40,0.125000
2025-09-21,Wayfair,17,18,5,40,0.125000
2025-09-21,Webster Financial,18,19,3,40,0.075000
2025-09-21,Weis Markets,9,24,7,40,0.175000
2025-09-21,Wells Fargo,31,2,7,40,0.175000
2025-09-21,Welltower,30,10,0,40,0.000000
2025-09-21,Werner Enterprises,19,14,7,40,0.175000
2025-09-21,West Pharmaceutical Services,19,17,4,40,0.100000
2025-09-21,Western & Southern Financial,14,21,5,40,0.125000
2025-09-21,Western Alliance Bancorp,13,18,9,40,0.225000
2025-09-21,Western Digital,16,18,6,40,0.150000
2025-09-21,Western Midstream Partners,22,16,2,40,0.050000
2025-09-21,Western Union,14,22,4,40,0.100000
2025-09-21,Westinghouse Air Brake Technologies,18,18,4,40,0.100000
2025-09-21,Weyerhaeuser,15,22,3,40,0.075000
2025-09-21,Whirlpool,11,22,7,40,0.175000
2025-09-21,Williams Companies,22,16,2,40,0.050000
2025-09-21,Winnebago Industries,11,23,6,40,0.150000
2025-09-21,Wintrust Financial,15,24,1,40,0.025000
2025-09-21,Woodward Inc,18,21,1,40,0.025000
2025-09-21,Workday,15,19,6,40,0.150000
2025-09-21,World Kinect,16,21,3,40,0.075000
2025-09-21,Worthington Enterprises,16,23,1,40,0.025000
2025-09-21,Wynn Resorts,18,17,5,40,0.125000
2025-09-21,XPO,15,22,3,40,0.075000
2025-09-21,Xcel Energy,33,5,2,40,0.050000
2025-09-21,Xerox,11,26,3,40,0.075000
2025-09-21,Xylem Inc,25,14,1,40,0.025000
2025-09-21,Yum Brands,15,23,2,40,0.050000
2025-09-21,Yum China,23,14,3,40,0.075000
2025-09-21,Zebra Technologies,14,24,2,40,0.050000
2025-09-21,Zimmer Biomet,12,27,1,40,0.025000
2025-09-21,Zions Bancorp,20,17,3,40,0.075000
2025-09-21,Zoetis,26,13,1,40,0.025000
2025-09-21,Zoom Video Communications,15,20,5,40,0.125000
2025-09-21,eXp World,13,24,3,40,0.075000
2025-09-21,iHeartMedia,11,24,5,40,0.125000
2025-09-22,3M,37,55,8,100,0.080000
2025-09-22,A O Smith,27,71,2,100,0.020000
2025-09-22,A-Mark Precious Metals,87,11,2,100,0.020000
2025-09-22,ABM Industries,22,63,15,100,0.150000
2025-09-22,ADT,42,38,20,100,0.200000
2025-09-22,AECOM,44,50,6,100,0.060000
2025-09-22,AES,40,50,10,100,0.100000
2025-09-22,AGCO,38,54,8,100,0.080000
2025-09-22,AGNC Investment,32,49,19,100,0.190000
2025-09-22,AIG,33,65,2,100,0.020000
2025-09-22,AMC Entertainment,77,18,5,100,0.050000
2025-09-22,AMC Networks,29,56,15,100,0.150000
2025-09-22,AMN Healthcare Services,19,68,13,100,0.130000
2025-09-22,APA,32,56,12,100,0.120000
2025-09-22,APi Group,37,56,7,100,0.070000
2025-09-22,ARKO,23,72,5,100,0.050000
2025-09-22,ASGN,23,68,9,100,0.090000
2025-09-22,AT&T,38,52,10,100,0.100000
2025-09-22,ATI Inc,38,57,5,100,0.050000
2025-09-22,AbbVie,44,50,6,100,0.060000
2025-09-22,Abbott Laboratories,63,33,4,100,0.040000
2025-09-22,Abercrombie & Fitch,37,58,5,100,0.050000
2025-09-22,Academy Sports and Outdoors,27,67,6,100,0.060000
2025-09-22,Acadia Healthcare,21,61,18,100,0.180000
2025-09-22,Ace Hardware,27,61,12,100,0.120000
2025-09-22,Acuity Inc,49,47,4,100,0.040000
2025-09-22,Adams Resources & Energy,16,6,1,23,0.043478
2025-09-22,AdaptHealth,35,56,9,100,0.090000
2025-09-22,Adobe,47,43,10,100,0.100000
2025-09-22,Advance Auto Parts,23,60,17,100,0.170000
2025-09-22,Advanced Drainage Systems,76,22,2,100,0.020000
2025-09-22,Advanced Micro Devices,69,23,2,94,0.021277
2025-09-22,Advantage Solutions,75,23,2,100,0.020000
2025-09-22,Aflac,32,43,25,100,0.250000
2025-09-22,Agilent Technologies,49,48,3,100,0.030000
2025-09-22,Agilon Health,25,63,12,100,0.120000
2025-09-22,Air Lease,29,67,4,100,0.040000
2025-09-22,Air Products & Chemicals,24,67,9,100,0.090000
2025-09-22,Airbnb,38,58,4,100,0.040000
2025-09-22,Akamai Technologies,48,45,7,100,0.070000
2025-09-22,Alaska Air,36,57,7,100,0.070000
2025-09-22,Albemarle Corporation,37,55,8,100,0.080000
2025-09-22,Albertsons,31,56,13,100,0.130000
2025-09-22,Alcoa Corporation,19,64,17,100,0.170000
2025-09-22,Alexandria Real Estate Equities,41,53,6,100,0.060000
2025-09-22,Alight Solutions,31,67,2,100,0.020000
2025-09-22,Align Technology,21,68,11,100,0.110000
2025-09-22,Allegiant Travel Company,20,72,8,100,0.080000
2025-09-22,Alliance Resource Partners,31,57,12,100,0.120000
2025-09-22,Alliant Energy,77,22,1,100,0.010000
2025-09-22,Allison Transmission,31,57,12,100,0.120000
2025-09-22,Allstate,64,21,15,100,0.150000
2025-09-22,Ally Financial,36,62,2,100,0.020000
2025-09-22,Alpha Metallurgical Resources,31,55,14,100,0.140000
2025-09-22,Alphabet,50,42,8,100,0.080000
2025-09-22,Altice USA,30,61,9,100,0.090000
2025-09-22,Altria,53,43,4,100,0.040000
2025-09-22,Amazon,31,50,20,101,0.198020
2025-09-22,Ameren,38,50,12,100,0.120000
2025-09-22,American Airlines,28,45,27,100,0.270000
2025-09-22,American Axle & Manufacturing,27,62,11,100,0.110000
2025-09-22,American Eagle Outfitters,33,52,15,100,0.150000
2025-09-22,American Electric Power,50,46,4,100,0.040000
2025-09-22,American Express,47,47,6,100,0.060000
2025-09-22,American Family Insurance,45,49,6,100,0.060000
2025-09-22,American Financial Group,32,58,10,100,0.100000
2025-09-22,American Tower,47,48,5,100,0.050000
2025-09-22,American Water Works,46,49,5,100,0.050000
2025-09-22,Americold Realty Trust,66,29,5,100,0.050000
2025-09-22,Ameriprise Financial,41,50,9,100,0.090000
2025-09-22,Ametek,56,43,1,100,0.010000
2025-09-22,Amgen,56,36,8,100,0.080000
2025-09-22,Amica Mutual Insurance,24,65,3,92,0.032609
2025-09-22,Amkor Technology,38,58,4,100,0.040000
2025-09-22,Amphenol,53,46,1,100,0.010000
2025-09-22,Analog Devices,46,49,5,100,0.050000
2025-09-22,Antero Resources,38,61,1,100,0.010000
2025-09-22,Anywhere Real Estate Inc,35,51,6,92,0.065217
2025-09-22,Apollo Global Management,31,62,7,100,0.070000
2025-09-22,AppLovin,42,50,8,100,0.080000
2025-09-22,Apple,41,55,9,105,0.085714
2025-09-22,Applied Industrial Technologies,30,68,2,100,0.020000
2025-09-22,Applied Materials,15,65,20,100,0.200000
2025-09-22,AptarGroup,29,68,3,100,0.030000
2025-09-22,Aramark,46,51,3,100,0.030000
2025-09-22,ArcBest,29,68,3,100,0.030000
2025-09-22,Arch Resources,59,31,10,100,0.100000
2025-09-22,Archer Daniels Midland,43,49,8,100,0.080000
2025-09-22,Ares Management,42,58,0,100,0.000000
2025-09-22,Arista Networks,54,43,3,100,0.030000
2025-09-22,Arrow Electronics,30,66,4,100,0.040000
2025-09-22,Arthur J Gallagher,33,64,3,100,0.030000
2025-09-22,Asbury Automotive Group,31,62,7,100,0.070000
2025-09-22,Assurant,46,47,7,100,0.070000
2025-09-22,Atkore,33,62,5,100,0.050000
2025-09-22,Atlassian,21,48,31,100,0.310000
2025-09-22,Atmos Energy,87,9,4,100,0.040000
2025-09-22,Auto-Owners Insurance,36,57,7,100,0.070000
2025-09-22,AutoNation,29,60,11,100,0.110000
2025-09-22,AutoZone,23,63,14,100,0.140000
2025-09-22,Autodesk,28,68,4,100,0.040000
2025-09-22,Autoliv,46,49,5,100,0.050000
2025-09-22,Automatic Data Processing,52,41,7,100,0.070000
2025-09-22,AvalonBay Communities,33,60,7,100,0.070000
2025-09-22,Avantor,29,60,11,100,0.110000
2025-09-22,Avery Dennison,36,62,2,100,0.020000
2025-09-22,Avient,34,58,8,100,0.080000
2025-09-22,Avis Budget,24,66,10,100,0.100000
2025-09-22,Avnet,24,70,6,100,0.060000
2025-09-22,BJ's Wholesale Club,29,61,10,100,0.100000
2025-09-22,BOK Financial,41,48,11,100,0.110000
2025-09-22,BWX Technologies,62,37,1,100,0.010000
2025-09-22,Baker Hughes,49,50,1,100,0.010000
2025-09-22,Ball Corporation,37,58,5,100,0.050000
2025-09-22,Bank of America,31,63,6,100,0.060000
2025-09-22,Bank of New York Mellon,49,48,3,100,0.030000
2025-09-22,Bath & Body Works,35,52,13,100,0.130000
2025-09-22,Baxter International,27,64,9,100,0.090000
2025-09-22,Becton Dickinson,45,46,9,100,0.090000
2025-09-22,Belden,30,59,11,100,0.110000
2025-09-22,Benchmark Electronics,23,73,4,100,0.040000
2025-09-22,Berkshire Hathaway,19,64,9,92,0.097826
2025-09-22,Berry Global,23,66,11,100,0.110000
2025-09-22,Best Buy,93,6,1,100,0.010000
2025-09-22,Bio-Rad Laboratories,25,67,8,100,0.080000
2025-09-22,Biogen,34,60,6,100,0.060000
2025-09-22,BlackRock,37,56,7,100,0.070000
2025-09-22,Blackstone,40,53,7,100,0.070000
2025-09-22,Bloomin Brands,14,74,12,100,0.120000
2025-09-22,BlueLinx,20,74,6,100,0.060000
2025-09-22,Boeing,20,60,22,102,0.215686
2025-09-22,Boise Cascade,17,73,10,100,0.100000
2025-09-22,Booking Holdings,55,41,4,100,0.040000
2025-09-22,Booz Allen Hamilton,32,56,12,100,0.120000
2025-09-22,BorgWarner,59,37,4,100,0.040000
2025-09-22,Boston Properties,21,76,3,100,0.030000
2025-09-22,Boston Scientific,47,48,5,100,0.050000
2025-09-22,Boyd Gaming,36,63,1,100,0.010000
2025-09-22,Bread Financial,47,50,3,100,0.030000
2025-09-22,BrightSpring Health Services,36,56,8,100,0.080000
2025-09-22,BrightView Holdings,40,56,4,100,0.040000
2025-09-22,Brighthouse Financial,41,54,4,99,0.040404
2025-09-22,Brinker International,52,46,2,100,0.020000
2025-09-22,Brinks Company,14,5,4,23,0.173913
2025-09-22,Bristol-Myers Squibb,30,62,8,100,0.080000
2025-09-22,Broadcom,33,60,7,100,0.070000
2025-09-22,Broadridge Financial Solutions,57,42,1,100,0.010000
2025-09-22,Brookdale Senior Living,34,57,9,100,0.090000
2025-09-22,Brown & Brown,30,56,14,100,0.140000
2025-09-22,Brown-Forman,14,74,12,100,0.120000
2025-09-22,Bruker,27,60,13,100,0.130000
2025-09-22,Brunswick Corporation,45,43,12,100,0.120000
2025-09-22,Builders FirstSource,39,51,10,100,0.100000
2025-09-22,Burlington Stores,34,64,2,100,0.020000
2025-09-22,CACI International,50,47,3,100,0.030000
2025-09-22,CBRE Group,39,59,2,100,0.020000
2025-09-22,CDW,42,55,3,100,0.030000
2025-09-22,CF Industries,41,57,2,100,0.020000
2025-09-22,CH Robinson Worldwide,39,56,5,100,0.050000
2025-09-22,CHS,45,47,8,100,0.080000
2025-09-22,CIncinnati Financial,42,54,4,100,0.040000
2025-09-22,CME Group,27,66,7,100,0.070000
2025-09-22,CMS Energy,93,6,1,100,0.010000
2025-09-22,CNO Financial Group,28,67,5,100,0.050000
2025-09-22,CNX Resources,42,54,4,100,0.040000
2025-09-22,CSX,34,62,4,100,0.040000
2025-09-22,CVS Health,46,50,4,100,0.040000
2025-09-22,Cabot Corporation,32,62,6,100,0.060000
2025-09-22,Cadence,26,60,14,100,0.140000
2025-09-22,Caesars Entertainment,61,26,13,100,0.130000
2025-09-22,Cal-Maine Foods,56,40,4,100,0.040000
2025-09-22,Caleres Inc,28,65,7,100,0.070000
2025-09-22,California Resources,36,55,9,100,0.090000
2025-09-22,Calumet Inc,38,47,6,91,0.065934
2025-09-22,Campbell Soup,34,53,13,100,0.130000
2025-09-22,Camping World,25,65,10,100,0.100000
2025-09-22,Capital One,49,46,5,100,0.050000
2025-09-22,CarMax,20,54,26,100,0.260000
2025-09-22,Cardinal Health,35,56,9,100,0.090000
2025-09-22,Carlisle Companies,34,60,6,100,0.060000
2025-09-22,Carlyle Group,31,64,5,100,0.050000
2025-09-22,Carpenter Technology,38,60,2,100,0.020000
2025-09-22,Carrier Global,32,54,14,100,0.140000
2025-09-22,Carters Inc,18,26,2,46,0.043478
2025-09-22,Carvana,38,57,5,100,0.050000
2025-09-22,Caseys General Stores,29,61,10,100,0.100000
2025-09-22,Catalent,22,71,7,100,0.070000
2025-09-22,Caterpillar,48,49,3,100,0.030000
2025-09-22,Cboe Global Markets,34,64,2,100,0.020000
2025-09-22,Celanese,32,40,28,100,0.280000
2025-09-22,Cencora,59,37,4,100,0.040000
2025-09-22,Centene,35,47,18,100,0.180000
2025-09-22,CenterPoint Energy,74,22,4,100,0.040000
2025-09-22,Central Garden & Pet,24,72,4,100,0.040000
2025-09-22,Century Communities,34,64,2,100,0.020000
2025-09-22,ChampionX,39,59,2,100,0.020000
2025-09-22,Charles River Laboratories International,29,59,12,100,0.120000
2025-09-22,Charles Schwab,42,53,5,100,0.050000
2025-09-22,Chart Industries,34,65,1,100,0.010000
2025-09-22,Charter Communications,20,59,21,100,0.210000
2025-09-22,Cheesecake Factory,28,56,16,100,0.160000
2025-09-22,Chefs Warehouse,42,52,6,100,0.060000
2025-09-22,Chemours,35,50,15,100,0.150000
2025-09-22,Cheniere Energy,92,8,0,100,0.000000
2025-09-22,Chevron,37,44,19,100,0.190000
2025-09-22,Chewy,35,51,14,100,0.140000
2025-09-22,Chipotle Mexican Grill,31,59,10,100,0.100000
2025-09-22,Chord Energy,86,13,1,100,0.010000
2025-09-22,Church & Dwight,32,61,7,100,0.070000
2025-09-22,Ciena,38,57,5,100,0.050000
2025-09-22,Cigna,50,40,10,100,0.100000
2025-09-22,Cinemark,38,52,10,100,0.100000
2025-09-22,Cintas,48,49,3,100,0.030000
2025-09-22,Cisco Systems,54,45,1,100,0.010000
2025-09-22,Citigroup,38,57,5,100,0.050000
2025-09-22,Citizens Financial Group,38,59,3,100,0.030000
2025-09-22,Civitas Resources,38,43,19,100,0.190000
2025-09-22,Clean Harbors,82,12,6,100,0.060000
2025-09-22,Clear Channel Outdoor Hldgs,8,1,1,10,0.100000
2025-09-22,Cleveland-Cliffs,28,57,15,100,0.150000
2025-09-22,Clorox,38,52,10,100,0.100000
2025-09-22,Cognizant Technology Solutions,39,53,8,100,0.080000
2025-09-22,Coherent,26,72,2,100,0.020000
2025-09-22,Coinbase Global,21,68,11,100,0.110000
2025-09-22,Colgate-Palmolive,36,55,9,100,0.090000
2025-09-22,Columbia Banking System,37,62,1,100,0.010000
2025-09-22,Columbia Sportswear,25,57,18,100,0.180000
2025-09-22,Comcast,42,43,15,100,0.150000
2025-09-22,Comerica,48,42,10,100,0.100000
2025-09-22,Comfort Systems USA,95,5,0,100,0.000000
2025-09-22,CommScope,25,72,3,100,0.030000
2025-09-22,Commercial Metals,31,60,9,100,0.090000
2025-09-22,Community Health Systems,27,59,14,100,0.140000
2025-09-22,Compass Group,35,51,14,100,0.140000
2025-09-22,Conagra Brands,40,55,5,100,0.050000
2025-09-22,Concentrix,28,65,7,100,0.070000
2025-09-22,Conduent,32,57,11,100,0.110000
2025-09-22,ConocoPhillips,42,50,8,100,0.080000
2025-09-22,Consol Energy,80,16,4,100,0.040000
2025-09-22,Consolidated Edison,38,56,6,100,0.060000
2025-09-22,Constellation Brands,21,52,27,100,0.270000
2025-09-22,Constellation Energy,80,19,1,100,0.010000
2025-09-22,Continental Resources,41,48,11,100,0.110000
2025-09-22,Cooper Cos,3,21,3,27,0.111111
2025-09-22,Cooper-Standard,30,65,5,100,0.050000
2025-09-22,Copart,45,53,2,100,0.020000
2025-09-22,Core & Main,29,57,14,100,0.140000
2025-09-22,Corebridge Financial,47,49,4,100,0.040000
2025-09-22,Cornerstone Building Brands,28,62,10,100,0.100000
2025-09-22,Corning,34,54,12,100,0.120000
2025-09-22,Corpay,32,67,1,100,0.010000
2025-09-22,Corteva,30,62,8,100,0.080000
2025-09-22,Costco,25,63,13,101,0.128713
2025-09-22,Coterra Energy,77,20,3,100,0.030000
2025-09-22,Coty,26,60,14,100,0.140000
2025-09-22,Country Financial,25,57,18,100,0.180000
2025-09-22,Coupang,35,56,9,100,0.090000
2025-09-22,Cracker Barrel Old Country Store,18,63,19,100,0.190000
2025-09-22,Crocs,23,66,11,100,0.110000
2025-09-22,CrossAmerica Partners,26,71,3,100,0.030000
2025-09-22,CrowdStrike,44,48,8,100,0.080000
2025-09-22,Crown Castle,36,61,3,100,0.030000
2025-09-22,Crown Holdings,35,59,6,100,0.060000
2025-09-22,Cullen Frost Bankers,45,51,4,100,0.040000
2025-09-22,Cummins Inc,58,39,3,100,0.030000
2025-09-22,Curtiss-Wright,48,48,4,100,0.040000
2025-09-22,DR Horton,38,57,5,100,0.050000
2025-09-22,DTE Energy,74,19,7,100,0.070000
2025-09-22,DXC Technology,24,73,3,100,0.030000
2025-09-22,DaVita,30,48,22,100,0.220000
2025-09-22,Dana Incorporated,33,58,9,100,0.090000
2025-09-22,Danaher,61,36,3,100,0.030000
2025-09-22,Darden Restaurants,28,60,12,100,0.120000
2025-09-22,Darling Ingredients,90,7,3,100,0.030000
2025-09-22,Deckers Outdoor,46,47,7,100,0.070000
2025-09-22,Deere,36,56,8,100,0.080000
2025-09-22,Delek US,43,52,5,100,0.050000
2025-09-22,Dell Technologies,32,63,2,97,0.020619
2025-09-22,Delta Air Lines,20,66,14,100,0.140000
2025-09-22,Dentsply Sirona,28,69,3,100,0.030000
2025-09-22,Designer Brands,20,68,12,100,0.120000
2025-09-22,Devon Energy,90,7,3,100,0.030000
2025-09-22,DexCom,27,63,10,100,0.100000
2025-09-22,Diamondback Energy,85,13,2,100,0.020000
2025-09-22,Dicks Sporting Goods,28,66,6,100,0.060000
2025-09-22,Diebold Nixdorf,34,66,0,100,0.000000
2025-09-22,Digital Realty Trust,87,13,0,100,0.000000
2025-09-22,Dillards,30,57,13,100,0.130000
2025-09-22,Discover Financial,37,54,9,100,0.090000
2025-09-22,DocuSign,46,46,8,100,0.080000
2025-09-22,Dollar General,16,57,27,100,0.270000
2025-09-22,Dollar Tree,37,55,8,100,0.080000
2025-09-22,Dominion Energy,75,21,4,100,0.040000
2025-09-22,Dominos Pizza Inc,16,21,2,39,0.051282
2025-09-22,Domtar,25,65,10,100,0.100000
2025-09-22,Donaldson Company,52,44,4,100,0.040000
2025-09-22,DoorDash,37,56,7,100,0.070000
2025-09-22,Dover Corporation,49,49,2,100,0.020000
2025-09-22,DraftKings,68,28,4,100,0.040000
2025-09-22,Dream Finders Homes,84,14,2,100,0.020000
2025-09-22,Dropbox,26,70,4,100,0.040000
2025-09-22,DuPont,22,65,13,100,0.130000
2025-09-22,Duke Energy,90,9,1,100,0.010000
2025-09-22,Dycom Industries,31,65,4,100,0.040000
2025-09-22,EMCOR Group,32,64,4,100,0.040000
2025-09-22,EOG Resources,50,45,5,100,0.050000
2025-09-22,EPAM Systems,42,55,3,100,0.030000
2025-09-22,EQT,32,59,9,100,0.090000
2025-09-22,ESAB,30,65,5,100,0.050000
2025-09-22,East West Bancorp,45,51,4,100,0.040000
2025-09-22,Eastman Chemical,29,51,20,100,0.200000
2025-09-22,Ebay,33,59,8,100,0.080000
2025-09-22,EchoStar,20,71,9,100,0.090000
2025-09-22,Ecolab,49,49,2,100,0.020000
2025-09-22,Edison International,29,53,18,100,0.180000
2025-09-22,Edward Jones,25,65,10,100,0.100000
2025-09-22,Edwards Lifesciences,44,41,15,100,0.150000
2025-09-22,Elanco Animal Health,35,62,3,100,0.030000
2025-09-22,Electronic Arts,30,61,9,100,0.090000
2025-09-22,Elevance Health,55,34,11,100,0.110000
2025-09-22,Eli Lilly,37,52,11,100,0.110000
2025-09-22,Emerson Electric,52,46,2,100,0.020000
2025-09-22,EnLink Midstream,42,51,7,100,0.070000
2025-09-22,Encompass Health,30,63,7,100,0.070000
2025-09-22,Endeavor Group,17,75,8,100,0.080000
2025-09-22,Endeavor Group Holdings,19,72,9,100,0.090000
2025-09-22,EnerSys,36,55,9,100,0.090000
2025-09-22,Energizer Holdings,84,15,1,100,0.010000
2025-09-22,Energy Transfer,79,17,4,100,0.040000
2025-09-22,Ensign Group,46,52,2,100,0.020000
2025-09-22,Entegris,48,47,5,100,0.050000
2025-09-22,Entergy,44,51,5,100,0.050000
2025-09-22,Enterprise Products Partners,47,42,11,100,0.110000
2025-09-22,Envista,27,64,9,100,0.090000
2025-09-22,Equifax,46,45,9,100,0.090000
2025-09-22,Equinix,41,54,5,100,0.050000
2025-09-22,Equitable Holdings,34,57,9,100,0.090000
2025-09-22,Equity Residential,35,58,7,100,0.070000
2025-09-22,Erie Insurance,31,55,14,100,0.140000
2025-09-22,Estée Lauder,35,55,10,100,0.100000
2025-09-22,Etsy,34,46,20,100,0.200000
2025-09-22,Euronet Worldwide,35,61,4,100,0.040000
2025-09-22,Evergy,44,48,8,100,0.080000
2025-09-22,Eversource Energy,73,21,6,100,0.060000
2025-09-22,Exact Sciences,27,51,22,100,0.220000
2025-09-22,Exelon,48,50,2,100,0.020000
2025-09-22,Expand Energy Corporation,97,3,0,100,0.000000
2025-09-22,Expedia,43,51,6,100,0.060000
2025-09-22,Expeditors International of Washington,31,60,9,100,0.090000
2025-09-22,Extra Space Storage,31,62,7,100,0.070000
2025-09-22,Exxon Mobil,56,42,2,100,0.020000
2025-09-22,F5,36,59,5,100,0.050000
2025-09-22,FM Global,36,45,19,100,0.190000
2025-09-22,FMC Corporation,39,54,7,100,0.070000
2025-09-22,FTI Consulting,32,55,13,100,0.130000
2025-09-22,Fannie Mae,19,71,10,100,0.100000
2025-09-22,Farmers Insurance Exchange,20,58,19,97,0.195876
2025-09-22,Fastenal,57,41,2,100,0.020000
2025-09-22,FedEx,34,55,11,100,0.110000
2025-09-22,Federated Mutual Insurance,18,22,6,46,0.130435
2025-09-22,Ferguson Enterprises,39,55,6,100,0.060000
2025-09-22,Fidelity National Financial,42,52,6,100,0.060000
2025-09-22,Fidelity National Information Services,48,40,12,100,0.120000
2025-09-22,Fifth Third Bancorp,48,40,12,100,0.120000
2025-09-22,First American Financial,32,60,8,100,0.080000
2025-09-22,First Citizens BancShares,36,61,3,100,0.030000
2025-09-22,First Horizon,39,59,2,100,0.020000
2025-09-22,First National of Nebraska,17,34,1,52,0.019231
2025-09-22,First Solar,34,60,6,100,0.060000
2025-09-22,FirstCash,35,55,10,100,0.100000
2025-09-22,FirstEnergy,36,49,15,100,0.150000
2025-09-22,Fiserv,37,60,3,100,0.030000
2025-09-22,Five Below,30,57,13,100,0.130000
2025-09-22,Flagstar Financial,28,60,12,100,0.120000
2025-09-22,Floor & Decor,35,57,8,100,0.080000
2025-09-22,Flowers Foods,18,63,19,100,0.190000
2025-09-22,Flowserve,31,66,3,100,0.030000
2025-09-22,Fluor,35,51,14,100,0.140000
2025-09-22,Foot Locker,15,67,18,100,0.180000
2025-09-22,Ford Motor,26,63,11,100,0.110000
2025-09-22,Fortinet,28,44,28,100,0.280000
2025-09-22,Fortive,35,57,8,100,0.080000
2025-09-22,Fortune Brands Innovations,27,69,4,100,0.040000
2025-09-22,Franklin Resources,41,50,9,100,0.090000
2025-09-22,Freddie Mac,19,71,10,100,0.100000
2025-09-22,Freeport-McMoRan,47,41,12,100,0.120000
2025-09-22,Frontier Airlines,34,54,12,100,0.120000
2025-09-22,Frontier Communications,41,52,7,100,0.070000
2025-09-22,G-III Apparel Group,32,59,9,100,0.090000
2025-09-22,GE HealthCare Technologies,32,64,4,100,0.040000
2025-09-22,GE Vernova,57,39,4,100,0.040000
2025-09-22,GMS,24,70,6,100,0.060000
2025-09-22,GXO Logistics,38,56,6,100,0.060000
2025-09-22,GameStop,24,63,13,100,0.130000
2025-09-22,Gannett,28,62,10,100,0.100000
2025-09-22,Garrett Motion Inc,37,61,2,100,0.020000
2025-09-22,Gartner,25,64,11,100,0.110000
2025-09-22,Gen Digital,50,47,3,100,0.030000
2025-09-22,Generac,38,56,6,100,0.060000
2025-09-22,General Dynamics,92,8,0,100,0.000000
2025-09-22,General Mills,40,58,2,100,0.020000
2025-09-22,General Motors,36,55,9,100,0.090000
2025-09-22,Genesis Energy,75,22,3,100,0.030000
2025-09-22,Genuine Parts,41,57,2,100,0.020000
2025-09-22,Genworth Financial,44,54,2,100,0.020000
2025-09-22,Gilead Sciences,45,51,4,100,0.040000
2025-09-22,Global Partners,41,49,10,100,0.100000
2025-09-22,Global Payments,40,57,3,100,0.030000
2025-09-22,Globe Life,36,56,8,100,0.080000
2025-09-22,GoDaddy,34,59,7,100,0.070000
2025-09-22,Goldman Sachs,34,60,8,102,0.078431
2025-09-22,Goodyear Tire & Rubber,26,65,9,100,0.090000
2025-09-22,Graham Holdings Company,27,69,4,100,0.040000
2025-09-22,Granite Construction,44,53,3,100,0.030000
2025-09-22,Graphic Packaging,19,66,15,100,0.150000
2025-09-22,Gray Television,24,63,13,100,0.130000
2025-09-22,Graybar Electric,15,28,5,48,0.104167
2025-09-22,Green Plains Inc,39,49,12,100,0.120000
2025-09-22,Greenbrier,26,46,28,100,0.280000
2025-09-22,Greif,21,75,4,100,0.040000
2025-09-22,Griffon Corporation,34,61,5,100,0.050000
2025-09-22,Grocery Outlet Holding,29,63,8,100,0.080000
2025-09-22,Group 1 Automotive,34,61,5,100,0.050000
2025-09-22,Guardian Life insurance,47,51,2,100,0.020000
2025-09-22,Guess Inc,35,61,4,100,0.040000
2025-09-22,GuideWell Mutual,19,21,1,41,0.024390
2025-09-22,HB Fuller,21,75,4,100,0.040000
2025-09-22,HCA Healthcare,44,52,4,100,0.040000
2025-09-22,HEICO,36,57,7,100,0.070000
2025-09-22,HF SInclair,32,58,10,100,0.100000
2025-09-22,HP,33,59,8,100,0.080000
2025-09-22,Halliburton,25,55,20,100,0.200000
2025-09-22,Hanesbrands,33,65,2,100,0.020000
2025-09-22,Hanover Insurance Group,44,48,8,100,0.080000
2025-09-22,Harley-Davidson,21,68,11,100,0.110000
2025-09-22,Hasbro,32,57,11,100,0.110000
2025-09-22,Hawaiian Airlines Inc,33,65,2,100,0.020000
2025-09-22,Hawaiian Electric Industries,30,63,7,100,0.070000
2025-09-22,Helmerich & Payne,23,62,15,100,0.150000
2025-09-22,Henry Schein,30,67,3,100,0.030000
2025-09-22,Herc Rentals,35,56,9,100,0.090000
2025-09-22,Hershey,37,58,5,100,0.050000
2025-09-22,Hertz,26,52,22,100,0.220000
2025-09-22,Hewlett Packard Enterprise,29,70,1,100,0.010000
2025-09-22,Hillenbrand,25,67,8,100,0.080000
2025-09-22,Hilton Grand Vacations,90,10,0,100,0.000000
2025-09-22,Hilton Worldwide,53,46,1,100,0.010000
2025-09-22,Hologic,31,64,5,100,0.050000
2025-09-22,Home Depot,49,44,7,100,0.070000
2025-09-22,Honeywell,34,45,21,100,0.210000
2025-09-22,Hormel Foods,27,66,7,100,0.070000
2025-09-22,Host Hotels & Resorts,25,72,3,100,0.030000
2025-09-22,Hovnanian Enterprises,33,60,7,100,0.070000
2025-09-22,Howmet Aerospace,46,49,5,100,0.050000
2025-09-22,Hub Group,25,64,11,100,0.110000
2025-09-22,Hubbell,30,58,12,100,0.120000
2025-09-22,Humana,48,41,11,100,0.110000
2025-09-22,Huntington Bancshares,35,63,2,100,0.020000
2025-09-22,Huntington Ingalls Industries,42,48,10,100,0.100000
2025-09-22,Huntsman,14,53,33,100,0.330000
2025-09-22,Hyatt Hotels,36,60,4,100,0.040000
2025-09-22,Hyster-Yale,22,72,6,100,0.060000
2025-09-22,IAC,31,61,8,100,0.080000
2025-09-22,IBM,39,53,8,100,0.080000
2025-09-22,IDEX,37,57,6,100,0.060000
2025-09-22,IDEXX Laboratories,51,46,3,100,0.030000
2025-09-22,IQVIA,55,39,6,100,0.060000
2025-09-22,ITT,45,48,7,100,0.070000
2025-09-22,Icahn Enterprises,28,56,16,100,0.160000
2025-09-22,Illinois Tool Works,48,50,2,100,0.020000
2025-09-22,Illumina Inc,36,59,5,100,0.050000
2025-09-22,Incyte,47,52,1,100,0.010000
2025-09-22,Ingersoll Rand,35,57,8,100,0.080000
2025-09-22,Ingles Markets,25,50,25,100,0.250000
2025-09-22,Ingram Micro,21,46,33,100,0.330000
2025-09-22,Ingredion,42,53,5,100,0.050000
2025-09-22,Insight Enterprises,33,58,9,100,0.090000
2025-09-22,Insperity,33,57,10,100,0.100000
2025-09-22,Instacart,28,61,11,100,0.110000
2025-09-22,Installed Building Products,26,67,7,100,0.070000
2025-09-22,Intel,25,60,14,99,0.141414
2025-09-22,Interactive Brokers,41,51,8,100,0.080000
2025-09-22,Intercontinental Exchange,42,55,3,100,0.030000
2025-09-22,International Flavors & Fragrances,23,69,8,100,0.080000
2025-09-22,International Paper,26,66,8,100,0.080000
2025-09-22,Interpublic Group,37,57,6,100,0.060000
2025-09-22,Intuit,47,52,1,100,0.010000
2025-09-22,Intuitive Surgical,40,51,9,100,0.090000
2025-09-22,Iron Mountain,21,66,13,100,0.130000
2025-09-22,JB Hunt Transport Services,21,68,11,100,0.110000
2025-09-22,JELD-WEN Holding,26,64,10,100,0.100000
2025-09-22,JM Smucker,35,59,6,100,0.060000
2025-09-22,JPMorgan Chase,49,46,5,100,0.050000
2025-09-22,Jabil,25,71,4,100,0.040000
2025-09-22,Jackson Financial,37,59,4,100,0.040000
2025-09-22,Jacobs Solutions,55,43,2,100,0.020000
2025-09-22,Jefferies Financial,42,52,6,100,0.060000
2025-09-22,JetBlue Airways,33,48,19,100,0.190000
2025-09-22,Johnson & Johnson,45,47,8,100,0.080000
2025-09-22,Jones Lang LaSalle,40,58,2,100,0.020000
2025-09-22,Juniper Networks,29,64,7,100,0.070000
2025-09-22,KB Home,43,48,9,100,0.090000
2025-09-22,KBR,56,40,4,100,0.040000
2025-09-22,KKR & Co,59,38,3,100,0.030000
2025-09-22,KLA,36,45,19,100,0.190000
2025-09-22,Kaiser Aluminum,25,67,8,100,0.080000
2025-09-22,Kellanova,42,51,7,100,0.070000
2025-09-22,Kelly Services Inc,26,66,8,100,0.080000
2025-09-22,Kemper Corporation,38,55,7,100,0.070000
2025-09-22,Kenvue,17,65,16,98,0.163265
2025-09-22,Keurig Dr Pepper,17,75,8,100,0.080000
2025-09-22,KeyCorp,37,57,6,100,0.060000
2025-09-22,Keysight Technologies,46,49,5,100,0.050000
2025-09-22,Kimberly-Clark,34,55,11,100,0.110000
2025-09-22,Kinder Morgan,95,4,1,100,0.010000
2025-09-22,Kirby Corporation,19,39,5,63,0.079365
2025-09-22,Knife River Corporation,25,51,7,83,0.084337
2025-09-22,Knight Swift Transportation,34,58,8,100,0.080000
2025-09-22,Kohl's,32,49,19,100,0.190000
2025-09-22,Kontoor Brands,33,63,4,100,0.040000
2025-09-22,Korn Ferry,57,35,8,100,0.080000
2025-09-22,Kraft Heinz,25,60,15,100,0.150000
2025-09-22,Kroger,29,49,14,92,0.152174
2025-09-22,Kyndryl,31,62,7,100,0.070000
2025-09-22,L3Harris Technologies,41,55,4,100,0.040000
2025-09-22,LCI Industries,38,57,5,100,0.050000
2025-09-22,LKQ,28,67,5,100,0.050000
2025-09-22,LPL Financial,62,37,1,100,0.010000
2025-09-22,Labcorp Holdings,43,52,5,100,0.050000
2025-09-22,Lam Research,49,49,2,100,0.020000
2025-09-22,Lamb Weston,34,56,10,100,0.100000
2025-09-22,Land O'Lakes,25,64,11,100,0.110000
2025-09-22,Landstar System,24,54,22,100,0.220000
2025-09-22,Las Vegas Sands,36,56,8,100,0.080000
2025-09-22,Lear Corporation,36,55,9,100,0.090000
2025-09-22,Leggett & Platt,22,68,10,100,0.100000
2025-09-22,Leidos,45,51,4,100,0.040000
2025-09-22,Lennar,12,70,18,100,0.180000
2025-09-22,Lennox International,37,54,9,100,0.090000
2025-09-22,Levi Strauss,21,75,4,100,0.040000
2025-09-22,Liberty Energy,93,7,0,100,0.000000
2025-09-22,Liberty Media,96,3,1,100,0.010000
2025-09-22,Liberty Mutual Insurance,78,16,6,100,0.060000
2025-09-22,Light & Wonder,23,64,13,100,0.130000
2025-09-22,Lincoln Electric,40,58,2,100,0.020000
2025-09-22,Lincoln National,31,51,18,100,0.180000
2025-09-22,Lithia Motors,41,56,3,100,0.030000
2025-09-22,Live Nation Entertainment,40,39,21,100,0.210000
2025-09-22,Lockheed Martin,31,51,11,93,0.118280
2025-09-22,Loews,41,56,3,100,0.030000
2025-09-22,Louisiana-Pacific Corporation,38,58,4,100,0.040000
2025-09-22,Lowe's,25,53,22,100,0.220000
2025-09-22,Lululemon athletica,24,50,26,100,0.260000
2025-09-22,Lumen Technologies,16,71,13,100,0.130000
2025-09-22,Lyft,15,73,12,100,0.120000
2025-09-22,M&T Bank,28,60,12,100,0.120000
2025-09-22,M/I Homes,32,62,6,100,0.060000
2025-09-22,MDU Resources Group,37,57,6,100,0.060000
2025-09-22,MGM Resorts International,32,63,5,100,0.050000
2025-09-22,MKS Instruments,43,49,8,100,0.080000
2025-09-22,MRC Global,39,58,3,100,0.030000
2025-09-22,MSC Industrial Direct,25,66,9,100,0.090000
2025-09-22,MSCI,31,64,5,100,0.050000
2025-09-22,MYR Group,30,58,12,100,0.120000
2025-09-22,Macys,22,71,7,100,0.070000
2025-09-22,ManpowerGroup,28,56,16,100,0.160000
2025-09-22,Marathon Oil,22,61,17,100,0.170000
2025-09-22,Marathon Petroleum,32,57,11,100,0.110000
2025-09-22,Markel Group,43,51,6,100,0.060000
2025-09-22,Marriott International,39,59,2,100,0.020000
2025-09-22,Marriott Vacations Worldwide,35,52,13,100,0.130000
2025-09-22,Marsh & McLennan,50,44,6,100,0.060000
2025-09-22,Martin Marietta Materials,30,55,15,100,0.150000
2025-09-22,Marvell Technology,43,50,7,100,0.070000
2025-09-22,MasTec,46,53,1,100,0.010000
2025-09-22,Masco,32,59,9,100,0.090000
2025-09-22,Mass Mutual,21,45,4,70,0.057143
2025-09-22,MasterBrand,32,65,3,100,0.030000
2025-09-22,Mastercard,46,52,2,100,0.020000
2025-09-22,Matador Resources,33,59,8,100,0.080000
2025-09-22,Match Group,25,55,20,100,0.200000
2025-09-22,Mativ,26,70,4,100,0.040000
2025-09-22,Matson Inc,34,59,7,100,0.070000
2025-09-22,Mattel,34,53,13,100,0.130000
2025-09-22,Maximus,24,69,7,100,0.070000
2025-09-22,McCormick & Company,43,49,8,100,0.080000
2025-09-22,McDonalds,23,63,14,100,0.140000
2025-09-22,McKesson,42,54,4,100,0.040000
2025-09-22,Medical Mutual of Ohio,25,64,11,100,0.110000
2025-09-22,Merck,49,43,8,100,0.080000
2025-09-22,Mercury General,26,57,17,100,0.170000
2025-09-22,Meritage Homes,25,63,12,100,0.120000
2025-09-22,MetLife,33,60,7,100,0.070000
2025-09-22,Meta Platforms,50,41,9,100,0.090000
2025-09-22,Mettler-Toledo International,39,59,2,100,0.020000
2025-09-22,Microchip Technology,43,52,5,100,0.050000
2025-09-22,Micron Technology,30,51,11,92,0.119565
2025-09-22,Microsoft,27,55,18,100,0.180000
2025-09-22,Middleby,23,74,3,100,0.030000
2025-09-22,MillerKnoll,31,63,6,100,0.060000
2025-09-22,Moderna,29,54,17,100,0.170000
2025-09-22,ModivCare,32,52,16,100,0.160000
2025-09-22,Mohawk Industries,36,58,6,100,0.060000
2025-09-22,Molina Healthcare,33,54,13,100,0.130000
2025-09-22,Molson Coors Beverage,25,57,12,94,0.127660
2025-09-22,Mondelez,34,53,13,100,0.130000
2025-09-22,Monster Beverage,45,50,5,100,0.050000
2025-09-22,Moodys Corporation,4,16,3,23,0.130435
2025-09-22,Moog Inc,36,59,5,100,0.050000
2025-09-22,Morgan Stanley,28,61,13,102,0.127451
2025-09-22,Motorola Solutions,50,47,3,100,0.030000
2025-09-22,Mueller Industries,44,50,6,100,0.060000
2025-09-22,Murphy Oil,27,70,3,100,0.030000
2025-09-22,Murphy USA,31,61,8,100,0.080000
2025-09-22,Mutual of Omaha,48,47,5,100,0.050000
2025-09-22,NCR Atleos,38,59,3,100,0.030000
2025-09-22,NCR Voyix,30,61,9,100,0.090000
2025-09-22,NGL Energy Partners,84,13,3,100,0.030000
2025-09-22,NLV Financial,2,7,1,10,0.100000
2025-09-22,NOV,26,64,10,100,0.100000
2025-09-22,NRG Energy,89,8,3,100,0.030000
2025-09-22,NVR Inc,39,54,7,100,0.070000
2025-09-22,Nasdaq Inc,43,56,1,100,0.010000
2025-09-22,Nationwide Insurance,21,60,19,100,0.190000
2025-09-22,Navient,38,46,16,100,0.160000
2025-09-22,NetApp,42,55,3,100,0.030000
2025-09-22,Netflix,26,57,23,106,0.216981
2025-09-22,NeueHealth,57,41,2,100,0.020000
2025-09-22,New York Life Insurance,37,56,7,100,0.070000
2025-09-22,NewMarket Corporation,29,45,4,78,0.051282
2025-09-22,Newell Brands,28,63,9,100,0.090000
2025-09-22,Newmont,38,57,5,100,0.050000
2025-09-22,News Corp,22,68,10,100,0.100000
2025-09-22,Nexstar Media Group,31,65,4,100,0.040000
2025-09-22,NextEra Energy,97,3,0,100,0.000000
2025-09-22,NiSource,43,49,8,100,0.080000
2025-09-22,Nike,28,60,12,100,0.120000
2025-09-22,Nordson,41,57,2,100,0.020000
2025-09-22,Nordstrom,28,61,11,100,0.110000
2025-09-22,Norfolk Southern,37,55,8,100,0.080000
2025-09-22,Northern Trust,92,8,0,100,0.000000
2025-09-22,Northrop Grumman,27,67,6,100,0.060000
2025-09-22,Northwestern Mutual,33,51,16,100,0.160000
2025-09-22,Nucor,37,48,15,100,0.150000
2025-09-22,Nvidia,21,75,6,102,0.058824
2025-09-22,O'Reilly Automotive,68,29,3,100,0.030000
2025-09-22,O-I Glass,39,51,10,100,0.100000
2025-09-22,ODP Business Solutions,17,48,2,67,0.029851
2025-09-22,OGE Energy,89,10,1,100,0.010000
2025-09-22,ON Semiconductor,27,62,11,100,0.110000
2025-09-22,Occidental Petroleum,37,52,11,100,0.110000
2025-09-22,Old Dominion Freight Line,38,48,14,100,0.140000
2025-09-22,Old National Bancorp,39,60,1,100,0.010000
2025-09-22,Old Republic International,55,43,2,100,0.020000
2025-09-22,Olin,27,53,20,100,0.200000
2025-09-22,Omnicom Group,36,54,10,100,0.100000
2025-09-22,OneMain,48,49,3,100,0.030000
2025-09-22,Oneok,47,50,3,100,0.030000
2025-09-22,Opendoor Technologies,21,49,30,100,0.300000
2025-09-22,Option Care Health,93,7,0,100,0.000000
2025-09-22,Oracle,23,73,3,99,0.030303
2025-09-22,Organon,31,54,15,100,0.150000
2025-09-22,Oscar Health,33,56,11,100,0.110000
2025-09-22,Oshkosh Corporation,40,52,8,100,0.080000
2025-09-22,Otis Worldwide,42,52,6,100,0.060000
2025-09-22,Ovintiv,51,42,7,100,0.070000
2025-09-22,Owens & Minor,28,55,17,100,0.170000
2025-09-22,Owens Corning,24,73,3,100,0.030000
2025-09-22,PACS Group,30,44,15,89,0.168539
2025-09-22,PBF Energy,80,18,2,100,0.020000
2025-09-22,PC Connection Inc,45,40,4,89,0.044944
2025-09-22,PENN Entertainment,83,16,1,100,0.010000
2025-09-22,PG&E,44,39,17,100,0.170000
2025-09-22,PNC Financial Services,49,48,3,100,0.030000
2025-09-22,PPG Industries,43,53,4,100,0.040000
2025-09-22,PPL Corporation,43,54,3,100,0.030000
2025-09-22,PVH,30,57,13,100,0.130000
2025-09-22,Paccar,41,50,9,100,0.090000
2025-09-22,Pacific Life,38,59,3,100,0.030000
2025-09-22,Packaging Corp of America,16,74,10,100,0.100000
2025-09-22,Palo Alto Networks,35,50,15,100,0.150000
2025-09-22,Par Pacific,36,59,5,100,0.050000
2025-09-22,Paramount Global,25,64,11,100,0.110000
2025-09-22,Park Hotels & Resorts,25,67,8,100,0.080000
2025-09-22,Parker-Hannifin,57,43,0,100,0.000000
2025-09-22,Parsons Corporation,44,51,5,100,0.050000
2025-09-22,Patrick Industries,39,57,4,100,0.040000
2025-09-22,Patterson Companies Inc,13,59,1,73,0.013699
2025-09-22,Patterson-UTI Energy,62,31,7,100,0.070000
2025-09-22,PayPal,37,58,5,100,0.050000
2025-09-22,Paychex,48,46,6,100,0.060000
2025-09-22,Peabody Energy,72,23,5,100,0.050000
2025-09-22,Peloton Interactive,38,57,5,100,0.050000
2025-09-22,Penn Mutual Life Insurance,35,60,5,100,0.050000
2025-09-22,PennyMac Financial Services,29,68,3,100,0.030000
2025-09-22,Penske Automotive,30,66,4,100,0.040000
2025-09-22,PepsiCo,40,56,4,100,0.040000
2025-09-22,Performance Food,40,56,4,100,0.040000
2025-09-22,Permian Resources,39,59,2,100,0.020000
2025-09-22,Petco Health and Wellness,76,21,3,100,0.030000
2025-09-22,Peter Kiewit Sons',7,23,13,43,0.302326
2025-09-22,Pfizer,14,72,6,92,0.065217
2025-09-22,Philip Morris International,51,47,2,100,0.020000
2025-09-22,Phillips 66,39,53,8,100,0.080000
2025-09-22,Pinnacle West Capital,42,45,13,100,0.130000
2025-09-22,Pinterest,35,61,4,100,0.040000
2025-09-22,Pioneer Natural Resources,46,36,18,100,0.180000
2025-09-22,Pitney Bowes,36,63,1,100,0.010000
2025-09-22,Plains GP,34,51,15,100,0.150000
2025-09-22,Playtika Holding,26,60,14,100,0.140000
2025-09-22,Plexus Corp,36,61,3,100,0.030000
2025-09-22,Polaris Inc,46,50,4,100,0.040000
2025-09-22,Pool Corporation,40,53,7,100,0.070000
2025-09-22,Popular Inc,96,3,1,100,0.010000
2025-09-22,Portland General Electric,34,58,8,100,0.080000
2025-09-22,Post Holdings,23,70,7,100,0.070000
2025-09-22,PrIncipal Financial,40,56,4,100,0.040000
2025-09-22,PriceSmart,35,62,3,100,0.030000
2025-09-22,Primerica,39,55,6,100,0.060000
2025-09-22,Primoris Services,42,56,2,100,0.020000
2025-09-22,ProFrac Holding,27,61,12,100,0.120000
2025-09-22,Procter & Gamble,43,46,11,100,0.110000
2025-09-22,Progressive Insurance,32,57,11,100,0.110000
2025-09-22,Prologis,39,57,4,100,0.040000
2025-09-22,Prudential Financial,38,58,4,100,0.040000
2025-09-22,Public Service Enterprise Group,44,53,3,100,0.030000
2025-09-22,Public Storage,35,51,14,100,0.140000
2025-09-22,Publix Super Markets,41,56,3,100,0.030000
2025-09-22,Puget Sound Energy,57,30,13,100,0.130000
2025-09-22,PulteGroup,33,61,6,100,0.060000
2025-09-22,Pure Storage,29,65,6,100,0.060000
2025-09-22,QVC Group,25,57,12,94,0.127660
2025-09-22,QXO Building Products,0,8,2,10,0.200000
2025-09-22,Qorvo,43,49,8,100,0.080000
2025-09-22,Qualcomm,50,47,3,100,0.030000
2025-09-22,Quanta Services,55,41,4,100,0.040000
2025-09-22,Quest Diagnostics,27,64,9,100,0.090000
2025-09-22,QuidelOrtho,36,57,7,100,0.070000
2025-09-22,REV Group,50,45,5,100,0.050000
2025-09-22,RPM International,28,66,6,100,0.060000
2025-09-22,RTX,35,56,9,100,0.090000
2025-09-22,RXO Inc,36,56,8,100,0.080000
2025-09-22,Rackspace Technology,29,61,10,100,0.100000
2025-09-22,Radius Recycling,16,60,24,100,0.240000
2025-09-22,Ralph Lauren,32,64,4,100,0.040000
2025-09-22,Range Resources,40,55,5,100,0.050000
2025-09-22,Raymond James Financial,34,62,4,100,0.040000
2025-09-22,Realty Income,40,46,14,100,0.140000
2025-09-22,Regal Rexnord,32,61,7,100,0.070000
2025-09-22,Regeneron Pharmaceuticals,50,43,7,100,0.070000
2025-09-22,Regions Financial,41,55,4,100,0.040000
2025-09-22,Reinsurance Group of America,45,52,3,100,0.030000
2025-09-22,Reliance Inc,51,44,5,100,0.050000
2025-09-22,Republic Services,38,43,19,100,0.190000
2025-09-22,ResMed,28,68,4,100,0.040000
2025-09-22,Resideo Technologies,42,53,5,100,0.050000
2025-09-22,Restoration Hardware,26,63,11,100,0.110000
2025-09-22,Revvity,28,60,12,100,0.120000
2025-09-22,Rithm Capital,18,78,4,100,0.040000
2025-09-22,Rivian Automotive,30,61,9,100,0.090000
2025-09-22,Robert Half,36,53,11,100,0.110000
2025-09-22,Roblox,24,54,22,100,0.220000
2025-09-22,Rocket Companies,19,76,5,100,0.050000
2025-09-22,Rockwell Automation,34,64,2,100,0.020000
2025-09-22,Roku,55,40,5,100,0.050000
2025-09-22,Rollins Inc,36,61,3,100,0.030000
2025-09-22,Roper Technologies,37,59,4,100,0.040000
2025-09-22,Ross Stores,37,56,7,100,0.070000
2025-09-22,Rush Enterprises,34,56,10,100,0.100000
2025-09-22,Ryder System,47,51,2,100,0.020000
2025-09-22,Ryerson Holding,16,78,6,100,0.060000
2025-09-22,S&P Global,22,72,6,100,0.060000
2025-09-22,SBA Communications,43,47,10,100,0.100000
2025-09-22,SS&C Technologies,43,55,2,100,0.020000
2025-09-22,Sabre Corporation,31,62,7,100,0.070000
2025-09-22,Saia Inc,43,53,4,100,0.040000
2025-09-22,Salesforce,28,42,30,100,0.300000
2025-09-22,Sallie Mae,35,58,7,100,0.070000
2025-09-22,Sally Beauty,95,5,0,100,0.000000
2025-09-22,Sanmina,32,64,4,100,0.040000
2025-09-22,ScanSource,46,52,2,100,0.020000
2025-09-22,Schneider National,29,65,6,100,0.060000
2025-09-22,Science Applications International,32,58,10,100,0.100000
2025-09-22,Scotts Miracle-Gro,41,50,9,100,0.090000
2025-09-22,Seaboard,30,58,12,100,0.120000
2025-09-22,Sealed Air Corporation,32,61,7,100,0.070000
2025-09-22,Securian Financial,29,64,7,100,0.070000
2025-09-22,Select Medical Holdings,31,63,6,100,0.060000
2025-09-22,Selective Insurance Group,33,54,13,100,0.130000
2025-09-22,Sempra,52,46,2,100,0.020000
2025-09-22,Sentry Insurance Group,4,6,0,10,0.000000
2025-09-22,Service Corp International,4,13,4,21,0.190476
2025-09-22,ServiceNow,50,47,3,100,0.030000
2025-09-22,Sherwin-Williams,23,64,13,100,0.130000
2025-09-22,Shift4 Payments,24,69,7,100,0.070000
2025-09-22,Silgan,21,61,18,100,0.180000
2025-09-22,Simon Property Group,43,51,6,100,0.060000
2025-09-22,Sinclair,32,55,13,100,0.130000
2025-09-22,Sirius XM,29,65,6,100,0.060000
2025-09-22,SiteOne Landscape Supply,30,67,3,100,0.030000
2025-09-22,Skechers USA,24,72,4,100,0.040000
2025-09-22,SkyWest,18,57,25,100,0.250000
2025-09-22,Skyline Champion,39,10,1,50,0.020000
2025-09-22,Skyworks Solutions,40,56,4,100,0.040000
2025-09-22,Smurfit Westrock,28,59,13,100,0.130000
2025-09-22,Snap Inc,31,57,14,102,0.137255
2025-09-22,Snap-on,24,68,8,100,0.080000
2025-09-22,Snowflake Inc,50,50,0,100,0.000000
2025-09-22,Solventum,39,56,5,100,0.050000
2025-09-22,Sonic Automotive,21,76,3,100,0.030000
2025-09-22,Sonoco Products,29,61,10,100,0.100000
2025-09-22,Southern Company,52,47,1,100,0.010000
2025-09-22,Southwest Airlines,25,64,11,100,0.110000
2025-09-22,Southwest Gas Holdings,38,57,5,100,0.050000
2025-09-22,SpartanNash,22,76,2,100,0.020000
2025-09-22,Spectrum Brands,26,63,11,100,0.110000
2025-09-22,Spire Inc,53,44,3,100,0.030000
2025-09-22,Spirit AeroSystems,36,54,10,100,0.100000
2025-09-22,Spirit Airlines,12,73,7,92,0.076087
2025-09-22,Splunk,39,50,11,100,0.110000
2025-09-22,Sprouts Farmers Market,27,70,3,100,0.030000
2025-09-22,Stagwell,29,61,10,100,0.100000
2025-09-22,Stanley Black & Decker,22,69,9,100,0.090000
2025-09-22,Starbucks,26,57,10,93,0.107527
2025-09-22,State Farm Insurance,18,60,22,100,0.220000
2025-09-22,State Street,29,58,13,100,0.130000
2025-09-22,Steel Dynamics,87,11,2,100,0.020000
2025-09-22,Steelcase,35,63,2,100,0.020000
2025-09-22,Stericycle,12,38,50,100,0.500000
2025-09-22,Stifel Financial,38,57,5,100,0.050000
2025-09-22,StoneX Group,35,63,2,100,0.020000
2025-09-22,Stryker,40,53,7,100,0.070000
2025-09-22,Summit Materials,22,71,7,100,0.070000
2025-09-22,Sun Communities,42,45,13,100,0.130000
2025-09-22,Super Micro Computer,87,10,3,100,0.030000
2025-09-22,Surgery Partners,30,56,14,100,0.140000
2025-09-22,Sylvamo,26,59,15,100,0.150000
2025-09-22,Synchrony Financial,57,39,4,100,0.040000
2025-09-22,Synopsys,32,54,14,100,0.140000
2025-09-22,Synovus Financial,35,61,4,100,0.040000
2025-09-22,Sysco,50,46,4,100,0.040000
2025-09-22,T Rowe Price,50,49,1,100,0.010000
2025-09-22,TD Synnex,53,45,2,100,0.020000
2025-09-22,TEGNA,26,67,7,100,0.070000
2025-09-22,THOR Industries,25,66,9,100,0.090000
2025-09-22,TIAA,23,70,7,100,0.070000
2025-09-22,TJX,57,37,6,100,0.060000
2025-09-22,Take-Two Interactive Software,37,59,4,100,0.040000
2025-09-22,Talen Energy,90,9,1,100,0.010000
2025-09-22,Tapestry,27,61,12,100,0.120000
2025-09-22,Targa Resources,46,49,5,100,0.050000
2025-09-22,Target Corporation,27,65,8,100,0.080000
2025-09-22,Taylor Morrison Home,36,58,6,100,0.060000
2025-09-22,Teladoc Health,34,54,12,100,0.120000
2025-09-22,Teledyne Technologies,34,65,1,100,0.010000
2025-09-22,Teleflex,27,68,5,100,0.050000
2025-09-22,Telephone & Data Systems,11,24,0,35,0.000000
2025-09-22,TelevisaUnivision,31,62,7,100,0.070000
2025-09-22,Tempur Sealy International,27,62,11,100,0.110000
2025-09-22,Tenet Healthcare,39,53,8,100,0.080000
2025-09-22,Teradyne,44,52,4,100,0.040000
2025-09-22,Terex,23,72,5,100,0.050000
2025-09-22,Tesla,23,57,24,104,0.230769
2025-09-22,Tetra Tech,46,48,6,100,0.060000
2025-09-22,Texas Instruments,34,60,6,100,0.060000
2025-09-22,Texas Roadhouse,39,53,8,100,0.080000
2025-09-22,Textron,23,72,5,100,0.050000
2025-09-22,The Andersons Inc,35,63,2,100,0.020000
2025-09-22,The Coca-Cola Company,29,62,9,100,0.090000
2025-09-22,The Hartford,31,46,23,100,0.230000
2025-09-22,The Mosaic Company,33,61,6,100,0.060000
2025-09-22,Thermo Fisher Scientific,49,48,3,100,0.030000
2025-09-22,Thrivent Financial for Lutherans,30,58,2,90,0.022222
2025-09-22,Timken,25,67,8,100,0.080000
2025-09-22,Titan Machinery,21,68,11,100,0.110000
2025-09-22,Toast Inc,45,49,6,100,0.060000
2025-09-22,Toll Brothers,29,70,1,100,0.010000
2025-09-22,TopBuild,33,67,0,100,0.000000
2025-09-22,Topgolf Callaway Brands,27,60,13,100,0.130000
2025-09-22,Toro Company,32,61,7,100,0.070000
2025-09-22,Tractor Supply,22,75,3,100,0.030000
2025-09-22,TransDigm,40,52,8,100,0.080000
2025-09-22,TransUnion,36,54,10,100,0.100000
2025-09-22,Travelers Insurance,36,42,22,100,0.220000
2025-09-22,TreeHouse Foods,20,61,19,100,0.190000
2025-09-22,Tri Pointe Homes,29,68,3,100,0.030000
2025-09-22,TriNet Group,27,68,5,100,0.050000
2025-09-22,Trimble Inc,36,62,2,100,0.020000
2025-09-22,Trinity Industries,30,56,14,100,0.140000
2025-09-22,TruStage,51,42,7,100,0.070000
2025-09-22,Truist Financial,41,52,7,100,0.070000
2025-09-22,Tutor Perini Corporation,54,42,4,100,0.040000
2025-09-22,Twilio,36,57,7,100,0.070000
2025-09-22,Tyson Foods,30,55,15,100,0.150000
2025-09-22,U-Haul,9,45,46,100,0.460000
2025-09-22,UFP Industries,28,68,4,100,0.040000
2025-09-22,UGI Utilities Inc,27,39,16,82,0.195122
2025-09-22,UL Solutions,42,57,1,100,0.010000
2025-09-22,UPS,34,51,15,100,0.150000
2025-09-22,US Bancorp,34,58,8,100,0.080000
2025-09-22,US Foods,48,48,4,100,0.040000
2025-09-22,USAA,30,56,14,100,0.140000
2025-09-22,Uber,28,63,9,100,0.090000
2025-09-22,Ulta Beauty,83,14,3,100,0.030000
2025-09-22,Under Armour,28,63,9,100,0.090000
2025-09-22,Union Pacific,39,50,3,92,0.032609
2025-09-22,United Airlines,74,22,4,100,0.040000
2025-09-22,United Natural Foods,82,15,3,100,0.030000
2025-09-22,United Rentals,96,4,0,100,0.000000
2025-09-22,United States Steel,45,48,7,100,0.070000
2025-09-22,UnitedHealth,46,45,9,100,0.090000
2025-09-22,Universal Corporation,38,54,8,100,0.080000
2025-09-22,Universal Health Services,31,58,11,100,0.110000
2025-09-22,Unum Group,38,54,8,100,0.080000
2025-09-22,Upbound Group,41,58,1,100,0.010000
2025-09-22,Urban Outfitters,37,61,2,100,0.020000
2025-09-22,V2X,47,50,3,100,0.030000
2025-09-22,VF Corporation,25,58,17,100,0.170000
2025-09-22,VICI Properties,39,60,1,100,0.010000
2025-09-22,Vail Resorts,25,55,20,100,0.200000
2025-09-22,Valero Energy,87,12,1,100,0.010000
2025-09-22,Valley National Bancorp,30,65,5,100,0.050000
2025-09-22,Valmont Industries,44,50,6,100,0.060000
2025-09-22,Valvoline Inc,32,63,5,100,0.050000
2025-09-22,Ventas Inc,53,47,0,100,0.000000
2025-09-22,Verisk Analytics,37,51,12,100,0.120000
2025-09-22,Verizon,48,44,8,100,0.080000
2025-09-22,Vertex Pharmaceuticals,48,39,13,100,0.130000
2025-09-22,Vertiv,61,39,0,100,0.000000
2025-09-22,Viasat,37,54,9,100,0.090000
2025-09-22,Viatris,30,56,14,100,0.140000
2025-09-22,Victorias Secret,26,57,17,100,0.170000
2025-09-22,Visa Inc,60,33,7,100,0.070000
2025-09-22,Vishay Intertechnology,35,56,9,100,0.090000
2025-09-22,Vista Outdoor,20,62,18,100,0.180000
2025-09-22,Visteon,43,56,1,100,0.010000
2025-09-22,Vistra,46,46,8,100,0.080000
2025-09-22,Vontier,42,53,5,100,0.050000
2025-09-22,Voya Financial,40,57,3,100,0.030000
2025-09-22,Vulcan Materials,31,57,12,100,0.120000
2025-09-22,WEC Energy,89,10,1,100,0.010000
2025-09-22,WESCO International,40,56,4,100,0.040000
2025-09-22,WEX,41,55,4,100,0.040000
2025-09-22,WR Berkley,42,50,8,100,0.080000
2025-09-22,WW Grainger,48,44,8,100,0.080000
2025-09-22,Wabash National,18,56,26,100,0.260000
2025-09-22,Walmart,35,43,23,101,0.227723
2025-09-22,Walt Disney,29,55,8,92,0.086957
2025-09-22,Warner Bros Discovery,20,72,8,100,0.080000
2025-09-22,Warner Music Group,23,69,8,100,0.080000
2025-09-22,Waters Corporation,43,53,4,100,0.040000
2025-09-22,Watsco,31,60,9,100,0.090000
2025-09-22,Wayfair,34,63,3,100,0.030000
2025-09-22,Webster Financial,29,62,9,100,0.090000
2025-09-22,Weis Markets,23,64,13,100,0.130000
2025-09-22,Wells Fargo,76,16,8,100,0.080000
2025-09-22,Welltower,68,31,1,100,0.010000
2025-09-22,Werner Enterprises,34,53,13,100,0.130000
2025-09-22,West Pharmaceutical Services,42,48,10,100,0.100000
2025-09-22,Western & Southern Financial,28,70,2,100,0.020000
2025-09-22,Western Alliance Bancorp,19,53,19,91,0.208791
2025-09-22,Western Digital,28,68,4,100,0.040000
2025-09-22,Western Midstream Partners,34,61,5,100,0.050000
2025-09-22,Western Union,22,70,8,100,0.080000
2025-09-22,Westinghouse Air Brake Technologies,29,65,6,100,0.060000
2025-09-22,Weyerhaeuser,35,58,7,100,0.070000
2025-09-22,Whirlpool,28,56,16,100,0.160000
2025-09-22,Williams Companies,49,44,7,100,0.070000
2025-09-22,Williams-Sonoma,36,61,3,100,0.030000
2025-09-22,Winnebago Industries,26,60,14,100,0.140000
2025-09-22,Wintrust Financial,36,63,1,100,0.010000
2025-09-22,Woodward Inc,32,66,2,100,0.020000
2025-09-22,Workday,27,64,9,100,0.090000
2025-09-22,World Kinect,29,66,5,100,0.050000
2025-09-22,Worthington Enterprises,38,58,4,100,0.040000
2025-09-22,Wynn Resorts,28,62,10,100,0.100000
2025-09-22,XPO,29,62,9,100,0.090000
2025-09-22,Xcel Energy,82,15,3,100,0.030000
2025-09-22,Xerox,20,68,12,100,0.120000
2025-09-22,Xylem Inc,47,49,4,100,0.040000
2025-09-22,Yum Brands,35,58,7,100,0.070000
2025-09-22,Yum China,41,53,6,100,0.060000
2025-09-22,Zebra Technologies,37,59,4,100,0.040000
2025-09-22,Zimmer Biomet,24,72,4,100,0.040000
2025-09-22,Zions Bancorp,41,49,10,100,0.100000
2025-09-22,Zoetis,55,43,2,100,0.020000
2025-09-22,Zoom Video Communications,30,55,15,100,0.150000
2025-09-22,eXp World,30,65,5,100,0.050000
2025-09-22,iHeartMedia,28,66,6,100,0.060000
2025-09-23,3M,34,60,6,100,0.060000
2025-09-23,A O Smith,25,73,2,100,0.020000
2025-09-23,A-Mark Precious Metals,89,11,0,100,0.000000
2025-09-23,ABM Industries,22,63,15,100,0.150000
2025-09-23,ADT,42,40,18,100,0.180000
2025-09-23,AECOM,44,51,5,100,0.050000
2025-09-23,AES,40,50,10,100,0.100000
2025-09-23,AGCO,34,55,11,100,0.110000
2025-09-23,AGNC Investment,33,50,17,100,0.170000
2025-09-23,AIG,28,63,9,100,0.090000
2025-09-23,AMC Entertainment,82,13,5,100,0.050000
2025-09-23,AMC Networks,30,56,14,100,0.140000
2025-09-23,AMN Healthcare Services,19,66,15,100,0.150000
2025-09-23,APA,34,55,11,100,0.110000
2025-09-23,APi Group,37,56,7,100,0.070000
2025-09-23,ARKO,25,70,5,100,0.050000
2025-09-23,ASGN,24,67,9,100,0.090000
2025-09-23,AT&T,24,66,10,100,0.100000
2025-09-23,ATI Inc,39,57,4,100,0.040000
2025-09-23,AbbVie,41,54,5,100,0.050000
2025-09-23,Abbott Laboratories,62,33,5,100,0.050000
2025-09-23,Abercrombie & Fitch,37,59,4,100,0.040000
2025-09-23,Academy Sports and Outdoors,28,64,8,100,0.080000
2025-09-23,Acadia Healthcare,21,61,18,100,0.180000
2025-09-23,Ace Hardware,30,58,12,100,0.120000
2025-09-23,Acuity Inc,41,45,6,92,0.065217
2025-09-23,Adams Resources & Energy,17,6,1,24,0.041667
2025-09-23,AdaptHealth,34,57,9,100,0.090000
2025-09-23,Adobe,47,41,12,100,0.120000
2025-09-23,Advance Auto Parts,22,63,15,100,0.150000
2025-09-23,Advanced Drainage Systems,78,20,2,100,0.020000
2025-09-23,Advanced Micro Devices,75,25,0,100,0.000000
2025-09-23,Advantage Solutions,74,24,2,100,0.020000
2025-09-23,Aflac,30,48,22,100,0.220000
2025-09-23,Agilent Technologies,49,47,4,100,0.040000
2025-09-23,Agilon Health,24,64,12,100,0.120000
2025-09-23,Air Lease,26,70,4,100,0.040000
2025-09-23,Air Products & Chemicals,21,71,8,100,0.080000
2025-09-23,Airbnb,32,62,6,100,0.060000
2025-09-23,Akamai Technologies,49,45,6,100,0.060000
2025-09-23,Alaska Air,37,62,3,102,0.029412
2025-09-23,Albemarle Corporation,36,57,7,100,0.070000
2025-09-23,Albertsons,33,58,9,100,0.090000
2025-09-23,Alcoa Corporation,19,64,17,100,0.170000
2025-09-23,Alexandria Real Estate Equities,42,53,5,100,0.050000
2025-09-23,Alight Solutions,31,67,2,100,0.020000
2025-09-23,Align Technology,15,73,12,100,0.120000
2025-09-23,Allegiant Travel Company,20,71,9,100,0.090000
2025-09-23,Alliance Resource Partners,32,59,9,100,0.090000
2025-09-23,Alliant Energy,82,17,1,100,0.010000
2025-09-23,Allison Transmission,31,58,11,100,0.110000
2025-09-23,Allstate,61,26,13,100,0.130000
2025-09-23,Ally Financial,37,61,2,100,0.020000
2025-09-23,Alpha Metallurgical Resources,32,56,12,100,0.120000
2025-09-23,Alphabet,31,55,14,100,0.140000
2025-09-23,Altice USA,27,62,11,100,0.110000
2025-09-23,Altria,60,37,3,100,0.030000
2025-09-23,Amazon,42,50,10,102,0.098039
2025-09-23,Ameren,38,49,13,100,0.130000
2025-09-23,American Airlines,30,46,24,100,0.240000
2025-09-23,American Axle & Manufacturing,28,60,12,100,0.120000
2025-09-23,American Eagle Outfitters,29,59,12,100,0.120000
2025-09-23,American Electric Power,44,50,6,100,0.060000
2025-09-23,American Express,43,55,2,100,0.020000
2025-09-23,American Family Insurance,44,50,6,100,0.060000
2025-09-23,American Financial Group,31,60,9,100,0.090000
2025-09-23,American Tower,50,43,7,100,0.070000
2025-09-23,American Water Works,42,54,4,100,0.040000
2025-09-23,Americold Realty Trust,70,26,4,100,0.040000
2025-09-23,Ameriprise Financial,41,50,9,100,0.090000
2025-09-23,Ametek,40,57,3,100,0.030000
2025-09-23,Amgen,49,42,9,100,0.090000
2025-09-23,Amica Mutual Insurance,23,63,3,89,0.033708
2025-09-23,Amkor Technology,37,59,4,100,0.040000
2025-09-23,Amphenol,37,61,2,100,0.020000
2025-09-23,Analog Devices,38,56,6,100,0.060000
2025-09-23,Antero Resources,37,62,1,100,0.010000
2025-09-23,Anywhere Real Estate Inc,37,48,7,92,0.076087
2025-09-23,Apollo Global Management,35,60,5,100,0.050000
2025-09-23,AppLovin,36,57,7,100,0.070000
2025-09-23,Apple,33,55,14,102,0.137255
2025-09-23,Applied Industrial Technologies,27,71,2,100,0.020000
2025-09-23,Applied Materials,17,59,24,100,0.240000
2025-09-23,AptarGroup,28,69,3,100,0.030000
2025-09-23,Aramark,44,53,3,100,0.030000
2025-09-23,ArcBest,25,71,4,100,0.040000
2025-09-23,Arch Resources,60,30,10,100,0.100000
2025-09-23,Archer Daniels Midland,43,49,8,100,0.080000
2025-09-23,Ares Management,43,57,0,100,0.000000
2025-09-23,Arista Networks,41,54,5,100,0.050000
2025-09-23,Arrow Electronics,28,66,6,100,0.060000
2025-09-23,Arthur J Gallagher,37,61,2,100,0.020000
2025-09-23,Asbury Automotive Group,30,61,9,100,0.090000
2025-09-23,Assurant,46,46,8,100,0.080000
2025-09-23,Atkore,23,68,9,100,0.090000
2025-09-23,Atlassian,21,48,31,100,0.310000
2025-09-23,Atmos Energy,89,9,2,100,0.020000
2025-09-23,Auto-Owners Insurance,33,60,7,100,0.070000
2025-09-23,AutoNation,29,59,12,100,0.120000
2025-09-23,AutoZone,28,63,9,100,0.090000
2025-09-23,Autodesk,29,69,2,100,0.020000
2025-09-23,Autoliv,46,49,5,100,0.050000
2025-09-23,Automatic Data Processing,44,51,5,100,0.050000
2025-09-23,AvalonBay Communities,34,59,7,100,0.070000
2025-09-23,Avantor,30,59,11,100,0.110000
2025-09-23,Avery Dennison,30,67,3,100,0.030000
2025-09-23,Avient,29,61,10,100,0.100000
2025-09-23,Avis Budget,15,68,17,100,0.170000
2025-09-23,Avnet,25,69,6,100,0.060000
2025-09-23,BJ's Wholesale Club,28,61,11,100,0.110000
2025-09-23,BOK Financial,41,48,11,100,0.110000
2025-09-23,BWX Technologies,59,41,0,100,0.000000
2025-09-23,Baker Hughes,44,55,1,100,0.010000
2025-09-23,Ball Corporation,35,61,4,100,0.040000
2025-09-23,Bank of America,27,66,7,100,0.070000
2025-09-23,Bath & Body Works,39,51,10,100,0.100000
2025-09-23,Baxter International,27,66,7,100,0.070000
2025-09-23,Becton Dickinson,52,43,5,100,0.050000
2025-09-23,Belden,30,58,12,100,0.120000
2025-09-23,Benchmark Electronics,26,70,4,100,0.040000
2025-09-23,Berkshire Hathaway,21,65,14,100,0.140000
2025-09-23,Berry Global,24,65,11,100,0.110000
2025-09-23,Best Buy,94,4,2,100,0.020000
2025-09-23,Bio-Rad Laboratories,23,69,8,100,0.080000
2025-09-23,Biogen,33,63,4,100,0.040000
2025-09-23,BlackRock,35,58,7,100,0.070000
2025-09-23,Blackstone,41,53,6,100,0.060000
2025-09-23,Bloomin Brands,12,74,14,100,0.140000
2025-09-23,BlueLinx,23,72,5,100,0.050000
2025-09-23,Boeing,25,66,13,104,0.125000
2025-09-23,Boise Cascade,16,72,12,100,0.120000
2025-09-23,Booking Holdings,44,46,10,100,0.100000
2025-09-23,Booz Allen Hamilton,26,61,13,100,0.130000
2025-09-23,BorgWarner,60,34,6,100,0.060000
2025-09-23,Boston Properties,20,76,4,100,0.040000
2025-09-23,Boston Scientific,50,44,6,100,0.060000
2025-09-23,Boyd Gaming,40,58,2,100,0.020000
2025-09-23,Bread Financial,52,46,2,100,0.020000
2025-09-23,BrightSpring Health Services,35,57,8,100,0.080000
2025-09-23,BrightView Holdings,34,62,4,100,0.040000
2025-09-23,Brighthouse Financial,34,62,4,100,0.040000
2025-09-23,Brinker International,52,47,1,100,0.010000
2025-09-23,Brinks Company,16,5,3,24,0.125000
2025-09-23,Bristol-Myers Squibb,29,62,9,100,0.090000
2025-09-23,Broadcom,38,56,6,100,0.060000
2025-09-23,Broadridge Financial Solutions,59,40,1,100,0.010000
2025-09-23,Brookdale Senior Living,31,61,8,100,0.080000
2025-09-23,Brown & Brown,30,57,13,100,0.130000
2025-09-23,Brown-Forman,13,74,13,100,0.130000
2025-09-23,Bruker,25,62,13,100,0.130000
2025-09-23,Brunswick Corporation,44,44,12,100,0.120000
2025-09-23,Builders FirstSource,41,51,8,100,0.080000
2025-09-23,Burlington Stores,35,63,2,100,0.020000
2025-09-23,CACI International,53,44,3,100,0.030000
2025-09-23,CBRE Group,35,63,2,100,0.020000
2025-09-23,CDW,42,55,3,100,0.030000
2025-09-23,CF Industries,39,56,5,100,0.050000
2025-09-23,CH Robinson Worldwide,28,63,9,100,0.090000
2025-09-23,CHS,45,49,6,100,0.060000
2025-09-23,CIncinnati Financial,38,55,7,100,0.070000
2025-09-23,CME Group,27,67,6,100,0.060000
2025-09-23,CMS Energy,88,10,2,100,0.020000
2025-09-23,CNO Financial Group,28,67,5,100,0.050000
2025-09-23,CNX Resources,43,54,3,100,0.030000
2025-09-23,CSX,35,58,7,100,0.070000
2025-09-23,CVS Health,47,49,4,100,0.040000
2025-09-23,Cabot Corporation,35,60,5,100,0.050000
2025-09-23,Cadence,23,64,13,100,0.130000
2025-09-23,Caesars Entertainment,69,23,8,100,0.080000
2025-09-23,Cal-Maine Foods,58,40,2,100,0.020000
2025-09-23,Caleres Inc,29,64,7,100,0.070000
2025-09-23,California Resources,40,53,7,100,0.070000
2025-09-23,Calumet Inc,32,50,9,91,0.098901
2025-09-23,Campbell Soup,29,56,15,100,0.150000
2025-09-23,Camping World,26,62,12,100,0.120000
2025-09-23,Capital One,49,46,5,100,0.050000
2025-09-23,CarMax,20,68,12,100,0.120000
2025-09-23,Cardinal Health,31,60,9,100,0.090000
2025-09-23,Carlisle Companies,34,60,6,100,0.060000
2025-09-23,Carlyle Group,38,57,5,100,0.050000
2025-09-23,Carpenter Technology,34,64,2,100,0.020000
2025-09-23,Carrier Global,25,61,14,100,0.140000
2025-09-23,Carters Inc,18,27,2,47,0.042553
2025-09-23,Carvana,42,52,6,100,0.060000
2025-09-23,Caseys General Stores,28,62,10,100,0.100000
2025-09-23,Catalent,23,71,6,100,0.060000
2025-09-23,Caterpillar,38,57,5,100,0.050000
2025-09-23,Cboe Global Markets,36,63,1,100,0.010000
2025-09-23,Celanese,33,45,22,100,0.220000
2025-09-23,Cencora,61,36,3,100,0.030000
2025-09-23,Centene,31,46,23,100,0.230000
2025-09-23,CenterPoint Energy,72,24,4,100,0.040000
2025-09-23,Central Garden & Pet,22,74,4,100,0.040000
2025-09-23,Century Communities,31,66,3,100,0.030000
2025-09-23,ChampionX,37,61,2,100,0.020000
2025-09-23,Charles River Laboratories International,26,62,12,100,0.120000
2025-09-23,Charles Schwab,39,55,6,100,0.060000
2025-09-23,Chart Industries,33,64,3,100,0.030000
2025-09-23,Charter Communications,20,59,21,100,0.210000
2025-09-23,Cheesecake Factory,28,56,16,100,0.160000
2025-09-23,Chefs Warehouse,45,51,4,100,0.040000
2025-09-23,Chemours,33,51,16,100,0.160000
2025-09-23,Cheniere Energy,90,10,0,100,0.000000
2025-09-23,Chevron,39,47,16,102,0.156863
2025-09-23,Chewy,40,49,11,100,0.110000
2025-09-23,Chipotle Mexican Grill,23,65,12,100,0.120000
2025-09-23,Chord Energy,90,10,0,100,0.000000
2025-09-23,Church & Dwight,30,62,8,100,0.080000
2025-09-23,Ciena,43,52,5,100,0.050000
2025-09-23,Cigna,47,43,10,100,0.100000
2025-09-23,Cinemark,36,54,10,100,0.100000
2025-09-23,Cintas,47,49,4,100,0.040000
2025-09-23,Cisco Systems,32,64,4,100,0.040000
2025-09-23,Citigroup,37,58,5,100,0.050000
2025-09-23,Citizens Financial Group,41,56,3,100,0.030000
2025-09-23,Civitas Resources,30,50,20,100,0.200000
2025-09-23,Clean Harbors,78,13,9,100,0.090000
2025-09-23,Clear Channel Outdoor Hldgs,9,1,1,11,0.090909
2025-09-23,Cleveland-Cliffs,24,62,14,100,0.140000
2025-09-23,Clorox,37,52,11,100,0.110000
2025-09-23,Cognizant Technology Solutions,38,56,6,100,0.060000
2025-09-23,Coherent,29,69,2,100,0.020000
2025-09-23,Coinbase Global,20,69,11,100,0.110000
2025-09-23,Colgate-Palmolive,35,57,8,100,0.080000
2025-09-23,Columbia Banking System,38,61,1,100,0.010000
2025-09-23,Columbia Sportswear,28,55,17,100,0.170000
2025-09-23,Comcast,38,47,15,100,0.150000
2025-09-23,Comerica,48,43,9,100,0.090000
2025-09-23,Comfort Systems USA,95,5,0,100,0.000000
2025-09-23,CommScope,23,74,3,100,0.030000
2025-09-23,Commercial Metals,28,63,9,100,0.090000
2025-09-23,Community Health Systems,26,58,16,100,0.160000
2025-09-23,Compass Group,33,53,14,100,0.140000
2025-09-23,Conagra Brands,41,54,5,100,0.050000
2025-09-23,Concentrix,30,64,6,100,0.060000
2025-09-23,Conduent,30,58,12,100,0.120000
2025-09-23,ConocoPhillips,46,43,11,100,0.110000
2025-09-23,Consol Energy,76,22,2,100,0.020000
2025-09-23,Consolidated Edison,38,56,6,100,0.060000
2025-09-23,Constellation Brands,19,55,26,100,0.260000
2025-09-23,Constellation Energy,84,15,1,100,0.010000
2025-09-23,Continental Resources,42,47,11,100,0.110000
2025-09-23,Cooper Cos,3,23,4,30,0.133333
2025-09-23,Cooper-Standard,33,62,5,100,0.050000
2025-09-23,Copart,43,56,1,100,0.010000
2025-09-23,Core & Main,28,59,13,100,0.130000
2025-09-23,Corebridge Financial,43,54,3,100,0.030000
2025-09-23,Cornerstone Building Brands,29,61,10,100,0.100000
2025-09-23,Corning,36,51,13,100,0.130000
2025-09-23,Corpay,35,64,1,100,0.010000
2025-09-23,Corteva,31,64,5,100,0.050000
2025-09-23,Costco,24,59,17,100,0.170000
2025-09-23,Coterra Energy,79,18,3,100,0.030000
2025-09-23,Coty,26,61,13,100,0.130000
2025-09-23,Country Financial,25,59,16,100,0.160000
2025-09-23,Coupang,34,56,10,100,0.100000
2025-09-23,Cracker Barrel Old Country Store,16,67,17,100,0.170000
2025-09-23,Crocs,23,66,11,100,0.110000
2025-09-23,CrossAmerica Partners,27,69,4,100,0.040000
2025-09-23,CrowdStrike,41,48,11,100,0.110000
2025-09-23,Crown Castle,39,57,4,100,0.040000
2025-09-23,Crown Holdings,32,63,5,100,0.050000
2025-09-23,Cullen Frost Bankers,46,49,5,100,0.050000
2025-09-23,Cummins Inc,55,42,3,100,0.030000
2025-09-23,DR Horton,29,63,8,100,0.080000
2025-09-23,DTE Energy,74,20,6,100,0.060000
2025-09-23,DXC Technology,25,72,3,100,0.030000
2025-09-23,DaVita,29,50,21,100,0.210000
2025-09-23,Dana Incorporated,34,58,8,100,0.080000
2025-09-23,Danaher,60,36,4,100,0.040000
2025-09-23,Darden Restaurants,33,56,11,100,0.110000
2025-09-23,Darling Ingredients,89,8,3,100,0.030000
2025-09-23,Deckers Outdoor,42,50,8,100,0.080000
2025-09-23,Deere,28,62,10,100,0.100000
2025-09-23,Delek US,44,50,6,100,0.060000
2025-09-23,Dell Technologies,30,68,2,100,0.020000
2025-09-23,Delta Air Lines,23,64,15,102,0.147059
2025-09-23,Dentsply Sirona,29,69,2,100,0.020000
2025-09-23,Designer Brands,18,72,10,100,0.100000
2025-09-23,Devon Energy,93,5,2,100,0.020000
2025-09-23,DexCom,28,55,17,100,0.170000
2025-09-23,Diamondback Energy,87,12,1,100,0.010000
2025-09-23,Dicks Sporting Goods,28,67,5,100,0.050000
2025-09-23,Diebold Nixdorf,35,65,0,100,0.000000
2025-09-23,Digital Realty Trust,86,14,0,100,0.000000
2025-09-23,Dillards,29,57,14,100,0.140000
2025-09-23,Discover Financial,38,54,8,100,0.080000
2025-09-23,DocuSign,41,49,10,100,0.100000
2025-09-23,Dollar General,15,61,24,100,0.240000
2025-09-23,Dollar Tree,39,52,9,100,0.090000
2025-09-23,Dominion Energy,71,23,6,100,0.060000
2025-09-23,Dominos Pizza Inc,17,27,2,46,0.043478
2025-09-23,Domtar,29,62,9,100,0.090000
2025-09-23,Donaldson Company,46,49,5,100,0.050000
2025-09-23,DoorDash,35,51,9,95,0.094737
2025-09-23,Dover Corporation,50,49,1,100,0.010000
2025-09-23,DraftKings,61,35,4,100,0.040000
2025-09-23,Dream Finders Homes,85,13,2,100,0.020000
2025-09-23,Dropbox,27,69,4,100,0.040000
2025-09-23,DuPont,25,62,13,100,0.130000
2025-09-23,Duke Energy,90,9,1,100,0.010000
2025-09-23,Dycom Industries,30,66,4,100,0.040000
2025-09-23,EMCOR Group,29,68,3,100,0.030000
2025-09-23,EOG Resources,49,44,7,100,0.070000
2025-09-23,EPAM Systems,36,61,3,100,0.030000
2025-09-23,EQT,36,54,10,100,0.100000
2025-09-23,ESAB,33,62,5,100,0.050000
2025-09-23,East West Bancorp,43,53,4,100,0.040000
2025-09-23,Eastman Chemical,29,52,19,100,0.190000
2025-09-23,Ebay,30,59,11,100,0.110000
2025-09-23,EchoStar,19,72,9,100,0.090000
2025-09-23,Ecolab,43,54,3,100,0.030000
2025-09-23,Edison International,32,53,15,100,0.150000
2025-09-23,Edward Jones,25,66,9,100,0.090000
2025-09-23,Edwards Lifesciences,45,38,17,100,0.170000
2025-09-23,Elanco Animal Health,36,61,3,100,0.030000
2025-09-23,Electronic Arts,23,67,10,100,0.100000
2025-09-23,Elevance Health,43,44,13,100,0.130000
2025-09-23,Eli Lilly,28,66,6,100,0.060000
2025-09-23,Emerson Electric,46,52,2,100,0.020000
2025-09-23,EnLink Midstream,41,52,7,100,0.070000
2025-09-23,Encompass Health,30,63,7,100,0.070000
2025-09-23,Endeavor Group,16,76,8,100,0.080000
2025-09-23,Endeavor Group Holdings,19,71,10,100,0.100000
2025-09-23,EnerSys,36,54,10,100,0.100000
2025-09-23,Energizer Holdings,87,12,1,100,0.010000
2025-09-23,Energy Transfer,80,15,5,100,0.050000
2025-09-23,Ensign Group,43,55,2,100,0.020000
2025-09-23,Entegris,43,50,7,100,0.070000
2025-09-23,Entergy,47,47,6,100,0.060000
2025-09-23,Enterprise Products Partners,43,41,16,100,0.160000
2025-09-23,Envista,23,69,8,100,0.080000
2025-09-23,Equifax,49,44,7,100,0.070000
2025-09-23,Equinix,40,55,5,100,0.050000
2025-09-23,Equitable Holdings,36,57,7,100,0.070000
2025-09-23,Equity Residential,37,59,4,100,0.040000
2025-09-23,Erie Insurance,28,58,14,100,0.140000
2025-09-23,Estée Lauder,34,55,11,100,0.110000
2025-09-23,Etsy,26,50,24,100,0.240000
2025-09-23,Euronet Worldwide,32,64,4,100,0.040000
2025-09-23,Evergy,47,46,7,100,0.070000
2025-09-23,Eversource Energy,70,23,7,100,0.070000
2025-09-23,Exact Sciences,30,49,21,100,0.210000
2025-09-23,Exelon,43,52,5,100,0.050000
2025-09-23,Expand Energy Corporation,95,5,0,100,0.000000
2025-09-23,Expedia,50,44,6,100,0.060000
2025-09-23,Expeditors International of Washington,30,62,8,100,0.080000
2025-09-23,Extra Space Storage,30,62,8,100,0.080000
2025-09-23,Exxon Mobil,64,32,4,100,0.040000
2025-09-23,F5,38,58,4,100,0.040000
2025-09-23,FM Global,36,47,17,100,0.170000
2025-09-23,FMC Corporation,36,56,8,100,0.080000
2025-09-23,FTI Consulting,33,54,13,100,0.130000
2025-09-23,Fannie Mae,18,75,7,100,0.070000
2025-09-23,Farmers Insurance Exchange,20,61,19,100,0.190000
2025-09-23,Fastenal,63,35,2,100,0.020000
2025-09-23,FedEx,33,55,14,102,0.137255
2025-09-23,Federated Mutual Insurance,19,21,6,46,0.130435
2025-09-23,Ferguson Enterprises,39,55,6,100,0.060000
2025-09-23,Fidelity National Financial,39,55,6,100,0.060000
2025-09-23,Fidelity National Information Services,47,42,11,100,0.110000
2025-09-23,Fifth Third Bancorp,42,48,10,100,0.100000
2025-09-23,First American Financial,32,58,10,100,0.100000
2025-09-23,First Citizens BancShares,39,58,3,100,0.030000
2025-09-23,First Horizon,43,56,1,100,0.010000
2025-09-23,First National of Nebraska,17,33,1,51,0.019608
2025-09-23,First Solar,33,62,5,100,0.050000
2025-09-23,FirstCash,35,56,9,100,0.090000
2025-09-23,FirstEnergy,40,47,13,100,0.130000
2025-09-23,Fiserv,34,60,6,100,0.060000
2025-09-23,Five Below,34,57,9,100,0.090000
2025-09-23,Flagstar Financial,27,61,12,100,0.120000
2025-09-23,Floor & Decor,33,59,8,100,0.080000
2025-09-23,Flowers Foods,21,61,18,100,0.180000
2025-09-23,Flowserve,29,68,3,100,0.030000
2025-09-23,Fluor,34,52,14,100,0.140000
2025-09-23,Foot Locker,13,70,17,100,0.170000
2025-09-23,Ford Motor,26,66,8,100,0.080000
2025-09-23,Fortinet,30,46,24,100,0.240000
2025-09-23,Fortive,30,59,11,100,0.110000
2025-09-23,Fortune Brands Innovations,29,65,6,100,0.060000
2025-09-23,Franklin Resources,38,53,9,100,0.090000
2025-09-23,Freddie Mac,20,66,14,100,0.140000
2025-09-23,Freeport-McMoRan,47,40,13,100,0.130000
2025-09-23,Frontier Airlines,28,58,14,100,0.140000
2025-09-23,Frontier Communications,40,54,6,100,0.060000
2025-09-23,G-III Apparel Group,34,59,7,100,0.070000
2025-09-23,GE HealthCare Technologies,31,62,7,100,0.070000
2025-09-23,GE Vernova,54,41,5,100,0.050000
2025-09-23,GMS,24,71,5,100,0.050000
2025-09-23,GXO Logistics,35,58,7,100,0.070000
2025-09-23,GameStop,21,63,16,100,0.160000
2025-09-23,Gannett,27,63,10,100,0.100000
2025-09-23,Garrett Motion Inc,35,62,3,100,0.030000
2025-09-23,Gartner,22,67,11,100,0.110000
2025-09-23,Gen Digital,49,48,3,100,0.030000
2025-09-23,Generac,31,62,7,100,0.070000
2025-09-23,General Dynamics,92,7,1,100,0.010000
2025-09-23,General Mills,46,53,1,100,0.010000
2025-09-23,General Motors,34,57,9,100,0.090000
2025-09-23,Genesis Energy,77,20,3,100,0.030000
2025-09-23,Genuine Parts,39,60,1,100,0.010000
2025-09-23,Genworth Financial,47,49,4,100,0.040000
2025-09-23,Gilead Sciences,46,51,3,100,0.030000
2025-09-23,Global Partners,42,48,10,100,0.100000
2025-09-23,Global Payments,37,61,2,100,0.020000
2025-09-23,Globe Life,35,56,9,100,0.090000
2025-09-23,GoDaddy,38,54,8,100,0.080000
2025-09-23,Goldman Sachs,31,63,8,102,0.078431
2025-09-23,Goodyear Tire & Rubber,24,67,9,100,0.090000
2025-09-23,Graham Holdings Company,29,67,4,100,0.040000
2025-09-23,Granite Construction,41,56,3,100,0.030000
2025-09-23,Graphic Packaging,19,65,16,100,0.160000
2025-09-23,Gray Television,24,62,14,100,0.140000
2025-09-23,Graybar Electric,15,27,4,46,0.086957
2025-09-23,Green Plains Inc,36,53,11,100,0.110000
2025-09-23,Greif,20,72,8,100,0.080000
2025-09-23,Griffon Corporation,37,58,5,100,0.050000
2025-09-23,Grocery Outlet Holding,28,64,8,100,0.080000
2025-09-23,Group 1 Automotive,31,63,6,100,0.060000
2025-09-23,Guardian Life insurance,50,48,2,100,0.020000
2025-09-23,Guess Inc,32,64,4,100,0.040000
2025-09-23,GuideWell Mutual,19,24,1,44,0.022727
2025-09-23,HB Fuller,21,75,4,100,0.040000
2025-09-23,HCA Healthcare,44,52,4,100,0.040000
2025-09-23,HEICO,35,57,8,100,0.080000
2025-09-23,HF SInclair,33,57,10,100,0.100000
2025-09-23,HP,30,66,4,100,0.040000
2025-09-23,Halliburton,18,63,19,100,0.190000
2025-09-23,Hanesbrands,27,71,2,100,0.020000
2025-09-23,Hanover Insurance Group,42,50,8,100,0.080000
2025-09-23,Harley-Davidson,16,69,15,100,0.150000
2025-09-23,Hasbro,34,55,11,100,0.110000
2025-09-23,Hawaiian Airlines Inc,35,63,2,100,0.020000
2025-09-23,Hawaiian Electric Industries,28,65,7,100,0.070000
2025-09-23,Helmerich & Payne,22,65,13,100,0.130000
2025-09-23,Henry Schein,27,68,5,100,0.050000
2025-09-23,Herc Rentals,33,57,10,100,0.100000
2025-09-23,Hershey,33,59,8,100,0.080000
2025-09-23,Hertz,25,49,26,100,0.260000
2025-09-23,Hewlett Packard Enterprise,28,70,2,100,0.020000
2025-09-23,Hillenbrand,22,68,10,100,0.100000
2025-09-23,Hilton Grand Vacations,90,10,0,100,0.000000
2025-09-23,Hilton Worldwide,53,44,3,100,0.030000
2025-09-23,Hologic,27,66,7,100,0.070000
2025-09-23,Home Depot,49,45,6,100,0.060000
2025-09-23,Honeywell,35,45,20,100,0.200000
2025-09-23,Hormel Foods,26,67,7,100,0.070000
2025-09-23,Host Hotels & Resorts,23,74,3,100,0.030000
2025-09-23,Hovnanian Enterprises,35,57,8,100,0.080000
2025-09-23,Howmet Aerospace,38,57,5,100,0.050000
2025-09-23,Hub Group,24,64,12,100,0.120000
2025-09-23,Hubbell,21,68,11,100,0.110000
2025-09-23,Humana,47,40,13,100,0.130000
2025-09-23,Huntington Bancshares,35,63,2,100,0.020000
2025-09-23,Huntington Ingalls Industries,38,51,11,100,0.110000
2025-09-23,Huntsman,12,60,28,100,0.280000
2025-09-23,Hyatt Hotels,39,56,5,100,0.050000
2025-09-23,Hyster-Yale,24,70,6,100,0.060000
2025-09-23,IAC,32,60,8,100,0.080000
2025-09-23,IBM,44,48,8,100,0.080000
2025-09-23,IDEX,37,55,8,100,0.080000
2025-09-23,IDEXX Laboratories,55,42,3,100,0.030000
2025-09-23,IQVIA,56,38,6,100,0.060000
2025-09-23,ITT,42,51,7,100,0.070000
2025-09-23,Icahn Enterprises,29,55,16,100,0.160000
2025-09-23,Illinois Tool Works,41,54,5,100,0.050000
2025-09-23,Illumina Inc,25,66,9,100,0.090000
2025-09-23,Incyte,34,62,4,100,0.040000
2025-09-23,Ingersoll Rand,33,59,8,100,0.080000
2025-09-23,Ingles Markets,25,49,26,100,0.260000
2025-09-23,Ingram Micro,22,44,34,100,0.340000
2025-09-23,Ingredion,41,54,5,100,0.050000
2025-09-23,Insight Enterprises,32,58,10,100,0.100000
2025-09-23,Insperity,36,56,8,100,0.080000
2025-09-23,Instacart,34,57,9,100,0.090000
2025-09-23,Installed Building Products,24,69,7,100,0.070000
2025-09-23,Intel,17,69,14,100,0.140000
2025-09-23,Interactive Brokers,37,55,8,100,0.080000
2025-09-23,Intercontinental Exchange,41,56,3,100,0.030000
2025-09-23,International Flavors & Fragrances,27,66,7,100,0.070000
2025-09-23,International Paper,21,71,8,100,0.080000
2025-09-23,Interpublic Group,37,57,6,100,0.060000
2025-09-23,Intuit,52,45,3,100,0.030000
2025-09-23,Intuitive Surgical,45,45,10,100,0.100000
2025-09-23,Iron Mountain,25,63,12,100,0.120000
2025-09-23,JB Hunt Transport Services,23,66,11,100,0.110000
2025-09-23,JELD-WEN Holding,26,65,9,100,0.090000
2025-09-23,JM Smucker,34,60,6,100,0.060000
2025-09-23,JPMorgan Chase,42,51,7,100,0.070000
2025-09-23,Jabil,27,70,3,100,0.030000
2025-09-23,Jackson Financial,38,58,4,100,0.040000
2025-09-23,Jacobs Solutions,56,42,2,100,0.020000
2025-09-23,Jefferies Financial,38,56,6,100,0.060000
2025-09-23,JetBlue Airways,35,48,17,100,0.170000
2025-09-23,Johnson & Johnson,38,54,8,100,0.080000
2025-09-23,Jones Lang LaSalle,42,56,2,100,0.020000
2025-09-23,Juniper Networks,29,65,6,100,0.060000
2025-09-23,KB Home,42,49,9,100,0.090000
2025-09-23,KBR,49,47,4,100,0.040000
2025-09-23,KKR & Co,61,35,4,100,0.040000
2025-09-23,KLA,28,50,22,100,0.220000
2025-09-23,Kaiser Aluminum,33,62,5,100,0.050000
2025-09-23,Kellanova,36,55,9,100,0.090000
2025-09-23,Kelly Services Inc,23,68,9,100,0.090000
2025-09-23,Kemper Corporation,36,57,7,100,0.070000
2025-09-23,Kenvue,20,59,21,100,0.210000
2025-09-23,Keurig Dr Pepper,20,67,13,100,0.130000
2025-09-23,KeyCorp,35,60,5,100,0.050000
2025-09-23,Keysight Technologies,42,52,6,100,0.060000
2025-09-23,Kimberly-Clark,35,55,10,100,0.100000
2025-09-23,Kinder Morgan,94,4,2,100,0.020000
2025-09-23,Kirby Corporation,26,68,6,100,0.060000
2025-09-23,Knife River Corporation,25,54,6,85,0.070588
2025-09-23,Knight Swift Transportation,32,60,8,100,0.080000
2025-09-23,Kohl's,29,51,20,100,0.200000
2025-09-23,Kontoor Brands,34,62,4,100,0.040000
2025-09-23,Korn Ferry,55,37,8,100,0.080000
2025-09-23,Kraft Heinz,31,54,14,99,0.141414
2025-09-23,Kroger,16,56,20,92,0.217391
2025-09-23,Kyndryl,33,63,4,100,0.040000
2025-09-23,L3Harris Technologies,36,58,6,100,0.060000
2025-09-23,LCI Industries,36,59,5,100,0.050000
2025-09-23,LKQ,28,64,8,100,0.080000
2025-09-23,LPL Financial,61,38,1,100,0.010000
2025-09-23,Labcorp Holdings,43,52,5,100,0.050000
2025-09-23,Lam Research,50,47,3,100,0.030000
2025-09-23,Lamb Weston,26,65,9,100,0.090000
2025-09-23,Land O'Lakes,27,60,13,100,0.130000
2025-09-23,Landstar System,24,53,23,100,0.230000
2025-09-23,Las Vegas Sands,33,59,8,100,0.080000
2025-09-23,Lear Corporation,34,56,10,100,0.100000
2025-09-23,Leggett & Platt,21,69,10,100,0.100000
2025-09-23,Leidos,44,49,7,100,0.070000
2025-09-23,Lennar,13,66,21,100,0.210000
2025-09-23,Lennox International,37,57,6,100,0.060000
2025-09-23,Levi Strauss,22,76,2,100,0.020000
2025-09-23,Liberty Energy,90,10,0,100,0.000000
2025-09-23,Liberty Media,96,3,1,100,0.010000
2025-09-23,Liberty Mutual Insurance,78,15,7,100,0.070000
2025-09-23,Light & Wonder,24,62,14,100,0.140000
2025-09-23,Lincoln Electric,36,61,3,100,0.030000
2025-09-23,Lincoln National,31,54,15,100,0.150000
2025-09-23,Lithia Motors,40,57,3,100,0.030000
2025-09-23,Live Nation Entertainment,40,40,20,100,0.200000
2025-09-23,Lockheed Martin,34,47,19,100,0.190000
2025-09-23,Loews,41,55,4,100,0.040000
2025-09-23,Louisiana-Pacific Corporation,35,61,4,100,0.040000
2025-09-23,Lowe's,24,50,26,100,0.260000
2025-09-23,Lululemon athletica,21,58,21,100,0.210000
2025-09-23,Lumen Technologies,16,73,11,100,0.110000
2025-09-23,Lyft,14,73,13,100,0.130000
2025-09-23,M&T Bank,30,56,14,100,0.140000
2025-09-23,M/I Homes,23,70,7,100,0.070000
2025-09-23,MDU Resources Group,38,57,5,100,0.050000
2025-09-23,MGM Resorts International,34,61,5,100,0.050000
2025-09-23,MKS Instruments,42,48,10,100,0.100000
2025-09-23,MRC Global,39,58,3,100,0.030000
2025-09-23,MSC Industrial Direct,22,69,9,100,0.090000
2025-09-23,MSCI,31,62,7,100,0.070000
2025-09-23,MYR Group,28,62,10,100,0.100000
2025-09-23,Macys,23,69,8,100,0.080000
2025-09-23,ManpowerGroup,28,56,16,100,0.160000
2025-09-23,Marathon Oil,22,64,14,100,0.140000
2025-09-23,Marathon Petroleum,40,54,6,100,0.060000
2025-09-23,Markel Group,44,51,5,100,0.050000
2025-09-23,Marriott International,37,61,2,100,0.020000
2025-09-23,Marriott Vacations Worldwide,34,53,13,100,0.130000
2025-09-23,Marsh & McLennan,52,42,6,100,0.060000
2025-09-23,Martin Marietta Materials,32,54,14,100,0.140000
2025-09-23,Marvell Technology,37,56,7,100,0.070000
2025-09-23,MasTec,46,52,2,100,0.020000
2025-09-23,Masco,29,61,10,100,0.100000
2025-09-23,Mass Mutual,26,52,5,83,0.060241
2025-09-23,MasterBrand,30,66,4,100,0.040000
2025-09-23,Mastercard,35,61,4,100,0.040000
2025-09-23,Matador Resources,29,63,8,100,0.080000
2025-09-23,Match Group,21,58,21,100,0.210000
2025-09-23,Mativ,25,70,5,100,0.050000
2025-09-23,Matson Inc,35,57,8,100,0.080000
2025-09-23,Mattel,37,50,13,100,0.130000
2025-09-23,Maximus,26,68,6,100,0.060000
2025-09-23,McCormick & Company,45,45,10,100,0.100000
2025-09-23,McDonalds,24,57,19,100,0.190000
2025-09-23,McKesson,40,56,4,100,0.040000
2025-09-23,Medical Mutual of Ohio,25,63,12,100,0.120000
2025-09-23,Merck,40,49,11,100,0.110000
2025-09-23,Mercury General,28,54,18,100,0.180000
2025-09-23,Meritage Homes,24,70,6,100,0.060000
2025-09-23,MetLife,34,60,6,100,0.060000
2025-09-23,Meta Platforms,44,44,12,100,0.120000
2025-09-23,Mettler-Toledo International,36,61,3,100,0.030000
2025-09-23,Microchip Technology,46,50,4,100,0.040000
2025-09-23,Micron Technology,29,62,9,100,0.090000
2025-09-23,Microsoft,23,64,17,104,0.163462
2025-09-23,Middleby,19,78,3,100,0.030000
2025-09-23,MillerKnoll,32,62,6,100,0.060000
2025-09-23,Moderna,36,49,15,100,0.150000
2025-09-23,ModivCare,30,52,18,100,0.180000
2025-09-23,Mohawk Industries,35,59,6,100,0.060000
2025-09-23,Molina Healthcare,36,50,14,100,0.140000
2025-09-23,Molson Coors Beverage,24,55,13,92,0.141304
2025-09-23,Mondelez,35,52,13,100,0.130000
2025-09-23,Monster Beverage,45,51,4,100,0.040000
2025-09-23,Moodys Corporation,4,16,3,23,0.130435
2025-09-23,Moog Inc,37,57,6,100,0.060000
2025-09-23,Morgan Stanley,15,72,7,94,0.074468
2025-09-23,Motorola Solutions,36,57,7,100,0.070000
2025-09-23,Mueller Industries,44,50,6,100,0.060000
2025-09-23,Murphy Oil,28,67,5,100,0.050000
2025-09-23,Murphy USA,32,59,9,100,0.090000
2025-09-23,Mutual of Omaha,47,48,5,100,0.050000
2025-09-23,NCR Atleos,37,60,3,100,0.030000
2025-09-23,NCR Voyix,27,64,9,100,0.090000
2025-09-23,NGL Energy Partners,79,14,7,100,0.070000
2025-09-23,NLV Financial,3,6,1,10,0.100000
2025-09-23,NOV,24,65,11,100,0.110000
2025-09-23,NRG Energy,87,10,3,100,0.030000
2025-09-23,NVR Inc,37,56,7,100,0.070000
2025-09-23,Nasdaq Inc,42,56,2,100,0.020000
2025-09-23,Nationwide Insurance,20,60,20,100,0.200000
2025-09-23,Navient,41,44,15,100,0.150000
2025-09-23,NetApp,35,62,3,100,0.030000
2025-09-23,Netflix,26,50,26,102,0.254902
2025-09-23,NeueHealth,53,45,2,100,0.020000
2025-09-23,New York Life Insurance,36,58,6,100,0.060000
2025-09-23,NewMarket Corporation,33,47,4,84,0.047619
2025-09-23,Newell Brands,29,60,11,100,0.110000
2025-09-23,Newmont,28,66,6,100,0.060000
2025-09-23,News Corp,22,70,8,100,0.080000
2025-09-23,Nexstar Media Group,21,65,6,92,0.065217
2025-09-23,NextEra Energy,87,12,1,100,0.010000
2025-09-23,NiSource,41,52,7,100,0.070000
2025-09-23,Nike,24,68,7,99,0.070707
2025-09-23,Nordson,41,57,2,100,0.020000
2025-09-23,Nordstrom,34,59,7,100,0.070000
2025-09-23,Norfolk Southern,35,51,8,94,0.085106
2025-09-23,Northern Trust,92,7,1,100,0.010000
2025-09-23,Northrop Grumman,29,65,6,100,0.060000
2025-09-23,Northwestern Mutual,33,51,16,100,0.160000
2025-09-23,Nucor,30,55,15,100,0.150000
2025-09-23,Nvidia,20,72,10,102,0.098039
2025-09-23,O'Reilly Automotive,68,30,2,100,0.020000
2025-09-23,O-I Glass,38,50,12,100,0.120000
2025-09-23,ODP Business Solutions,19,52,1,72,0.013889
2025-09-23,OGE Energy,89,10,1,100,0.010000
2025-09-23,ON Semiconductor,27,62,11,100,0.110000
2025-09-23,Occidental Petroleum,36,51,13,100,0.130000
2025-09-23,Old Dominion Freight Line,38,47,15,100,0.150000
2025-09-23,Old National Bancorp,31,68,1,100,0.010000
2025-09-23,Old Republic International,50,48,2,100,0.020000
2025-09-23,Olin,22,59,19,100,0.190000
2025-09-23,Omnicom Group,40,53,7,100,0.070000
2025-09-23,OneMain,46,50,4,100,0.040000
2025-09-23,Oneok,46,50,4,100,0.040000
2025-09-23,Opendoor Technologies,20,49,31,100,0.310000
2025-09-23,Option Care Health,95,5,0,100,0.000000
2025-09-23,Oracle,22,70,8,100,0.080000
2025-09-23,Organon,28,57,15,100,0.150000
2025-09-23,Oscar Health,28,64,8,100,0.080000
2025-09-23,Oshkosh Corporation,40,51,9,100,0.090000
2025-09-23,Otis Worldwide,43,49,8,100,0.080000
2025-09-23,Ovintiv,48,46,6,100,0.060000
2025-09-23,Owens & Minor,28,56,16,100,0.160000
2025-09-23,Owens Corning,25,73,2,100,0.020000
2025-09-23,PACS Group,33,52,15,100,0.150000
2025-09-23,PBF Energy,81,17,2,100,0.020000
2025-09-23,PC Connection Inc,44,38,4,86,0.046512
2025-09-23,PENN Entertainment,87,12,1,100,0.010000
2025-09-23,PG&E,41,41,18,100,0.180000
2025-09-23,PNC Financial Services,47,48,5,100,0.050000
2025-09-23,PPG Industries,46,51,3,100,0.030000
2025-09-23,PPL Corporation,43,53,4,100,0.040000
2025-09-23,PVH,33,51,16,100,0.160000
2025-09-23,Paccar,40,52,8,100,0.080000
2025-09-23,Pacific Life,41,56,3,100,0.030000
2025-09-23,Packaging Corp of America,15,77,8,100,0.080000
2025-09-23,Palo Alto Networks,34,54,12,100,0.120000
2025-09-23,Par Pacific,35,61,4,100,0.040000
2025-09-23,Paramount Global,28,62,10,100,0.100000
2025-09-23,Park Hotels & Resorts,27,65,8,100,0.080000
2025-09-23,Parker-Hannifin,58,42,0,100,0.000000
2025-09-23,Parsons Corporation,44,50,6,100,0.060000
2025-09-23,Patrick Industries,38,58,4,100,0.040000
2025-09-23,Patterson Companies Inc,13,58,1,72,0.013889
2025-09-23,Patterson-UTI Energy,62,31,7,100,0.070000
2025-09-23,PayPal,39,56,5,100,0.050000
2025-09-23,Paychex,43,53,4,100,0.040000
2025-09-23,Peabody Energy,74,23,3,100,0.030000
2025-09-23,Peloton Interactive,38,57,5,100,0.050000
2025-09-23,Penn Mutual Life Insurance,35,60,5,100,0.050000
2025-09-23,PennyMac Financial Services,29,66,5,100,0.050000
2025-09-23,Penske Automotive,28,68,4,100,0.040000
2025-09-23,PepsiCo,54,42,4,100,0.040000
2025-09-23,Performance Food,34,61,5,100,0.050000
2025-09-23,Permian Resources,39,59,2,100,0.020000
2025-09-23,Petco Health and Wellness,74,23,3,100,0.030000
2025-09-23,Peter Kiewit Sons',6,21,11,38,0.289474
2025-09-23,Pfizer,19,69,4,92,0.043478
2025-09-23,Philip Morris International,50,46,4,100,0.040000
2025-09-23,Phillips 66,43,52,5,100,0.050000
2025-09-23,Pinnacle West Capital,32,51,17,100,0.170000
2025-09-23,Pinterest,37,59,4,100,0.040000
2025-09-23,Pioneer Natural Resources,46,37,17,100,0.170000
2025-09-23,Pitney Bowes,35,64,1,100,0.010000
2025-09-23,Plains GP,33,51,16,100,0.160000
2025-09-23,Playtika Holding,29,58,13,100,0.130000
2025-09-23,Plexus Corp,34,62,4,100,0.040000
2025-09-23,Polaris Inc,42,52,6,100,0.060000
2025-09-23,Pool Corporation,41,53,6,100,0.060000
2025-09-23,Popular Inc,96,3,1,100,0.010000
2025-09-23,Portland General Electric,34,60,6,100,0.060000
2025-09-23,Post Holdings,27,66,7,100,0.070000
2025-09-23,PrIncipal Financial,39,57,4,100,0.040000
2025-09-23,PriceSmart,34,61,5,100,0.050000
2025-09-23,Primerica,40,56,4,100,0.040000
2025-09-23,Primoris Services,41,57,2,100,0.020000
2025-09-23,ProFrac Holding,27,61,12,100,0.120000
2025-09-23,Procter & Gamble,41,50,9,100,0.090000
2025-09-23,Progressive Insurance,32,57,11,100,0.110000
2025-09-23,Prologis,41,57,2,100,0.020000
2025-09-23,Prudential Financial,41,54,5,100,0.050000
2025-09-23,Public Service Enterprise Group,50,47,3,100,0.030000
2025-09-23,Public Storage,42,44,14,100,0.140000
2025-09-23,Publix Super Markets,38,58,4,100,0.040000
2025-09-23,Puget Sound Energy,56,34,10,100,0.100000
2025-09-23,PulteGroup,31,63,6,100,0.060000
2025-09-23,Pure Storage,29,64,7,100,0.070000
2025-09-23,QVC Group,25,65,10,100,0.100000
2025-09-23,QXO Building Products,0,8,2,10,0.200000
2025-09-23,Qorvo,47,45,8,100,0.080000
2025-09-23,Qualcomm,37,57,6,100,0.060000
2025-09-23,Quanta Services,47,51,2,100,0.020000
2025-09-23,Quest Diagnostics,26,65,9,100,0.090000
2025-09-23,QuidelOrtho,34,59,7,100,0.070000
2025-09-23,REV Group,51,45,4,100,0.040000
2025-09-23,RPM International,28,65,7,100,0.070000
2025-09-23,RTX,35,59,8,102,0.078431
2025-09-23,RXO Inc,31,61,8,100,0.080000
2025-09-23,Rackspace Technology,26,63,11,100,0.110000
2025-09-23,Radius Recycling,14,62,24,100,0.240000
2025-09-23,Ralph Lauren,33,63,4,100,0.040000
2025-09-23,Range Resources,44,53,3,100,0.030000
2025-09-23,Raymond James Financial,35,60,5,100,0.050000
2025-09-23,Realty Income,44,42,14,100,0.140000
2025-09-23,Regal Rexnord,33,61,6,100,0.060000
2025-09-23,Regeneron Pharmaceuticals,49,45,6,100,0.060000
2025-09-23,Regions Financial,41,56,3,100,0.030000
2025-09-23,Reinsurance Group of America,42,55,3,100,0.030000
2025-09-23,Reliance Inc,44,49,7,100,0.070000
2025-09-23,Republic Services,37,46,17,100,0.170000
2025-09-23,ResMed,31,64,5,100,0.050000
2025-09-23,Resideo Technologies,41,53,6,100,0.060000
2025-09-23,Restoration Hardware,25,62,13,100,0.130000
2025-09-23,Revvity,29,60,11,100,0.110000
2025-09-23,Rithm Capital,20,75,5,100,0.050000
2025-09-23,Rivian Automotive,32,61,9,102,0.088235
2025-09-23,Robert Half,33,54,13,100,0.130000
2025-09-23,Roblox,25,51,24,100,0.240000
2025-09-23,Rocket Companies,20,74,6,100,0.060000
2025-09-23,Rockwell Automation,36,64,0,100,0.000000
2025-09-23,Roku,52,42,8,102,0.078431
2025-09-23,Rollins Inc,34,62,4,100,0.040000
2025-09-23,Roper Technologies,36,61,3,100,0.030000
2025-09-23,Ross Stores,40,51,9,100,0.090000
2025-09-23,Rush Enterprises,35,56,9,100,0.090000
2025-09-23,Ryder System,46,53,1,100,0.010000
2025-09-23,Ryerson Holding,18,74,8,100,0.080000
2025-09-23,S&P Global,25,64,11,100,0.110000
2025-09-23,SBA Communications,45,45,10,100,0.100000
2025-09-23,SS&C Technologies,43,55,2,100,0.020000
2025-09-23,Sabre Corporation,27,67,6,100,0.060000
2025-09-23,Saia Inc,43,54,3,100,0.030000
2025-09-23,Salesforce,25,50,25,100,0.250000
2025-09-23,Sallie Mae,36,57,7,100,0.070000
2025-09-23,Sally Beauty,93,6,1,100,0.010000
2025-09-23,Sanmina,31,64,5,100,0.050000
2025-09-23,ScanSource,48,50,2,100,0.020000
2025-09-23,Schneider National,31,62,7,100,0.070000
2025-09-23,Science Applications International,32,59,9,100,0.090000
2025-09-23,Scotts Miracle-Gro,40,50,10,100,0.100000
2025-09-23,Seaboard,26,62,12,100,0.120000
2025-09-23,Sealed Air Corporation,30,63,7,100,0.070000
2025-09-23,Securian Financial,28,64,8,100,0.080000
2025-09-23,Select Medical Holdings,28,65,7,100,0.070000
2025-09-23,Selective Insurance Group,34,51,15,100,0.150000
2025-09-23,Sempra,37,55,0,92,0.000000
2025-09-23,Sentry Insurance Group,3,6,0,9,0.000000
2025-09-23,Service Corp International,5,14,4,23,0.173913
2025-09-23,ServiceNow,35,58,7,100,0.070000
2025-09-23,Sherwin-Williams,22,64,14,100,0.140000
2025-09-23,Shift4 Payments,29,64,7,100,0.070000
2025-09-23,Silgan,15,65,20,100,0.200000
2025-09-23,Simon Property Group,43,50,7,100,0.070000
2025-09-23,Sinclair,7,71,14,92,0.152174
2025-09-23,Sirius XM,29,66,5,100,0.050000
2025-09-23,SiteOne Landscape Supply,30,67,3,100,0.030000
2025-09-23,Skechers USA,25,71,4,100,0.040000
2025-09-23,SkyWest,17,55,28,100,0.280000
2025-09-23,Skyline Champion,39,10,1,50,0.020000
2025-09-23,Skyworks Solutions,37,58,5,100,0.050000
2025-09-23,Smurfit Westrock,23,65,12,100,0.120000
2025-09-23,Snap Inc,30,55,17,102,0.166667
2025-09-23,Snap-on,17,73,10,100,0.100000
2025-09-23,Snowflake Inc,47,53,0,100,0.000000
2025-09-23,Solventum,37,59,4,100,0.040000
2025-09-23,Sonic Automotive,21,76,3,100,0.030000
2025-09-23,Sonoco Products,28,62,10,100,0.100000
2025-09-23,Southern Company,45,53,2,100,0.020000
2025-09-23,Southwest Airlines,27,62,11,100,0.110000
2025-09-23,Southwest Gas Holdings,37,58,5,100,0.050000
2025-09-23,SpartanNash,22,75,3,100,0.030000
2025-09-23,Spectrum Brands,27,60,13,100,0.130000
2025-09-23,Spire Inc,54,41,5,100,0.050000
2025-09-23,Spirit AeroSystems,33,52,15,100,0.150000
2025-09-23,Spirit Airlines,16,66,10,92,0.108696
2025-09-23,Splunk,38,51,11,100,0.110000
2025-09-23,Sprouts Farmers Market,24,72,4,100,0.040000
2025-09-23,Stagwell,30,61,9,100,0.090000
2025-09-23,Stanley Black & Decker,25,66,9,100,0.090000
2025-09-23,Starbucks,20,55,17,92,0.184783
2025-09-23,State Farm Insurance,18,59,23,100,0.230000
2025-09-23,State Street,30,56,14,100,0.140000
2025-09-23,Steel Dynamics,88,10,2,100,0.020000
2025-09-23,Steelcase,34,62,4,100,0.040000
2025-09-23,Stericycle,9,40,51,100,0.510000
2025-09-23,Stifel Financial,37,59,4,100,0.040000
2025-09-23,StoneX Group,34,62,4,100,0.040000
2025-09-23,Stryker,37,53,10,100,0.100000
2025-09-23,Summit Materials,23,70,7,100,0.070000
2025-09-23,Sun Communities,47,43,10,100,0.100000
2025-09-23,Super Micro Computer,84,10,2,96,0.020833
2025-09-23,Surgery Partners,34,54,12,100,0.120000
2025-09-23,Sylvamo,21,64,15,100,0.150000
2025-09-23,Synchrony Financial,56,39,5,100,0.050000
2025-09-23,Synopsys,22,58,20,100,0.200000
2025-09-23,Synovus Financial,41,55,4,100,0.040000
2025-09-23,Sysco,50,46,4,100,0.040000
2025-09-23,T Rowe Price,54,45,1,100,0.010000
2025-09-23,TD Synnex,55,43,2,100,0.020000
2025-09-23,TEGNA,21,74,5,100,0.050000
2025-09-23,THOR Industries,24,66,10,100,0.100000
2025-09-23,TIAA,22,71,7,100,0.070000
2025-09-23,TJX,58,36,6,100,0.060000
2025-09-23,Take-Two Interactive Software,39,56,5,100,0.050000
2025-09-23,Talen Energy,90,9,1,100,0.010000
2025-09-23,Tapestry,24,65,11,100,0.110000
2025-09-23,Targa Resources,46,49,5,100,0.050000
2025-09-23,Target Corporation,46,50,4,100,0.040000
2025-09-23,Taylor Morrison Home,33,61,6,100,0.060000
2025-09-23,Teladoc Health,36,52,12,100,0.120000
2025-09-23,Teledyne Technologies,35,64,1,100,0.010000
2025-09-23,Teleflex,24,69,7,100,0.070000
2025-09-23,Telephone & Data Systems,9,21,0,30,0.000000
2025-09-23,TelevisaUnivision,31,56,13,100,0.130000
2025-09-23,Tempur Sealy International,29,61,10,100,0.100000
2025-09-23,Tenet Healthcare,41,53,6,100,0.060000
2025-09-23,Teradyne,33,62,5,100,0.050000
2025-09-23,Terex,19,74,7,100,0.070000
2025-09-23,Tesla,28,54,21,103,0.203883
2025-09-23,Tetra Tech,43,50,7,100,0.070000
2025-09-23,Texas Instruments,30,64,6,100,0.060000
2025-09-23,Texas Roadhouse,36,56,8,100,0.080000
2025-09-23,Textron,31,62,7,100,0.070000
2025-09-23,The Andersons Inc,32,66,2,100,0.020000
2025-09-23,The Coca-Cola Company,29,62,9,100,0.090000
2025-09-23,The Greenbrier Companies,26,66,8,100,0.080000
2025-09-23,The Hartford,32,45,23,100,0.230000
2025-09-23,The Mosaic Company,32,61,7,100,0.070000
2025-09-23,Thermo Fisher Scientific,51,46,3,100,0.030000
2025-09-23,Thrivent Financial for Lutherans,19,39,2,60,0.033333
2025-09-23,Timken,23,68,9,100,0.090000
2025-09-23,Titan Machinery,22,67,11,100,0.110000
2025-09-23,Toast Inc,39,52,9,100,0.090000
2025-09-23,Toll Brothers,17,81,2,100,0.020000
2025-09-23,TopBuild,22,78,0,100,0.000000
2025-09-23,Topgolf Callaway Brands,25,62,13,100,0.130000
2025-09-23,Toro Company,29,64,7,100,0.070000
2025-09-23,Tractor Supply,25,72,3,100,0.030000
2025-09-23,TransDigm,40,50,10,100,0.100000
2025-09-23,TransUnion,34,55,11,100,0.110000
2025-09-23,Travelers Insurance,36,45,19,100,0.190000
2025-09-23,TreeHouse Foods,18,61,21,100,0.210000
2025-09-23,Tri Pointe Homes,30,66,4,100,0.040000
2025-09-23,TriNet Group,29,66,5,100,0.050000
2025-09-23,Trimble Inc,33,65,2,100,0.020000
2025-09-23,Trinity Industries,26,60,14,100,0.140000
2025-09-23,TruStage,51,42,7,100,0.070000
2025-09-23,Truist Financial,32,60,8,100,0.080000
2025-09-23,Tutor Perini Corporation,55,41,4,100,0.040000
2025-09-23,Twilio,37,56,7,100,0.070000
2025-09-23,Tyson Foods,24,62,14,100,0.140000
2025-09-23,U-Haul,10,42,48,100,0.480000
2025-09-23,UFP Industries,25,70,5,100,0.050000
2025-09-23,UGI Utilities Inc,27,40,16,83,0.192771
2025-09-23,UL Solutions,48,51,1,100,0.010000
2025-09-23,UPS,33,55,12,100,0.120000
2025-09-23,US Bancorp,31,61,8,100,0.080000
2025-09-23,US Foods,53,44,3,100,0.030000
2025-09-23,USAA,26,55,19,100,0.190000
2025-09-23,Uber,19,64,17,100,0.170000
2025-09-23,Ulta Beauty,82,15,3,100,0.030000
2025-09-23,Under Armour,26,66,8,100,0.080000
2025-09-23,Union Pacific,47,50,3,100,0.030000
2025-09-23,United Airlines,66,30,4,100,0.040000
2025-09-23,United Natural Foods,83,15,2,100,0.020000
2025-09-23,United Rentals,96,4,0,100,0.000000
2025-09-23,United States Steel,47,45,8,100,0.080000
2025-09-23,UnitedHealth,47,45,8,100,0.080000
2025-09-23,Universal Corporation,37,55,8,100,0.080000
2025-09-23,Universal Health Services,33,57,10,100,0.100000
2025-09-23,Unum Group,39,54,7,100,0.070000
2025-09-23,Upbound Group,41,57,2,100,0.020000
2025-09-23,Urban Outfitters,38,58,4,100,0.040000
2025-09-23,V2X,47,46,7,100,0.070000
2025-09-23,VF Corporation,22,60,18,100,0.180000
2025-09-23,VICI Properties,38,60,2,100,0.020000
2025-09-23,Vail Resorts,25,56,19,100,0.190000
2025-09-23,Valero Energy,89,10,1,100,0.010000
2025-09-23,Valley National Bancorp,25,70,5,100,0.050000
2025-09-23,Valmont Industries,38,57,5,100,0.050000
2025-09-23,Valvoline Inc,32,63,5,100,0.050000
2025-09-23,Ventas Inc,45,55,0,100,0.000000
2025-09-23,Verisk Analytics,35,54,11,100,0.110000
2025-09-23,Verizon,52,43,5,100,0.050000
2025-09-23,Vertex Pharmaceuticals,42,41,17,100,0.170000
2025-09-23,Vertiv,50,48,2,100,0.020000
2025-09-23,Viasat,33,58,9,100,0.090000
2025-09-23,Viatris,27,57,16,100,0.160000
2025-09-23,Victorias Secret,26,56,18,100,0.180000
2025-09-23,Visa Inc,62,32,6,100,0.060000
2025-09-23,Vishay Intertechnology,30,62,8,100,0.080000
2025-09-23,Vista Outdoor,23,60,17,100,0.170000
2025-09-23,Visteon,43,56,1,100,0.010000
2025-09-23,Vistra,43,51,6,100,0.060000
2025-09-23,Vontier,40,54,6,100,0.060000
2025-09-23,Voya Financial,45,52,3,100,0.030000
2025-09-23,Vulcan Materials,32,57,11,100,0.110000
2025-09-23,WEC Energy,86,14,0,100,0.000000
2025-09-23,WESCO International,37,60,3,100,0.030000
2025-09-23,WEX,38,59,3,100,0.030000
2025-09-23,WR Berkley,40,54,6,100,0.060000
2025-09-23,WW Grainger,38,53,9,100,0.090000
2025-09-23,Wabash National,20,56,24,100,0.240000
2025-09-23,Walmart,31,43,25,99,0.252525
2025-09-23,Walt Disney,31,56,13,100,0.130000
2025-09-23,Warner Bros Discovery,21,68,11,100,0.110000
2025-09-23,Warner Music Group,22,70,8,100,0.080000
2025-09-23,Waters Corporation,44,53,3,100,0.030000
2025-09-23,Watsco,26,62,12,100,0.120000
2025-09-23,Wayfair,33,66,1,100,0.010000
2025-09-23,Webster Financial,28,62,10,100,0.100000
2025-09-23,Weis Markets,26,61,13,100,0.130000
2025-09-23,Wells Fargo,77,16,6,99,0.060606
2025-09-23,Welltower,68,30,2,100,0.020000
2025-09-23,Werner Enterprises,35,53,12,100,0.120000
2025-09-23,West Pharmaceutical Services,43,47,10,100,0.100000
2025-09-23,Western & Southern Financial,31,65,4,100,0.040000
2025-09-23,Western Alliance Bancorp,20,54,19,93,0.204301
2025-09-23,Western Digital,29,65,6,100,0.060000
2025-09-23,Western Midstream Partners,33,63,4,100,0.040000
2025-09-23,Western Union,23,69,8,100,0.080000
2025-09-23,Westinghouse Air Brake Technologies,27,54,4,85,0.047059
2025-09-23,Weyerhaeuser,30,61,9,100,0.090000
2025-09-23,Whirlpool,30,55,15,100,0.150000
2025-09-23,Williams Companies,53,41,6,100,0.060000
2025-09-23,Williams-Sonoma,31,64,5,100,0.050000
2025-09-23,Winnebago Industries,24,61,15,100,0.150000
2025-09-23,Wintrust Financial,36,63,1,100,0.010000
2025-09-23,Woodward Inc,31,67,2,100,0.020000
2025-09-23,Workday,27,63,10,100,0.100000
2025-09-23,World Kinect,33,61,6,100,0.060000
2025-09-23,Worthington Enterprises,32,63,5,100,0.050000
2025-09-23,Wynn Resorts,27,66,7,100,0.070000
2025-09-23,XPO,26,65,9,100,0.090000
2025-09-23,Xcel Energy,80,17,3,100,0.030000
2025-09-23,Xerox,23,62,15,100,0.150000
2025-09-23,Xylem Inc,43,52,5,100,0.050000
2025-09-23,Yum Brands,35,59,6,100,0.060000
2025-09-23,Yum China,43,51,6,100,0.060000
2025-09-23,Zebra Technologies,35,60,5,100,0.050000
2025-09-23,Zimmer Biomet,30,66,4,100,0.040000
2025-09-23,Zions Bancorp,37,52,11,100,0.110000
2025-09-23,Zoetis,51,45,4,100,0.040000
2025-09-23,Zoom Video Communications,29,56,15,100,0.150000
2025-09-23,eXp World,29,66,5,100,0.050000
2025-09-23,iHeartMedia,26,68,6,100,0.060000
2025-09-24,3M,30,65,7,102,0.068627
2025-09-24,A O Smith,27,72,1,100,0.010000
2025-09-24,A-Mark Precious Metals,89,11,0,100,0.000000
2025-09-24,ABM Industries,24,63,13,100,0.130000
2025-09-24,ADT,40,38,22,100,0.220000
2025-09-24,AECOM,44,50,6,100,0.060000
2025-09-24,AES,35,55,10,100,0.100000
2025-09-24,AGCO,34,56,10,100,0.100000
2025-09-24,AGNC Investment,32,54,14,100,0.140000
2025-09-24,AIG,35,62,3,100,0.030000
2025-09-24,AMC Entertainment,82,14,4,100,0.040000
2025-09-24,AMC Networks,28,57,15,100,0.150000
2025-09-24,AMN Healthcare Services,17,66,17,100,0.170000
2025-09-24,APA,32,56,12,100,0.120000
2025-09-24,APi Group,33,60,7,100,0.070000
2025-09-24,ARKO,25,70,5,100,0.050000
2025-09-24,ASGN,24,70,6,100,0.060000
2025-09-24,AT&T,22,63,15,100,0.150000
2025-09-24,ATI Inc,39,57,4,100,0.040000
2025-09-24,AbbVie,38,54,8,100,0.080000
2025-09-24,Abbott Laboratories,62,34,4,100,0.040000
2025-09-24,Abercrombie & Fitch,36,60,4,100,0.040000
2025-09-24,Academy Sports and Outdoors,29,65,6,100,0.060000
2025-09-24,Acadia Healthcare,25,63,12,100,0.120000
2025-09-24,Ace Hardware,24,62,14,100,0.140000
2025-09-24,Acuity Inc,32,41,6,79,0.075949
2025-09-24,Adams Resources & Energy,18,6,1,25,0.040000
2025-09-24,AdaptHealth,36,55,9,100,0.090000
2025-09-24,Adobe,46,49,5,100,0.050000
2025-09-24,Advance Auto Parts,25,62,13,100,0.130000
2025-09-24,Advanced Drainage Systems,77,21,2,100,0.020000
2025-09-24,Advanced Micro Devices,75,24,3,102,0.029412
2025-09-24,Advantage Solutions,73,24,3,100,0.030000
2025-09-24,Aflac,36,45,19,100,0.190000
2025-09-24,Agilent Technologies,45,50,5,100,0.050000
2025-09-24,Agilon Health,23,65,12,100,0.120000
2025-09-24,Air Lease,28,68,4,100,0.040000
2025-09-24,Air Products & Chemicals,23,69,8,100,0.080000
2025-09-24,Airbnb,22,71,7,100,0.070000
2025-09-24,Akamai Technologies,49,43,8,100,0.080000
2025-09-24,Alaska Air,37,60,3,100,0.030000
2025-09-24,Albemarle Corporation,32,56,12,100,0.120000
2025-09-24,Albertsons,36,55,9,100,0.090000
2025-09-24,Alcoa Corporation,22,62,16,100,0.160000
2025-09-24,Alexandria Real Estate Equities,43,51,6,100,0.060000
2025-09-24,Alight Solutions,31,67,2,100,0.020000
2025-09-24,Align Technology,12,71,17,100,0.170000
2025-09-24,Allegiant Travel Company,21,71,8,100,0.080000
2025-09-24,Alliance Resource Partners,33,58,9,100,0.090000
2025-09-24,Alliant Energy,78,21,1,100,0.010000
2025-09-24,Allison Transmission,28,62,10,100,0.100000
2025-09-24,Allstate,62,26,12,100,0.120000
2025-09-24,Ally Financial,35,63,2,100,0.020000
2025-09-24,Alpha Metallurgical Resources,34,54,12,100,0.120000
2025-09-24,Alphabet,23,57,20,100,0.200000
2025-09-24,Altice USA,28,62,10,100,0.100000
2025-09-24,Altria,56,41,3,100,0.030000
2025-09-24,Amazon,42,46,14,102,0.137255
2025-09-24,Ameren,37,51,12,100,0.120000
2025-09-24,American Airlines,31,43,28,102,0.274510
2025-09-24,American Axle & Manufacturing,31,57,12,100,0.120000
2025-09-24,American Eagle Outfitters,31,55,14,100,0.140000
2025-09-24,American Electric Power,47,48,5,100,0.050000
2025-09-24,American Express,45,51,4,100,0.040000
2025-09-24,American Family Insurance,48,46,6,100,0.060000
2025-09-24,American Financial Group,30,61,9,100,0.090000
2025-09-24,American Tower,49,45,6,100,0.060000
2025-09-24,American Water Works,45,52,3,100,0.030000
2025-09-24,Americold Realty Trust,73,23,4,100,0.040000
2025-09-24,Ameriprise Financial,47,46,7,100,0.070000
2025-09-24,Ametek,36,61,3,100,0.030000
2025-09-24,Amgen,41,49,10,100,0.100000
2025-09-24,Amica Mutual Insurance,23,62,4,89,0.044944
2025-09-24,Amkor Technology,40,55,5,100,0.050000
2025-09-24,Amphenol,33,65,2,100,0.020000
2025-09-24,Analog Devices,49,48,3,100,0.030000
2025-09-24,Antero Resources,36,61,3,100,0.030000
2025-09-24,Anywhere Real Estate Inc,36,52,4,92,0.043478
2025-09-24,Apollo Global Management,37,57,6,100,0.060000
2025-09-24,AppLovin,30,63,7,100,0.070000
2025-09-24,Apple,28,51,26,105,0.247619
2025-09-24,Applied Industrial Technologies,27,71,2,100,0.020000
2025-09-24,Applied Materials,20,59,21,100,0.210000
2025-09-24,AptarGroup,31,66,3,100,0.030000
2025-09-24,Aramark,43,54,3,100,0.030000
2025-09-24,ArcBest,24,72,4,100,0.040000
2025-09-24,Arch Resources,60,30,10,100,0.100000
2025-09-24,Archer Daniels Midland,43,49,8,100,0.080000
2025-09-24,Ares Management,41,59,0,100,0.000000
2025-09-24,Arista Networks,40,55,5,100,0.050000
2025-09-24,Arrow Electronics,29,67,4,100,0.040000
2025-09-24,Arthur J Gallagher,36,63,1,100,0.010000
2025-09-24,Asbury Automotive Group,31,60,9,100,0.090000
2025-09-24,Assurant,43,49,8,100,0.080000
2025-09-24,Atkore,21,73,6,100,0.060000
2025-09-24,Atlassian,19,63,18,100,0.180000
2025-09-24,Atmos Energy,86,10,4,100,0.040000
2025-09-24,Auto-Owners Insurance,31,62,7,100,0.070000
2025-09-24,AutoNation,30,58,12,100,0.120000
2025-09-24,AutoZone,26,65,9,100,0.090000
2025-09-24,Autodesk,27,70,3,100,0.030000
2025-09-24,Autoliv,43,52,5,100,0.050000
2025-09-24,Automatic Data Processing,46,47,7,100,0.070000
2025-09-24,AvalonBay Communities,33,60,7,100,0.070000
2025-09-24,Avantor,31,58,11,100,0.110000
2025-09-24,Avery Dennison,24,74,2,100,0.020000
2025-09-24,Avient,30,59,11,100,0.110000
2025-09-24,Avis Budget,17,66,17,100,0.170000
2025-09-24,Avnet,24,69,7,100,0.070000
2025-09-24,BJ's Wholesale Club,31,58,11,100,0.110000
2025-09-24,BOK Financial,39,50,11,100,0.110000
2025-09-24,BWX Technologies,52,46,2,100,0.020000
2025-09-24,Baker Hughes,38,60,2,100,0.020000
2025-09-24,Ball Corporation,33,64,3,100,0.030000
2025-09-24,Bank of America,36,59,5,100,0.050000
2025-09-24,Bank of New York Mellon,51,45,4,100,0.040000
2025-09-24,Bath & Body Works,40,48,12,100,0.120000
2025-09-24,Baxter International,27,65,8,100,0.080000
2025-09-24,Becton Dickinson,49,47,4,100,0.040000
2025-09-24,Belden,31,58,11,100,0.110000
2025-09-24,Benchmark Electronics,24,72,4,100,0.040000
2025-09-24,Berkshire Hathaway,23,61,16,100,0.160000
2025-09-24,Berry Global,24,65,11,100,0.110000
2025-09-24,Best Buy,92,6,2,100,0.020000
2025-09-24,Bio-Rad Laboratories,22,72,6,100,0.060000
2025-09-24,Biogen,29,55,12,96,0.125000
2025-09-24,BlackRock,27,67,5,99,0.050505
2025-09-24,Blackstone,43,50,7,100,0.070000
2025-09-24,Bloomin Brands,11,75,14,100,0.140000
2025-09-24,BlueLinx,23,73,4,100,0.040000
2025-09-24,Boeing,29,61,9,99,0.090909
2025-09-24,Boise Cascade,16,73,11,100,0.110000
2025-09-24,Booking Holdings,37,53,10,100,0.100000
2025-09-24,Booz Allen Hamilton,29,58,13,100,0.130000
2025-09-24,BorgWarner,53,42,5,100,0.050000
2025-09-24,Boston Properties,20,77,3,100,0.030000
2025-09-24,Boston Scientific,41,51,8,100,0.080000
2025-09-24,Boyd Gaming,24,69,7,100,0.070000
2025-09-24,Bread Financial,51,47,2,100,0.020000
2025-09-24,BrightSpring Health Services,30,62,8,100,0.080000
2025-09-24,BrightView Holdings,34,62,4,100,0.040000
2025-09-24,Brighthouse Financial,39,57,4,100,0.040000
2025-09-24,Brinker International,49,49,2,100,0.020000
2025-09-24,Brinks Company,15,5,3,23,0.130435
2025-09-24,Bristol-Myers Squibb,26,63,13,102,0.127451
2025-09-24,Broadcom,39,57,6,102,0.058824
2025-09-24,Broadridge Financial Solutions,58,41,1,100,0.010000
2025-09-24,Brookdale Senior Living,32,58,10,100,0.100000
2025-09-24,Brown & Brown,30,58,12,100,0.120000
2025-09-24,Brown-Forman,16,71,13,100,0.130000
2025-09-24,Bruker,14,70,16,100,0.160000
2025-09-24,Brunswick Corporation,46,44,10,100,0.100000
2025-09-24,Builders FirstSource,39,54,7,100,0.070000
2025-09-24,Burlington Stores,35,63,2,100,0.020000
2025-09-24,CACI International,54,43,3,100,0.030000
2025-09-24,CBRE Group,31,68,1,100,0.010000
2025-09-24,CDW,39,56,5,100,0.050000
2025-09-24,CF Industries,40,54,6,100,0.060000
2025-09-24,CH Robinson Worldwide,39,56,5,100,0.050000
2025-09-24,CHS,45,49,6,100,0.060000
2025-09-24,CIncinnati Financial,36,57,7,100,0.070000
2025-09-24,CME Group,21,74,5,100,0.050000
2025-09-24,CMS Energy,87,11,2,100,0.020000
2025-09-24,CNO Financial Group,31,65,4,100,0.040000
2025-09-24,CNX Resources,44,53,3,100,0.030000
2025-09-24,CSX,32,62,6,100,0.060000
2025-09-24,CVS Health,48,49,3,100,0.030000
2025-09-24,Cabot Corporation,35,60,5,100,0.050000
2025-09-24,Cadence,24,60,16,100,0.160000
2025-09-24,Caesars Entertainment,71,24,5,100,0.050000
2025-09-24,Cal-Maine Foods,53,43,4,100,0.040000
2025-09-24,Caleres Inc,31,63,6,100,0.060000
2025-09-24,California Resources,40,51,9,100,0.090000
2025-09-24,Calumet Inc,33,51,9,93,0.096774
2025-09-24,Campbell Soup,32,56,12,100,0.120000
2025-09-24,Camping World,25,65,10,100,0.100000
2025-09-24,Capital One,40,51,9,100,0.090000
2025-09-24,CarMax,17,72,11,100,0.110000
2025-09-24,Cardinal Health,37,55,8,100,0.080000
2025-09-24,Carlisle Companies,32,62,6,100,0.060000
2025-09-24,Carlyle Group,32,64,4,100,0.040000
2025-09-24,Carpenter Technology,35,60,5,100,0.050000
2025-09-24,Carrier Global,30,58,12,100,0.120000
2025-09-24,Carters Inc,18,29,2,49,0.040816
2025-09-24,Carvana,38,56,6,100,0.060000
2025-09-24,Caseys General Stores,29,62,9,100,0.090000
2025-09-24,Catalent,21,70,9,100,0.090000
2025-09-24,Caterpillar,28,66,6,100,0.060000
2025-09-24,Cboe Global Markets,32,67,1,100,0.010000
2025-09-24,Celanese,30,43,27,100,0.270000
2025-09-24,Cencora,58,39,3,100,0.030000
2025-09-24,Centene,28,49,23,100,0.230000
2025-09-24,CenterPoint Energy,70,22,8,100,0.080000
2025-09-24,Central Garden & Pet,24,72,4,100,0.040000
2025-09-24,Century Communities,32,64,4,100,0.040000
2025-09-24,ChampionX,36,62,2,100,0.020000
2025-09-24,Charles River Laboratories International,26,62,12,100,0.120000
2025-09-24,Charles Schwab,39,57,4,100,0.040000
2025-09-24,Chart Industries,36,61,3,100,0.030000
2025-09-24,Charter Communications,25,59,16,100,0.160000
2025-09-24,Cheesecake Factory,25,61,14,100,0.140000
2025-09-24,Chefs Warehouse,45,49,6,100,0.060000
2025-09-24,Chemours,30,53,17,100,0.170000
2025-09-24,Cheniere Energy,88,12,0,100,0.000000
2025-09-24,Chevron,34,47,19,100,0.190000
2025-09-24,Chewy,40,51,9,100,0.090000
2025-09-24,Chipotle Mexican Grill,32,60,8,100,0.080000
2025-09-24,Chord Energy,93,7,0,100,0.000000
2025-09-24,Church & Dwight,33,57,10,100,0.100000
2025-09-24,Ciena,42,53,5,100,0.050000
2025-09-24,Cigna,38,49,13,100,0.130000
2025-09-24,Cinemark,31,58,11,100,0.110000
2025-09-24,Cintas,35,62,3,100,0.030000
2025-09-24,Cisco Systems,32,63,5,100,0.050000
2025-09-24,Citigroup,38,59,3,100,0.030000
2025-09-24,Citizens Financial Group,40,57,3,100,0.030000
2025-09-24,Civitas Resources,32,50,18,100,0.180000
2025-09-24,Clean Harbors,74,16,10,100,0.100000
2025-09-24,Clear Channel Outdoor Hldgs,9,2,0,11,0.000000
2025-09-24,Cleveland-Cliffs,21,66,13,100,0.130000
2025-09-24,Clorox,38,48,14,100,0.140000
2025-09-24,Cognizant Technology Solutions,33,61,6,100,0.060000
2025-09-24,Coherent,31,68,1,100,0.010000
2025-09-24,Coinbase Global,18,70,12,100,0.120000
2025-09-24,Colgate-Palmolive,37,53,10,100,0.100000
2025-09-24,Columbia Banking System,37,60,3,100,0.030000
2025-09-24,Columbia Sportswear,29,56,15,100,0.150000
2025-09-24,Comcast,37,43,20,100,0.200000
2025-09-24,Comerica,48,41,11,100,0.110000
2025-09-24,Comfort Systems USA,94,6,0,100,0.000000
2025-09-24,CommScope,23,74,3,100,0.030000
2025-09-24,Commercial Metals,28,64,8,100,0.080000
2025-09-24,Community Health Systems,26,58,16,100,0.160000
2025-09-24,Compass Group,36,48,16,100,0.160000
2025-09-24,Conagra Brands,37,54,9,100,0.090000
2025-09-24,Concentrix,30,64,6,100,0.060000
2025-09-24,Conduent,31,57,12,100,0.120000
2025-09-24,ConocoPhillips,45,44,11,100,0.110000
2025-09-24,Consol Energy,79,17,4,100,0.040000
2025-09-24,Consolidated Edison,38,56,6,100,0.060000
2025-09-24,Constellation Brands,19,55,26,100,0.260000
2025-09-24,Constellation Energy,81,18,1,100,0.010000
2025-09-24,Continental Resources,40,48,12,100,0.120000
2025-09-24,Cooper Cos,3,24,4,31,0.129032
2025-09-24,Cooper-Standard,33,62,5,100,0.050000
2025-09-24,Copart,43,54,3,100,0.030000
2025-09-24,Core & Main,32,54,14,100,0.140000
2025-09-24,Corebridge Financial,44,52,4,100,0.040000
2025-09-24,Cornerstone Building Brands,28,61,11,100,0.110000
2025-09-24,Corning,39,52,9,100,0.090000
2025-09-24,Corpay,35,63,2,100,0.020000
2025-09-24,Corteva,32,62,6,100,0.060000
2025-09-24,Costco,28,60,12,100,0.120000
2025-09-24,Coterra Energy,80,17,3,100,0.030000
2025-09-24,Coty,24,61,15,100,0.150000
2025-09-24,Country Financial,25,57,18,100,0.180000
2025-09-24,Coupang,33,57,10,100,0.100000
2025-09-24,Cracker Barrel Old Country Store,16,67,17,100,0.170000
2025-09-24,Crocs,29,61,10,100,0.100000
2025-09-24,CrossAmerica Partners,26,71,3,100,0.030000
2025-09-24,CrowdStrike,39,45,16,100,0.160000
2025-09-24,Crown Castle,37,60,3,100,0.030000
2025-09-24,Crown Holdings,34,61,5,100,0.050000
2025-09-24,Cullen Frost Bankers,43,52,5,100,0.050000
2025-09-24,Cummins Inc,59,39,2,100,0.020000
2025-09-24,Curtiss-Wright,50,48,2,100,0.020000
2025-09-24,DR Horton,23,70,7,100,0.070000
2025-09-24,DTE Energy,73,20,7,100,0.070000
2025-09-24,DXC Technology,27,70,3,100,0.030000
2025-09-24,DaVita,30,50,20,100,0.200000
2025-09-24,Dana Incorporated,36,58,6,100,0.060000
2025-09-24,Danaher,57,39,4,100,0.040000
2025-09-24,Darden Restaurants,36,52,12,100,0.120000
2025-09-24,Darling Ingredients,89,8,3,100,0.030000
2025-09-24,Deckers Outdoor,40,48,12,100,0.120000
2025-09-24,Deere,30,61,9,100,0.090000
2025-09-24,Delek US,41,51,8,100,0.080000
2025-09-24,Dell Technologies,37,61,2,100,0.020000
2025-09-24,Delta Air Lines,19,62,19,100,0.190000
2025-09-24,Dentsply Sirona,30,67,3,100,0.030000
2025-09-24,Designer Brands,20,69,11,100,0.110000
2025-09-24,Devon Energy,92,7,1,100,0.010000
2025-09-24,DexCom,25,63,12,100,0.120000
2025-09-24,Diamondback Energy,86,13,1,100,0.010000
2025-09-24,Dicks Sporting Goods,28,66,6,100,0.060000
2025-09-24,Diebold Nixdorf,35,65,0,100,0.000000
2025-09-24,Digital Realty Trust,86,14,0,100,0.000000
2025-09-24,Dillards,29,57,14,100,0.140000
2025-09-24,Discover Financial,35,56,9,100,0.090000
2025-09-24,DocuSign,41,48,11,100,0.110000
2025-09-24,Dollar General,18,59,23,100,0.230000
2025-09-24,Dollar Tree,37,55,8,100,0.080000
2025-09-24,Dominion Energy,70,24,6,100,0.060000
2025-09-24,Dominos Pizza Inc,17,28,2,47,0.042553
2025-09-24,Domtar,25,64,11,100,0.110000
2025-09-24,Donaldson Company,44,50,6,100,0.060000
2025-09-24,DoorDash,40,42,11,93,0.118280
2025-09-24,Dover Corporation,45,54,1,100,0.010000
2025-09-24,DraftKings,58,40,4,102,0.039216
2025-09-24,Dream Finders Homes,84,14,2,100,0.020000
2025-09-24,Dropbox,27,70,3,100,0.030000
2025-09-24,DuPont,28,62,10,100,0.100000
2025-09-24,Duke Energy,86,11,3,100,0.030000
2025-09-24,Dycom Industries,32,65,3,100,0.030000
2025-09-24,EMCOR Group,28,69,3,100,0.030000
2025-09-24,EOG Resources,47,47,6,100,0.060000
2025-09-24,EPAM Systems,33,64,3,100,0.030000
2025-09-24,EQT,37,56,7,100,0.070000
2025-09-24,ESAB,32,64,4,100,0.040000
2025-09-24,East West Bancorp,43,51,6,100,0.060000
2025-09-24,Eastman Chemical,29,51,20,100,0.200000
2025-09-24,Ebay,33,58,9,100,0.090000
2025-09-24,EchoStar,18,73,9,100,0.090000
2025-09-24,Ecolab,41,56,3,100,0.030000
2025-09-24,Edison International,32,55,13,100,0.130000
2025-09-24,Edward Jones,31,59,10,100,0.100000
2025-09-24,Edwards Lifesciences,50,34,16,100,0.160000
2025-09-24,Elanco Animal Health,39,59,2,100,0.020000
2025-09-24,Electronic Arts,23,66,11,100,0.110000
2025-09-24,Elevance Health,38,45,17,100,0.170000
2025-09-24,Eli Lilly,18,73,10,101,0.099010
2025-09-24,Emerson Electric,48,48,4,100,0.040000
2025-09-24,EnLink Midstream,42,51,7,100,0.070000
2025-09-24,Encompass Health,28,64,8,100,0.080000
2025-09-24,Endeavor Group,18,73,9,100,0.090000
2025-09-24,Endeavor Group Holdings,19,71,10,100,0.100000
2025-09-24,EnerSys,39,53,8,100,0.080000
2025-09-24,Energizer Holdings,87,13,0,100,0.000000
2025-09-24,Energy Transfer,85,12,3,100,0.030000
2025-09-24,Ensign Group,44,54,2,100,0.020000
2025-09-24,Entegris,36,56,8,100,0.080000
2025-09-24,Entergy,47,47,6,100,0.060000
2025-09-24,Enterprise Products Partners,46,42,12,100,0.120000
2025-09-24,Envista,23,69,8,100,0.080000
2025-09-24,Equifax,46,46,8,100,0.080000
2025-09-24,Equinix,47,51,2,100,0.020000
2025-09-24,Equitable Holdings,38,56,6,100,0.060000
2025-09-24,Equity Residential,32,62,6,100,0.060000
2025-09-24,Erie Insurance,30,55,15,100,0.150000
2025-09-24,Estée Lauder,36,51,13,100,0.130000
2025-09-24,Etsy,22,52,26,100,0.260000
2025-09-24,Euronet Worldwide,30,63,7,100,0.070000
2025-09-24,Evergy,47,46,7,100,0.070000
2025-09-24,Eversource Energy,73,21,6,100,0.060000
2025-09-24,Exact Sciences,27,50,23,100,0.230000
2025-09-24,Exelon,41,54,5,100,0.050000
2025-09-24,Expand Energy Corporation,95,5,0,100,0.000000
2025-09-24,Expedia,47,48,5,100,0.050000
2025-09-24,Expeditors International of Washington,31,62,7,100,0.070000
2025-09-24,Extra Space Storage,23,66,11,100,0.110000
2025-09-24,Exxon Mobil,53,42,5,100,0.050000
2025-09-24,F5,40,55,5,100,0.050000
2025-09-24,FM Global,35,47,18,100,0.180000
2025-09-24,FMC Corporation,35,50,15,100,0.150000
2025-09-24,FTI Consulting,29,58,13,100,0.130000
2025-09-24,Fannie Mae,18,72,10,100,0.100000
2025-09-24,Farmers Insurance Exchange,19,62,19,100,0.190000
2025-09-24,Fastenal,65,33,2,100,0.020000
2025-09-24,FedEx,37,52,13,102,0.127451
2025-09-24,Federated Mutual Insurance,19,22,6,47,0.127660
2025-09-24,Ferguson Enterprises,40,54,6,100,0.060000
2025-09-24,Fidelity National Financial,38,56,6,100,0.060000
2025-09-24,Fidelity National Information Services,52,39,9,100,0.090000
2025-09-24,Fifth Third Bancorp,48,42,10,100,0.100000
2025-09-24,First American Financial,31,61,8,100,0.080000
2025-09-24,First Citizens BancShares,39,56,5,100,0.050000
2025-09-24,First Horizon,46,53,1,100,0.010000
2025-09-24,First National of Nebraska,18,33,1,52,0.019231
2025-09-24,First Solar,37,59,4,100,0.040000
2025-09-24,FirstCash,32,58,10,100,0.100000
2025-09-24,FirstEnergy,45,42,13,100,0.130000
2025-09-24,Fiserv,38,60,2,100,0.020000
2025-09-24,Five Below,32,58,10,100,0.100000
2025-09-24,Flagstar Financial,29,58,13,100,0.130000
2025-09-24,Floor & Decor,33,59,8,100,0.080000
2025-09-24,Flowers Foods,22,62,16,100,0.160000
2025-09-24,Flowserve,23,73,4,100,0.040000
2025-09-24,Fluor,40,45,15,100,0.150000
2025-09-24,Foot Locker,11,74,15,100,0.150000
2025-09-24,Ford Motor,22,65,15,102,0.147059
2025-09-24,Fortinet,32,42,26,100,0.260000
2025-09-24,Fortive,26,62,12,100,0.120000
2025-09-24,Fortune Brands Innovations,29,66,5,100,0.050000
2025-09-24,Franklin Resources,39,52,9,100,0.090000
2025-09-24,Freddie Mac,21,66,13,100,0.130000
2025-09-24,Freeport-McMoRan,30,49,13,92,0.141304
2025-09-24,Frontier Airlines,28,61,11,100,0.110000
2025-09-24,Frontier Communications,41,52,7,100,0.070000
2025-09-24,G-III Apparel Group,31,62,7,100,0.070000
2025-09-24,GE HealthCare Technologies,33,64,3,100,0.030000
2025-09-24,GE Vernova,51,44,5,100,0.050000
2025-09-24,GMS,26,69,5,100,0.050000
2025-09-24,GXO Logistics,35,58,7,100,0.070000
2025-09-24,GameStop,26,62,12,100,0.120000
2025-09-24,Gannett,28,62,10,100,0.100000
2025-09-24,Garrett Motion Inc,36,59,5,100,0.050000
2025-09-24,Gartner,23,66,11,100,0.110000
2025-09-24,Gen Digital,47,50,3,100,0.030000
2025-09-24,Generac,30,63,7,100,0.070000
2025-09-24,General Dynamics,92,8,0,100,0.000000
2025-09-24,General Mills,40,56,4,100,0.040000
2025-09-24,General Motors,40,53,7,100,0.070000
2025-09-24,Genesis Energy,75,22,3,100,0.030000
2025-09-24,Genuine Parts,37,62,1,100,0.010000
2025-09-24,Genworth Financial,50,46,4,100,0.040000
2025-09-24,Gilead Sciences,43,54,3,100,0.030000
2025-09-24,Global Partners,40,48,12,100,0.120000
2025-09-24,Global Payments,34,64,2,100,0.020000
2025-09-24,Globe Life,33,59,8,100,0.080000
2025-09-24,GoDaddy,38,56,6,100,0.060000
2025-09-24,Goldman Sachs,30,63,8,101,0.079208
2025-09-24,Goodyear Tire & Rubber,23,68,9,100,0.090000
2025-09-24,Graham Holdings Company,28,68,4,100,0.040000
2025-09-24,Granite Construction,42,55,3,100,0.030000
2025-09-24,Graphic Packaging,15,66,19,100,0.190000
2025-09-24,Gray Television,25,62,13,100,0.130000
2025-09-24,Graybar Electric,16,28,5,49,0.102041
2025-09-24,Green Plains Inc,36,52,12,100,0.120000
2025-09-24,Greif,22,75,3,100,0.030000
2025-09-24,Griffon Corporation,36,58,6,100,0.060000
2025-09-24,Grocery Outlet Holding,29,63,8,100,0.080000
2025-09-24,Group 1 Automotive,29,65,6,100,0.060000
2025-09-24,Guardian Life insurance,49,49,2,100,0.020000
2025-09-24,Guess Inc,30,65,5,100,0.050000
2025-09-24,GuideWell Mutual,19,25,1,45,0.022222
2025-09-24,HB Fuller,21,75,4,100,0.040000
2025-09-24,HCA Healthcare,43,53,4,100,0.040000
2025-09-24,HEICO,28,65,7,100,0.070000
2025-09-24,HF SInclair,30,58,12,100,0.120000
2025-09-24,HP,29,63,8,100,0.080000
2025-09-24,Halliburton,15,63,22,100,0.220000
2025-09-24,Hanesbrands,27,70,3,100,0.030000
2025-09-24,Hanover Insurance Group,35,52,13,100,0.130000
2025-09-24,Harley-Davidson,19,69,12,100,0.120000
2025-09-24,Hasbro,32,56,12,100,0.120000
2025-09-24,Hawaiian Airlines Inc,35,63,2,100,0.020000
2025-09-24,Hawaiian Electric Industries,28,65,7,100,0.070000
2025-09-24,Helmerich & Payne,23,64,13,100,0.130000
2025-09-24,Henry Schein,24,72,4,100,0.040000
2025-09-24,Herc Rentals,35,55,10,100,0.100000
2025-09-24,Hershey,39,53,8,100,0.080000
2025-09-24,Hertz,28,53,19,100,0.190000
2025-09-24,Hewlett Packard Enterprise,27,71,2,100,0.020000
2025-09-24,Hillenbrand,22,67,11,100,0.110000
2025-09-24,Hilton Grand Vacations,89,11,0,100,0.000000
2025-09-24,Hilton Worldwide,51,46,3,100,0.030000
2025-09-24,Hologic,28,67,5,100,0.050000
2025-09-24,Home Depot,47,44,9,100,0.090000
2025-09-24,Honeywell,43,42,15,100,0.150000
2025-09-24,Hormel Foods,30,63,7,100,0.070000
2025-09-24,Host Hotels & Resorts,22,75,3,100,0.030000
2025-09-24,Hovnanian Enterprises,34,58,8,100,0.080000
2025-09-24,Howmet Aerospace,39,57,4,100,0.040000
2025-09-24,Hub Group,25,63,12,100,0.120000
2025-09-24,Hubbell,20,68,12,100,0.120000
2025-09-24,Humana,51,39,10,100,0.100000
2025-09-24,Huntington Bancshares,34,64,2,100,0.020000
2025-09-24,Huntington Ingalls Industries,41,49,10,100,0.100000
2025-09-24,Huntsman,13,59,28,100,0.280000
2025-09-24,Hyatt Hotels,38,58,4,100,0.040000
2025-09-24,Hyster-Yale,24,71,5,100,0.050000
2025-09-24,IAC,28,62,10,100,0.100000
2025-09-24,IBM,44,47,9,100,0.090000
2025-09-24,IDEX,33,59,8,100,0.080000
2025-09-24,IDEXX Laboratories,53,44,3,100,0.030000
2025-09-24,IQVIA,54,40,6,100,0.060000
2025-09-24,ITT,43,51,6,100,0.060000
2025-09-24,Icahn Enterprises,26,58,16,100,0.160000
2025-09-24,Illinois Tool Works,43,52,5,100,0.050000
2025-09-24,Illumina Inc,23,67,10,100,0.100000
2025-09-24,Incyte,39,57,4,100,0.040000
2025-09-24,Ingersoll Rand,34,59,7,100,0.070000
2025-09-24,Ingles Markets,27,48,25,100,0.250000
2025-09-24,Ingram Micro,22,45,33,100,0.330000
2025-09-24,Ingredion,46,48,6,100,0.060000
2025-09-24,Insight Enterprises,30,59,11,100,0.110000
2025-09-24,Insperity,35,54,11,100,0.110000
2025-09-24,Instacart,27,65,8,100,0.080000
2025-09-24,Installed Building Products,25,68,7,100,0.070000
2025-09-24,Intel,27,62,15,104,0.144231
2025-09-24,Interactive Brokers,39,54,7,100,0.070000
2025-09-24,Intercontinental Exchange,37,61,2,100,0.020000
2025-09-24,International Flavors & Fragrances,33,60,7,100,0.070000
2025-09-24,International Paper,21,73,6,100,0.060000
2025-09-24,Interpublic Group,36,58,6,100,0.060000
2025-09-24,Intuit,51,46,3,100,0.030000
2025-09-24,Iron Mountain,26,64,10,100,0.100000
2025-09-24,JB Hunt Transport Services,24,65,11,100,0.110000
2025-09-24,JELD-WEN Holding,26,64,10,100,0.100000
2025-09-24,JM Smucker,38,55,7,100,0.070000
2025-09-24,JPMorgan Chase,34,59,9,102,0.088235
2025-09-24,Jabil,27,71,2,100,0.020000
2025-09-24,Jackson Financial,40,55,5,100,0.050000
2025-09-24,Jacobs Solutions,53,45,2,100,0.020000
2025-09-24,Jefferies Financial,36,59,5,100,0.050000
2025-09-24,JetBlue Airways,28,55,17,100,0.170000
2025-09-24,Johnson & Johnson,41,49,10,100,0.100000
2025-09-24,Juniper Networks,30,64,6,100,0.060000
2025-09-24,KB Home,28,61,11,100,0.110000
2025-09-24,KBR,49,46,5,100,0.050000
2025-09-24,KKR & Co,60,36,4,100,0.040000
2025-09-24,KLA,28,53,19,100,0.190000
2025-09-24,Kaiser Aluminum,28,66,6,100,0.060000
2025-09-24,Kellanova,38,52,10,100,0.100000
2025-09-24,Kelly Services Inc,26,66,8,100,0.080000
2025-09-24,Kemper Corporation,36,58,6,100,0.060000
2025-09-24,Kenvue,11,65,24,100,0.240000
2025-09-24,Keurig Dr Pepper,14,69,17,100,0.170000
2025-09-24,KeyCorp,34,59,7,100,0.070000
2025-09-24,Keysight Technologies,37,59,4,100,0.040000
2025-09-24,Kimberly-Clark,37,54,9,100,0.090000
2025-09-24,Kinder Morgan,93,4,3,100,0.030000
2025-09-24,Kirby Corporation,26,67,7,100,0.070000
2025-09-24,Knife River Corporation,25,52,5,82,0.060976
2025-09-24,Knight Swift Transportation,29,63,8,100,0.080000
2025-09-24,Kohl's,32,54,14,100,0.140000
2025-09-24,Kontoor Brands,33,63,4,100,0.040000
2025-09-24,Korn Ferry,52,40,8,100,0.080000
2025-09-24,Kraft Heinz,32,54,14,100,0.140000
2025-09-24,Kroger,27,46,19,92,0.206522
2025-09-24,Kyndryl,31,65,4,100,0.040000
2025-09-24,L3Harris Technologies,31,62,7,100,0.070000
2025-09-24,LCI Industries,35,60,5,100,0.050000
2025-09-24,LKQ,28,65,7,100,0.070000
2025-09-24,LPL Financial,61,37,2,100,0.020000
2025-09-24,Labcorp Holdings,45,51,4,100,0.040000
2025-09-24,Lam Research,44,51,5,100,0.050000
2025-09-24,Lamb Weston,24,68,8,100,0.080000
2025-09-24,Land O'Lakes,29,60,11,100,0.110000
2025-09-24,Landstar System,25,52,23,100,0.230000
2025-09-24,Las Vegas Sands,33,60,7,100,0.070000
2025-09-24,Lear Corporation,32,56,12,100,0.120000
2025-09-24,Leggett & Platt,23,69,8,100,0.080000
2025-09-24,Leidos,40,55,5,100,0.050000
2025-09-24,Lennar,13,67,20,100,0.200000
2025-09-24,Lennox International,32,60,8,100,0.080000
2025-09-24,Levi Strauss,26,72,2,100,0.020000
2025-09-24,Liberty Energy,91,9,0,100,0.000000
2025-09-24,Liberty Media,94,4,2,100,0.020000
2025-09-24,Liberty Mutual Insurance,79,14,7,100,0.070000
2025-09-24,Light & Wonder,25,61,14,100,0.140000
2025-09-24,Lincoln Electric,36,60,4,100,0.040000
2025-09-24,Lincoln National,29,56,15,100,0.150000
2025-09-24,Lithia Motors,39,58,3,100,0.030000
2025-09-24,Live Nation Entertainment,35,42,23,100,0.230000
2025-09-24,Lockheed Martin,36,52,12,100,0.120000
2025-09-24,Loews,39,58,3,100,0.030000
2025-09-24,Louisiana-Pacific Corporation,34,61,5,100,0.050000
2025-09-24,Lowe's,32,45,23,100,0.230000
2025-09-24,Lululemon athletica,20,59,21,100,0.210000
2025-09-24,Lumen Technologies,24,69,7,100,0.070000
2025-09-24,Lyft,17,65,18,100,0.180000
2025-09-24,M&T Bank,26,62,12,100,0.120000
2025-09-24,M/I Homes,24,69,7,100,0.070000
2025-09-24,MDU Resources Group,37,57,6,100,0.060000
2025-09-24,MGM Resorts International,28,63,9,100,0.090000
2025-09-24,MKS Instruments,42,48,10,100,0.100000
2025-09-24,MRC Global,39,58,3,100,0.030000
2025-09-24,MSC Industrial Direct,22,70,8,100,0.080000
2025-09-24,MSCI,32,62,6,100,0.060000
2025-09-24,MYR Group,28,62,10,100,0.100000
2025-09-24,Macys,26,67,7,100,0.070000
2025-09-24,ManpowerGroup,26,62,12,100,0.120000
2025-09-24,Marathon Oil,22,64,14,100,0.140000
2025-09-24,Marathon Petroleum,41,54,5,100,0.050000
2025-09-24,Markel Group,41,54,5,100,0.050000
2025-09-24,Marriott International,37,60,3,100,0.030000
2025-09-24,Marriott Vacations Worldwide,35,54,11,100,0.110000
2025-09-24,Marsh & McLennan,50,43,7,100,0.070000
2025-09-24,Martin Marietta Materials,29,56,15,100,0.150000
2025-09-24,Marvell Technology,37,55,8,100,0.080000
2025-09-24,MasTec,41,57,2,100,0.020000
2025-09-24,Masco,30,60,10,100,0.100000
2025-09-24,Mass Mutual,26,61,4,91,0.043956
2025-09-24,MasterBrand,34,64,2,100,0.020000
2025-09-24,Mastercard,39,57,4,100,0.040000
2025-09-24,Matador Resources,31,60,9,100,0.090000
2025-09-24,Match Group,21,56,23,100,0.230000
2025-09-24,Mativ,27,67,6,100,0.060000
2025-09-24,Matson Inc,35,56,9,100,0.090000
2025-09-24,Mattel,33,55,12,100,0.120000
2025-09-24,Maximus,24,69,7,100,0.070000
2025-09-24,McCormick & Company,45,45,10,100,0.100000
2025-09-24,McDonalds,24,61,15,100,0.150000
2025-09-24,McKesson,43,54,3,100,0.030000
2025-09-24,Medical Mutual of Ohio,26,63,11,100,0.110000
2025-09-24,Merck,41,52,7,100,0.070000
2025-09-24,Mercury General,27,56,17,100,0.170000
2025-09-24,Meritage Homes,27,64,9,100,0.090000
2025-09-24,MetLife,37,56,7,100,0.070000
2025-09-24,Meta Platforms,46,49,9,104,0.086538
2025-09-24,Mettler-Toledo International,31,66,3,100,0.030000
2025-09-24,Microchip Technology,45,50,5,100,0.050000
2025-09-24,Micron Technology,31,61,8,100,0.080000
2025-09-24,Microsoft,31,61,8,100,0.080000
2025-09-24,Middleby,21,76,3,100,0.030000
2025-09-24,MillerKnoll,31,64,5,100,0.050000
2025-09-24,Moderna,37,45,18,100,0.180000
2025-09-24,ModivCare,30,51,19,100,0.190000
2025-09-24,Mohawk Industries,34,59,7,100,0.070000
2025-09-24,Molina Healthcare,34,53,13,100,0.130000
2025-09-24,Molson Coors Beverage,20,62,10,92,0.108696
2025-09-24,Mondelez,35,54,11,100,0.110000
2025-09-24,Monster Beverage,38,55,7,100,0.070000
2025-09-24,Moodys Corporation,4,12,3,19,0.157895
2025-09-24,Moog Inc,37,57,6,100,0.060000
2025-09-24,Morgan Stanley,18,71,3,92,0.032609
2025-09-24,Motorola Solutions,50,47,3,100,0.030000
2025-09-24,Mueller Industries,45,50,5,100,0.050000
2025-09-24,Murphy Oil,27,68,5,100,0.050000
2025-09-24,Murphy USA,32,59,9,100,0.090000
2025-09-24,Mutual of Omaha,46,48,6,100,0.060000
2025-09-24,NCR Atleos,37,59,4,100,0.040000
2025-09-24,NCR Voyix,29,61,10,100,0.100000
2025-09-24,NGL Energy Partners,84,13,3,100,0.030000
2025-09-24,NLV Financial,3,5,1,9,0.111111
2025-09-24,NOV,25,60,15,100,0.150000
2025-09-24,NRG Energy,74,23,3,100,0.030000
2025-09-24,NVR Inc,39,55,6,100,0.060000
2025-09-24,Nasdaq Inc,40,59,1,100,0.010000
2025-09-24,Nationwide Insurance,18,61,21,100,0.210000
2025-09-24,Navient,40,46,14,100,0.140000
2025-09-24,NetApp,31,66,3,100,0.030000
2025-09-24,Netflix,28,51,21,100,0.210000
2025-09-24,NeueHealth,58,40,2,100,0.020000
2025-09-24,New York Life Insurance,34,59,7,100,0.070000
2025-09-24,NewMarket Corporation,33,43,3,79,0.037975
2025-09-24,Newell Brands,28,61,11,100,0.110000
2025-09-24,Newmont,22,71,7,100,0.070000
2025-09-24,News Corp,23,69,10,102,0.098039
2025-09-24,Nexstar Media Group,18,69,13,100,0.130000
2025-09-24,NextEra Energy,85,13,2,100,0.020000
2025-09-24,NiSource,45,48,7,100,0.070000
2025-09-24,Nike,26,67,7,100,0.070000
2025-09-24,Nordson,39,59,2,100,0.020000
2025-09-24,Nordstrom,29,63,8,100,0.080000
2025-09-24,Norfolk Southern,36,57,7,100,0.070000
2025-09-24,Northern Trust,93,6,1,100,0.010000
2025-09-24,Northrop Grumman,31,63,6,100,0.060000
2025-09-24,Northwestern Mutual,32,51,17,100,0.170000
2025-09-24,Nucor,29,55,16,100,0.160000
2025-09-24,Nvidia,27,58,14,99,0.141414
2025-09-24,O'Reilly Automotive,66,32,2,100,0.020000
2025-09-24,O-I Glass,41,47,12,100,0.120000
2025-09-24,ODP Business Solutions,18,56,2,76,0.026316
2025-09-24,OGE Energy,91,8,1,100,0.010000
2025-09-24,ON Semiconductor,27,63,10,100,0.100000
2025-09-24,Occidental Petroleum,33,55,12,100,0.120000
2025-09-24,Old Dominion Freight Line,37,44,19,100,0.190000
2025-09-24,Old National Bancorp,29,71,0,100,0.000000
2025-09-24,Old Republic International,50,48,2,100,0.020000
2025-09-24,Olin,21,60,19,100,0.190000
2025-09-24,Omnicom Group,37,54,9,100,0.090000
2025-09-24,OneMain,45,51,4,100,0.040000
2025-09-24,Oneok,46,51,3,100,0.030000
2025-09-24,Opendoor Technologies,22,50,28,100,0.280000
2025-09-24,Option Care Health,94,6,0,100,0.000000
2025-09-24,Oracle,25,67,8,100,0.080000
2025-09-24,Organon,28,60,12,100,0.120000
2025-09-24,Oscar Health,26,64,10,100,0.100000
2025-09-24,Oshkosh Corporation,40,51,9,100,0.090000
2025-09-24,Otis Worldwide,39,51,10,100,0.100000
2025-09-24,Ovintiv,44,50,6,100,0.060000
2025-09-24,Owens & Minor,28,56,16,100,0.160000
2025-09-24,Owens Corning,24,73,3,100,0.030000
2025-09-24,PACS Group,28,39,11,78,0.141026
2025-09-24,PBF Energy,80,18,2,100,0.020000
2025-09-24,PC Connection Inc,46,42,4,92,0.043478
2025-09-24,PENN Entertainment,88,11,1,100,0.010000
2025-09-24,PG&E,43,39,18,100,0.180000
2025-09-24,PNC Financial Services,39,55,6,100,0.060000
2025-09-24,PPG Industries,40,57,3,100,0.030000
2025-09-24,PPL Corporation,41,57,2,100,0.020000
2025-09-24,PVH,34,52,14,100,0.140000
2025-09-24,Paccar,38,54,8,100,0.080000
2025-09-24,Pacific Life,38,58,4,100,0.040000
2025-09-24,Packaging Corp of America,15,76,9,100,0.090000
2025-09-24,Palo Alto Networks,36,50,14,100,0.140000
2025-09-24,Par Pacific,34,62,4,100,0.040000
2025-09-24,Paramount Global,26,64,10,100,0.100000
2025-09-24,Park Hotels & Resorts,26,66,8,100,0.080000
2025-09-24,Parker-Hannifin,50,50,0,100,0.000000
2025-09-24,Parsons Corporation,42,50,8,100,0.080000
2025-09-24,Patrick Industries,37,59,4,100,0.040000
2025-09-24,Patterson Companies Inc,12,49,1,62,0.016129
2025-09-24,Patterson-UTI Energy,61,33,6,100,0.060000
2025-09-24,PayPal,37,58,3,98,0.030612
2025-09-24,Paychex,50,45,5,100,0.050000
2025-09-24,Peabody Energy,75,21,4,100,0.040000
2025-09-24,Peloton Interactive,38,56,6,100,0.060000
2025-09-24,Penn Mutual Life Insurance,34,61,5,100,0.050000
2025-09-24,PennyMac Financial Services,32,63,5,100,0.050000
2025-09-24,Penske Automotive,29,68,3,100,0.030000
2025-09-24,PepsiCo,53,43,4,100,0.040000
2025-09-24,Performance Food,40,57,3,100,0.030000
2025-09-24,Permian Resources,40,58,2,100,0.020000
2025-09-24,Petco Health and Wellness,77,21,2,100,0.020000
2025-09-24,Peter Kiewit Sons',7,23,13,43,0.302326
2025-09-24,Pfizer,23,59,10,92,0.108696
2025-09-24,Philip Morris International,49,49,2,100,0.020000
2025-09-24,Phillips 66,41,52,7,100,0.070000
2025-09-24,Pinnacle West Capital,34,53,13,100,0.130000
2025-09-24,Pinterest,34,62,4,100,0.040000
2025-09-24,Pioneer Natural Resources,48,35,17,100,0.170000
2025-09-24,Pitney Bowes,34,64,2,100,0.020000
2025-09-24,Plains GP,32,53,15,100,0.150000
2025-09-24,Playtika Holding,25,63,12,100,0.120000
2025-09-24,Plexus Corp,33,63,4,100,0.040000
2025-09-24,Polaris Inc,44,51,5,100,0.050000
2025-09-24,Pool Corporation,35,59,6,100,0.060000
2025-09-24,Popular Inc,95,4,1,100,0.010000
2025-09-24,Portland General Electric,34,58,8,100,0.080000
2025-09-24,Post Holdings,23,68,9,100,0.090000
2025-09-24,PrIncipal Financial,41,55,4,100,0.040000
2025-09-24,PriceSmart,32,63,5,100,0.050000
2025-09-24,Primerica,39,55,6,100,0.060000
2025-09-24,Primoris Services,40,59,1,100,0.010000
2025-09-24,ProFrac Holding,26,60,14,100,0.140000
2025-09-24,Procter & Gamble,40,50,10,100,0.100000
2025-09-24,Progressive Insurance,33,56,11,100,0.110000
2025-09-24,Prologis,42,55,3,100,0.030000
2025-09-24,Prudential Financial,41,54,5,100,0.050000
2025-09-24,Public Service Enterprise Group,46,52,2,100,0.020000
2025-09-24,Public Storage,40,47,13,100,0.130000
2025-09-24,Publix Super Markets,39,58,3,100,0.030000
2025-09-24,Puget Sound Energy,58,33,9,100,0.090000
2025-09-24,PulteGroup,29,65,6,100,0.060000
2025-09-24,Pure Storage,28,65,7,100,0.070000
2025-09-24,QVC Group,24,66,10,100,0.100000
2025-09-24,QXO Building Products,0,8,2,10,0.200000
2025-09-24,Qorvo,46,46,8,100,0.080000
2025-09-24,Qualcomm,29,58,6,93,0.064516
2025-09-24,Quanta Services,48,50,2,100,0.020000
2025-09-24,Quest Diagnostics,32,60,8,100,0.080000
2025-09-24,QuidelOrtho,32,61,7,100,0.070000
2025-09-24,REV Group,45,49,6,100,0.060000
2025-09-24,RPM International,27,67,6,100,0.060000
2025-09-24,RTX,36,51,13,100,0.130000
2025-09-24,RXO Inc,30,62,8,100,0.080000
2025-09-24,Rackspace Technology,26,62,12,100,0.120000
2025-09-24,Radius Recycling,12,63,25,100,0.250000
2025-09-24,Ralph Lauren,29,65,6,100,0.060000
2025-09-24,Range Resources,42,53,5,100,0.050000
2025-09-24,Raymond James Financial,32,65,3,100,0.030000
2025-09-24,Realty Income,44,43,13,100,0.130000
2025-09-24,Regal Rexnord,32,62,6,100,0.060000
2025-09-24,Regeneron Pharmaceuticals,50,42,8,100,0.080000
2025-09-24,Regions Financial,42,53,5,100,0.050000
2025-09-24,Reinsurance Group of America,45,51,4,100,0.040000
2025-09-24,Reliance Inc,43,48,9,100,0.090000
2025-09-24,Republic Services,31,50,19,100,0.190000
2025-09-24,ResMed,27,69,4,100,0.040000
2025-09-24,Resideo Technologies,44,50,6,100,0.060000
2025-09-24,Restoration Hardware,24,61,15,100,0.150000
2025-09-24,Revvity,29,62,9,100,0.090000
2025-09-24,Rithm Capital,20,75,5,100,0.050000
2025-09-24,Rivian Automotive,38,52,12,102,0.117647
2025-09-24,Robert Half,35,54,11,100,0.110000
2025-09-24,Roblox,24,44,32,100,0.320000
2025-09-24,Rocket Companies,20,74,6,100,0.060000
2025-09-24,Rockwell Automation,35,64,1,100,0.010000
2025-09-24,Roku,52,43,6,101,0.059406
2025-09-24,Rollins Inc,33,62,5,100,0.050000
2025-09-24,Roper Technologies,33,65,2,100,0.020000
2025-09-24,Ross Stores,37,56,7,100,0.070000
2025-09-24,Rush Enterprises,33,58,9,100,0.090000
2025-09-24,Ryder System,43,56,1,100,0.010000
2025-09-24,Ryerson Holding,18,72,7,97,0.072165
2025-09-24,S&P Global,26,65,9,100,0.090000
2025-09-24,SBA Communications,39,51,10,100,0.100000
2025-09-24,SS&C Technologies,41,57,2,100,0.020000
2025-09-24,Sabre Corporation,25,67,8,100,0.080000
2025-09-24,Saia Inc,49,48,3,100,0.030000
2025-09-24,Salesforce,16,59,25,100,0.250000
2025-09-24,Sallie Mae,33,60,7,100,0.070000
2025-09-24,Sally Beauty,94,5,1,100,0.010000
2025-09-24,Sanmina,26,71,3,100,0.030000
2025-09-24,ScanSource,46,53,1,100,0.010000
2025-09-24,Schneider National,30,64,6,100,0.060000
2025-09-24,Science Applications International,34,57,9,100,0.090000
2025-09-24,Scotts Miracle-Gro,41,49,10,100,0.100000
2025-09-24,Seaboard,28,57,15,100,0.150000
2025-09-24,Sealed Air Corporation,27,66,7,100,0.070000
2025-09-24,Securian Financial,28,64,8,100,0.080000
2025-09-24,Select Medical Holdings,30,63,7,100,0.070000
2025-09-24,Selective Insurance Group,32,54,14,100,0.140000
2025-09-24,Sempra,33,56,3,92,0.032609
2025-09-24,Sentry Insurance Group,3,6,0,9,0.000000
2025-09-24,Service Corp International,4,14,4,22,0.181818
2025-09-24,ServiceNow,28,59,13,100,0.130000
2025-09-24,Sherwin-Williams,22,66,12,100,0.120000
2025-09-24,Shift4 Payments,27,65,8,100,0.080000
2025-09-24,Silgan,14,63,23,100,0.230000
2025-09-24,Simon Property Group,43,52,5,100,0.050000
2025-09-24,Sinclair,10,64,18,92,0.195652
2025-09-24,Sirius XM,24,70,6,100,0.060000
2025-09-24,SiteOne Landscape Supply,29,66,5,100,0.050000
2025-09-24,Skechers USA,25,71,4,100,0.040000
2025-09-24,SkyWest,16,55,29,100,0.290000
2025-09-24,Skyline Champion,44,12,1,57,0.017544
2025-09-24,Skyworks Solutions,31,64,5,100,0.050000
2025-09-24,Smurfit Westrock,20,66,14,100,0.140000
2025-09-24,Snap Inc,30,52,18,100,0.180000
2025-09-24,Snap-on,11,79,10,100,0.100000
2025-09-24,Snowflake Inc,55,44,1,100,0.010000
2025-09-24,Solventum,31,63,6,100,0.060000
2025-09-24,Sonic Automotive,21,76,3,100,0.030000
2025-09-24,Sonoco Products,27,64,9,100,0.090000
2025-09-24,Southern Company,43,54,3,100,0.030000
2025-09-24,Southwest Airlines,29,61,10,100,0.100000
2025-09-24,Southwest Gas Holdings,39,56,5,100,0.050000
2025-09-24,SpartanNash,22,76,2,100,0.020000
2025-09-24,Spectrum Brands,29,58,13,100,0.130000
2025-09-24,Spire Inc,54,42,4,100,0.040000
2025-09-24,Spirit AeroSystems,33,49,18,100,0.180000
2025-09-24,Spirit Airlines,20,66,14,100,0.140000
2025-09-24,Splunk,41,49,10,100,0.100000
2025-09-24,Sprouts Farmers Market,26,71,3,100,0.030000
2025-09-24,Stagwell,30,61,9,100,0.090000
2025-09-24,Stanley Black & Decker,25,66,9,100,0.090000
2025-09-24,Starbucks,18,67,15,100,0.150000
2025-09-24,State Farm Insurance,16,62,22,100,0.220000
2025-09-24,State Street,26,58,16,100,0.160000
2025-09-24,Steel Dynamics,86,11,3,100,0.030000
2025-09-24,Steelcase,31,65,4,100,0.040000
2025-09-24,Stericycle,13,40,47,100,0.470000
2025-09-24,Stifel Financial,37,60,3,100,0.030000
2025-09-24,StoneX Group,32,64,4,100,0.040000
2025-09-24,Stryker,32,57,11,100,0.110000
2025-09-24,Summit Materials,24,68,8,100,0.080000
2025-09-24,Sun Communities,42,46,12,100,0.120000
2025-09-24,Super Micro Computer,86,12,2,100,0.020000
2025-09-24,Surgery Partners,33,57,10,100,0.100000
2025-09-24,Sylvamo,20,64,16,100,0.160000
2025-09-24,Synchrony Financial,54,42,4,100,0.040000
2025-09-24,Synopsys,19,70,11,100,0.110000
2025-09-24,Synovus Financial,41,55,4,100,0.040000
2025-09-24,Sysco,47,47,6,100,0.060000
2025-09-24,TD Synnex,51,46,3,100,0.030000
2025-09-24,TEGNA,23,72,5,100,0.050000
2025-09-24,THOR Industries,26,67,7,100,0.070000
2025-09-24,TIAA,20,72,8,100,0.080000
2025-09-24,TJX,55,40,5,100,0.050000
2025-09-24,Take-Two Interactive Software,36,59,5,100,0.050000
2025-09-24,Talen Energy,89,10,1,100,0.010000
2025-09-24,Targa Resources,48,47,5,100,0.050000
2025-09-24,Target Corporation,45,52,3,100,0.030000
2025-09-24,Taylor Morrison Home,31,64,5,100,0.050000
2025-09-24,Teladoc Health,35,53,12,100,0.120000
2025-09-24,Teledyne Technologies,34,65,1,100,0.010000
2025-09-24,Teleflex,24,69,7,100,0.070000
2025-09-24,Telephone & Data Systems,8,19,0,27,0.000000
2025-09-24,TelevisaUnivision,31,55,14,100,0.140000
2025-09-24,Tenet Healthcare,37,55,8,100,0.080000
2025-09-24,Teradyne,33,63,4,100,0.040000
2025-09-24,Terex,19,75,6,100,0.060000
2025-09-24,Tesla,27,54,23,104,0.221154
2025-09-24,Tetra Tech,41,50,9,100,0.090000
2025-09-24,Texas Instruments,26,66,8,100,0.080000
2025-09-24,Texas Roadhouse,39,52,9,100,0.090000
2025-09-24,Textron,27,67,6,100,0.060000
2025-09-24,The Andersons Inc,33,65,2,100,0.020000
2025-09-24,The Coca-Cola Company,33,57,10,100,0.100000
2025-09-24,The Greenbrier Companies,27,65,8,100,0.080000
2025-09-24,The Hartford,29,45,26,100,0.260000
2025-09-24,The Mosaic Company,33,61,6,100,0.060000
2025-09-24,Thermo Fisher Scientific,41,54,5,100,0.050000
2025-09-24,Thrivent Financial for Lutherans,27,55,3,85,0.035294
2025-09-24,Timken,27,64,9,100,0.090000
2025-09-24,Titan Machinery,19,70,11,100,0.110000
2025-09-24,Toast Inc,36,54,10,100,0.100000
2025-09-24,Toll Brothers,14,83,3,100,0.030000
2025-09-24,TopBuild,22,77,1,100,0.010000
2025-09-24,Topgolf Callaway Brands,26,61,13,100,0.130000
2025-09-24,Toro Company,28,66,6,100,0.060000
2025-09-24,Tractor Supply,25,70,5,100,0.050000
2025-09-24,TransDigm,39,53,8,100,0.080000
2025-09-24,TransUnion,36,51,13,100,0.130000
2025-09-24,Travelers Insurance,38,42,20,100,0.200000
2025-09-24,TreeHouse Foods,19,61,20,100,0.200000
2025-09-24,Tri Pointe Homes,30,66,4,100,0.040000
2025-09-24,TriNet Group,28,66,6,100,0.060000
2025-09-24,Trimble Inc,33,65,2,100,0.020000
2025-09-24,Trinity Industries,28,56,16,100,0.160000
2025-09-24,TruStage,50,43,7,100,0.070000
2025-09-24,Truist Financial,40,54,6,100,0.060000
2025-09-24,Tutor Perini Corporation,55,40,5,100,0.050000
2025-09-24,Twilio,39,55,6,100,0.060000
2025-09-24,Tyson Foods,24,63,13,100,0.130000
2025-09-24,U-Haul,9,44,47,100,0.470000
2025-09-24,UFP Industries,24,72,4,100,0.040000
2025-09-24,UGI Utilities Inc,29,38,16,83,0.192771
2025-09-24,UL Solutions,49,50,1,100,0.010000
2025-09-24,UPS,28,45,27,100,0.270000
2025-09-24,US Bancorp,29,67,4,100,0.040000
2025-09-24,US Foods,51,46,3,100,0.030000
2025-09-24,USAA,28,53,19,100,0.190000
2025-09-24,Uber,18,67,15,100,0.150000
2025-09-24,Ulta Beauty,86,11,3,100,0.030000
2025-09-24,Under Armour,23,70,7,100,0.070000
2025-09-24,Union Pacific,38,55,7,100,0.070000
2025-09-24,United Airlines,47,39,6,92,0.065217
2025-09-24,United Natural Foods,82,14,4,100,0.040000
2025-09-24,United Rentals,95,4,1,100,0.010000
2025-09-24,United States Steel,50,45,5,100,0.050000
2025-09-24,UnitedHealth,45,45,10,100,0.100000
2025-09-24,Universal Corporation,34,57,9,100,0.090000
2025-09-24,Universal Health Services,34,56,10,100,0.100000
2025-09-24,Unum Group,42,50,8,100,0.080000
2025-09-24,Upbound Group,42,55,3,100,0.030000
2025-09-24,Urban Outfitters,40,58,2,100,0.020000
2025-09-24,V2X,51,46,3,100,0.030000
2025-09-24,VF Corporation,28,55,17,100,0.170000
2025-09-24,VICI Properties,37,60,3,100,0.030000
2025-09-24,Vail Resorts,23,57,20,100,0.200000
2025-09-24,Valero Energy,83,15,2,100,0.020000
2025-09-24,Valley National Bancorp,27,69,4,100,0.040000
2025-09-24,Valmont Industries,42,52,6,100,0.060000
2025-09-24,Valvoline Inc,34,61,5,100,0.050000
2025-09-24,Ventas Inc,43,57,0,100,0.000000
2025-09-24,Verisk Analytics,36,51,13,100,0.130000
2025-09-24,Verizon,46,48,8,102,0.078431
2025-09-24,Vertex Pharmaceuticals,40,44,16,100,0.160000
2025-09-24,Vertiv,46,51,3,100,0.030000
2025-09-24,Viasat,37,55,8,100,0.080000
2025-09-24,Viatris,28,59,13,100,0.130000
2025-09-24,Victorias Secret,30,52,18,100,0.180000
2025-09-24,Visa Inc,66,28,6,100,0.060000
2025-09-24,Vishay Intertechnology,29,63,8,100,0.080000
2025-09-24,Vista Outdoor,20,64,16,100,0.160000
2025-09-24,Visteon,41,58,1,100,0.010000
2025-09-24,Vistra,41,53,6,100,0.060000
2025-09-24,Vontier,41,56,3,100,0.030000
2025-09-24,Voya Financial,41,56,3,100,0.030000
2025-09-24,Vulcan Materials,32,55,13,100,0.130000
2025-09-24,WEC Energy,86,14,0,100,0.000000
2025-09-24,WESCO International,37,60,3,100,0.030000
2025-09-24,WEX,40,57,3,100,0.030000
2025-09-24,WR Berkley,38,55,7,100,0.070000
2025-09-24,WW Grainger,35,56,9,100,0.090000
2025-09-24,Wabash National,20,59,21,100,0.210000
2025-09-24,Walmart,29,46,25,100,0.250000
2025-09-24,Walt Disney,33,54,13,100,0.130000
2025-09-24,Warner Bros Discovery,15,74,11,100,0.110000
2025-09-24,Warner Music Group,25,66,9,100,0.090000
2025-09-24,Waters Corporation,43,53,4,100,0.040000
2025-09-24,Watsco,27,60,13,100,0.130000
2025-09-24,Wayfair,35,64,1,100,0.010000
2025-09-24,Webster Financial,30,60,10,100,0.100000
2025-09-24,Weis Markets,23,67,10,100,0.100000
2025-09-24,Wells Fargo,78,17,6,101,0.059406
2025-09-24,Welltower,61,37,2,100,0.020000
2025-09-24,Werner Enterprises,32,58,10,100,0.100000
2025-09-24,West Pharmaceutical Services,42,48,10,100,0.100000
2025-09-24,Western & Southern Financial,30,67,3,100,0.030000
2025-09-24,Western Alliance Bancorp,20,54,20,94,0.212766
2025-09-24,Western Digital,26,69,5,100,0.050000
2025-09-24,Western Midstream Partners,33,61,6,100,0.060000
2025-09-24,Western Union,23,70,7,100,0.070000
2025-09-24,Westinghouse Air Brake Technologies,28,67,5,100,0.050000
2025-09-24,Weyerhaeuser,29,63,8,100,0.080000
2025-09-24,Whirlpool,27,60,13,100,0.130000
2025-09-24,Williams Companies,51,43,6,100,0.060000
2025-09-24,Williams-Sonoma,33,62,5,100,0.050000
2025-09-24,Winnebago Industries,22,62,16,100,0.160000
2025-09-24,Wintrust Financial,37,62,1,100,0.010000
2025-09-24,Woodward Inc,32,66,2,100,0.020000
2025-09-24,Workday,29,61,10,100,0.100000
2025-09-24,World Kinect,32,62,6,100,0.060000
2025-09-24,Worthington Enterprises,31,66,3,100,0.030000
2025-09-24,Wynn Resorts,28,64,8,100,0.080000
2025-09-24,XPO,25,66,9,100,0.090000
2025-09-24,Xcel Energy,80,16,4,100,0.040000
2025-09-24,Xerox,22,67,11,100,0.110000
2025-09-24,Xylem Inc,45,49,6,100,0.060000
2025-09-24,Yum Brands,32,63,5,100,0.050000
2025-09-24,Yum China,41,52,7,100,0.070000
2025-09-24,Zebra Technologies,33,61,6,100,0.060000
2025-09-24,Zimmer Biomet,30,68,2,100,0.020000
2025-09-24,Zions Bancorp,36,52,12,100,0.120000
2025-09-24,Zoetis,51,44,5,100,0.050000
2025-09-24,Zoom Video Communications,33,52,15,100,0.150000
2025-09-24,eXp World,30,65,5,100,0.050000
2025-09-24,iHeartMedia,25,69,6,100,0.060000
2025-09-25,3M,32,62,6,100,0.060000
2025-09-25,A O Smith,25,74,1,100,0.010000
2025-09-25,A-Mark Precious Metals,88,12,0,100,0.000000
2025-09-25,ABM Industries,25,61,14,100,0.140000
2025-09-25,ADT,38,39,23,100,0.230000
2025-09-25,AECOM,43,51,6,100,0.060000
2025-09-25,AES,33,55,12,100,0.120000
2025-09-25,AGCO,34,55,11,100,0.110000
2025-09-25,AGNC Investment,30,52,18,100,0.180000
2025-09-25,AIG,30,62,8,100,0.080000
2025-09-25,AMC Entertainment,81,15,4,100,0.040000
2025-09-25,AMC Networks,26,59,15,100,0.150000
2025-09-25,AMN Healthcare Services,17,66,17,100,0.170000
2025-09-25,APA,36,51,13,100,0.130000
2025-09-25,APi Group,32,60,8,100,0.080000
2025-09-25,ARKO,24,70,6,100,0.060000
2025-09-25,ASGN,26,69,5,100,0.050000
2025-09-25,AT&T,24,58,18,100,0.180000
2025-09-25,ATI Inc,38,59,3,100,0.030000
2025-09-25,AbbVie,39,51,10,100,0.100000
2025-09-25,Abbott Laboratories,63,33,4,100,0.040000
2025-09-25,Abercrombie & Fitch,32,64,4,100,0.040000
2025-09-25,Academy Sports and Outdoors,28,65,7,100,0.070000
2025-09-25,Acadia Healthcare,21,64,15,100,0.150000
2025-09-25,Ace Hardware,26,63,11,100,0.110000
2025-09-25,Acuity Inc,29,37,6,72,0.083333
2025-09-25,Adams Resources & Energy,19,6,1,26,0.038462
2025-09-25,AdaptHealth,35,56,9,100,0.090000
2025-09-25,Adobe,41,52,7,100,0.070000
2025-09-25,Advance Auto Parts,22,61,17,100,0.170000
2025-09-25,Advanced Drainage Systems,80,19,1,100,0.010000
2025-09-25,Advanced Micro Devices,76,24,2,102,0.019608
2025-09-25,Advantage Solutions,76,22,2,100,0.020000
2025-09-25,Aflac,36,47,17,100,0.170000
2025-09-25,Agilent Technologies,37,58,5,100,0.050000
2025-09-25,Agilon Health,25,64,11,100,0.110000
2025-09-25,Air Lease,30,66,4,100,0.040000
2025-09-25,Air Products & Chemicals,26,65,9,100,0.090000
2025-09-25,Airbnb,26,65,9,100,0.090000
2025-09-25,Akamai Technologies,44,48,8,100,0.080000
2025-09-25,Alaska Air,36,58,6,100,0.060000
2025-09-25,Albemarle Corporation,31,58,11,100,0.110000
2025-09-25,Albertsons,40,52,8,100,0.080000
2025-09-25,Alcoa Corporation,23,59,18,100,0.180000
2025-09-25,Alexandria Real Estate Equities,43,50,7,100,0.070000
2025-09-25,Alight Solutions,30,67,3,100,0.030000
2025-09-25,Align Technology,12,72,16,100,0.160000
2025-09-25,Allegiant Travel Company,19,73,8,100,0.080000
2025-09-25,Alliance Resource Partners,31,59,10,100,0.100000
2025-09-25,Alliant Energy,80,17,3,100,0.030000
2025-09-25,Allison Transmission,31,58,11,100,0.110000
2025-09-25,Allstate,59,29,12,100,0.120000
2025-09-25,Ally Financial,35,63,2,100,0.020000
2025-09-25,Alpha Metallurgical Resources,33,55,12,100,0.120000
2025-09-25,Alphabet,27,53,20,100,0.200000
2025-09-25,Altice USA,29,61,10,100,0.100000
2025-09-25,Altria,52,43,5,100,0.050000
2025-09-25,Amazon,40,47,17,104,0.163462
2025-09-25,Ameren,37,50,13,100,0.130000
2025-09-25,American Airlines,16,26,50,92,0.543478
2025-09-25,American Axle & Manufacturing,32,55,13,100,0.130000
2025-09-25,American Eagle Outfitters,31,55,14,100,0.140000
2025-09-25,American Electric Power,40,55,5,100,0.050000
2025-09-25,American Express,40,55,5,100,0.050000
2025-09-25,American Family Insurance,45,49,6,100,0.060000
2025-09-25,American Financial Group,29,62,9,100,0.090000
2025-09-25,American Tower,45,47,8,100,0.080000
2025-09-25,American Water Works,45,53,2,100,0.020000
2025-09-25,Americold Realty Trust,71,26,3,100,0.030000
2025-09-25,Ameriprise Financial,46,47,7,100,0.070000
2025-09-25,Ametek,38,58,4,100,0.040000
2025-09-25,Amgen,26,57,17,100,0.170000
2025-09-25,Amica Mutual Insurance,23,65,4,92,0.043478
2025-09-25,Amkor Technology,39,56,5,100,0.050000
2025-09-25,Amphenol,29,69,2,100,0.020000
2025-09-25,Analog Devices,48,47,5,100,0.050000
2025-09-25,Antero Resources,36,62,2,100,0.020000
2025-09-25,Anywhere Real Estate Inc,36,51,5,92,0.054348
2025-09-25,Apollo Global Management,33,62,5,100,0.050000
2025-09-25,AppLovin,25,68,7,100,0.070000
2025-09-25,Apple,21,66,15,102,0.147059
2025-09-25,Applied Industrial Technologies,27,71,2,100,0.020000
2025-09-25,Applied Materials,21,59,20,100,0.200000
2025-09-25,AptarGroup,31,66,3,100,0.030000
2025-09-25,Aramark,48,49,3,100,0.030000
2025-09-25,ArcBest,26,70,4,100,0.040000
2025-09-25,Arch Resources,62,28,10,100,0.100000
2025-09-25,Archer Daniels Midland,43,49,8,100,0.080000
2025-09-25,Ares Management,45,55,0,100,0.000000
2025-09-25,Arista Networks,35,60,5,100,0.050000
2025-09-25,Arrow Electronics,29,67,4,100,0.040000
2025-09-25,Arthur J Gallagher,36,62,2,100,0.020000
2025-09-25,Asbury Automotive Group,29,62,9,100,0.090000
2025-09-25,Assurant,37,55,8,100,0.080000
2025-09-25,Atkore,23,71,6,100,0.060000
2025-09-25,Atlassian,21,62,17,100,0.170000
2025-09-25,Atmos Energy,86,10,4,100,0.040000
2025-09-25,Auto-Owners Insurance,32,61,7,100,0.070000
2025-09-25,AutoNation,25,62,13,100,0.130000
2025-09-25,AutoZone,28,64,8,100,0.080000
2025-09-25,Autodesk,26,71,3,100,0.030000
2025-09-25,Autoliv,41,54,5,100,0.050000
2025-09-25,Automatic Data Processing,44,49,7,100,0.070000
2025-09-25,AvalonBay Communities,35,58,7,100,0.070000
2025-09-25,Avantor,32,57,11,100,0.110000
2025-09-25,Avery Dennison,30,68,2,100,0.020000
2025-09-25,Avient,29,61,10,100,0.100000
2025-09-25,Avis Budget,23,65,12,100,0.120000
2025-09-25,Avnet,25,69,6,100,0.060000
2025-09-25,BJ's Wholesale Club,30,60,10,100,0.100000
2025-09-25,BOK Financial,38,53,9,100,0.090000
2025-09-25,BWX Technologies,47,51,2,100,0.020000
2025-09-25,Baker Hughes,41,57,2,100,0.020000
2025-09-25,Ball Corporation,32,67,1,100,0.010000
2025-09-25,Bank of America,38,59,3,100,0.030000
2025-09-25,Bank of New York Mellon,49,48,3,100,0.030000
2025-09-25,Bath & Body Works,39,47,14,100,0.140000
2025-09-25,Baxter International,25,66,9,100,0.090000
2025-09-25,Becton Dickinson,52,42,6,100,0.060000
2025-09-25,Belden,31,58,11,100,0.110000
2025-09-25,Benchmark Electronics,24,72,4,100,0.040000
2025-09-25,Berkshire Hathaway,21,62,19,102,0.186275
2025-09-25,Berry Global,24,65,11,100,0.110000
2025-09-25,Best Buy,94,4,2,100,0.020000
2025-09-25,Bio-Rad Laboratories,24,70,6,100,0.060000
2025-09-25,Biogen,25,62,13,100,0.130000
2025-09-25,BlackRock,27,68,5,100,0.050000
2025-09-25,Blackstone,45,45,10,100,0.100000
2025-09-25,Bloomin Brands,11,75,14,100,0.140000
2025-09-25,BlueLinx,21,74,5,100,0.050000
2025-09-25,Boeing,34,56,9,99,0.090909
2025-09-25,Boise Cascade,15,72,13,100,0.130000
2025-09-25,Booking Holdings,35,57,8,100,0.080000
2025-09-25,Booz Allen Hamilton,26,62,12,100,0.120000
2025-09-25,BorgWarner,57,40,3,100,0.030000
2025-09-25,Boston Properties,19,76,5,100,0.050000
2025-09-25,Boston Scientific,39,54,7,100,0.070000
2025-09-25,Boyd Gaming,23,62,8,93,0.086022
2025-09-25,Bread Financial,49,49,2,100,0.020000
2025-09-25,BrightSpring Health Services,31,62,7,100,0.070000
2025-09-25,BrightView Holdings,33,62,5,100,0.050000
2025-09-25,Brighthouse Financial,33,63,4,100,0.040000
2025-09-25,Brinker International,49,49,2,100,0.020000
2025-09-25,Brinks Company,15,5,3,23,0.130435
2025-09-25,Bristol-Myers Squibb,27,59,14,100,0.140000
2025-09-25,Broadcom,33,62,7,102,0.068627
2025-09-25,Broadridge Financial Solutions,56,43,1,100,0.010000
2025-09-25,Brookdale Senior Living,31,58,11,100,0.110000
2025-09-25,Brown & Brown,29,58,13,100,0.130000
2025-09-25,Brown-Forman,17,69,14,100,0.140000
2025-09-25,Bruker,15,70,15,100,0.150000
2025-09-25,Brunswick Corporation,46,42,12,100,0.120000
2025-09-25,Builders FirstSource,41,51,8,100,0.080000
2025-09-25,Burlington Stores,34,63,3,100,0.030000
2025-09-25,CACI International,56,41,3,100,0.030000
2025-09-25,CBRE Group,30,68,2,100,0.020000
2025-09-25,CDW,38,56,6,100,0.060000
2025-09-25,CF Industries,36,57,7,100,0.070000
2025-09-25,CH Robinson Worldwide,36,59,5,100,0.050000
2025-09-25,CHS,45,48,7,100,0.070000
2025-09-25,CIncinnati Financial,36,57,7,100,0.070000
2025-09-25,CME Group,22,73,5,100,0.050000
2025-09-25,CMS Energy,84,13,3,100,0.030000
2025-09-25,CNO Financial Group,33,64,3,100,0.030000
2025-09-25,CNX Resources,44,54,2,100,0.020000
2025-09-25,CSX,34,60,6,100,0.060000
2025-09-25,CVS Health,42,40,10,92,0.108696
2025-09-25,Cabot Corporation,33,62,5,100,0.050000
2025-09-25,Cadence,26,62,12,100,0.120000
2025-09-25,Caesars Entertainment,76,21,3,100,0.030000
2025-09-25,Cal-Maine Foods,55,42,3,100,0.030000
2025-09-25,Caleres Inc,32,62,6,100,0.060000
2025-09-25,California Resources,41,50,9,100,0.090000
2025-09-25,Calumet Inc,33,50,9,92,0.097826
2025-09-25,Campbell Soup,33,56,11,100,0.110000
2025-09-25,Camping World,25,66,9,100,0.090000
2025-09-25,Capital One,31,53,18,102,0.176471
2025-09-25,CarMax,20,71,9,100,0.090000
2025-09-25,Cardinal Health,36,56,8,100,0.080000
2025-09-25,Carlisle Companies,32,62,6,100,0.060000
2025-09-25,Carlyle Group,30,66,4,100,0.040000
2025-09-25,Carpenter Technology,36,59,5,100,0.050000
2025-09-25,Carrier Global,30,59,11,100,0.110000
2025-09-25,Carters Inc,18,28,2,48,0.041667
2025-09-25,Carvana,38,56,6,100,0.060000
2025-09-25,Caseys General Stores,28,63,9,100,0.090000
2025-09-25,Catalent,21,71,8,100,0.080000
2025-09-25,Caterpillar,25,68,7,100,0.070000
2025-09-25,Cboe Global Markets,33,66,1,100,0.010000
2025-09-25,Celanese,27,51,22,100,0.220000
2025-09-25,Cencora,59,38,3,100,0.030000
2025-09-25,Centene,32,43,25,100,0.250000
2025-09-25,CenterPoint Energy,72,21,7,100,0.070000
2025-09-25,Central Garden & Pet,24,71,5,100,0.050000
2025-09-25,Century Communities,27,69,4,100,0.040000
2025-09-25,ChampionX,39,59,2,100,0.020000
2025-09-25,Charles River Laboratories International,26,62,12,100,0.120000
2025-09-25,Charles Schwab,40,58,2,100,0.020000
2025-09-25,Chart Industries,37,60,3,100,0.030000
2025-09-25,Charter Communications,24,61,15,100,0.150000
2025-09-25,Cheesecake Factory,23,62,15,100,0.150000
2025-09-25,Chefs Warehouse,43,51,6,100,0.060000
2025-09-25,Chemours,33,52,15,100,0.150000
2025-09-25,Cheniere Energy,87,13,0,100,0.000000
2025-09-25,Chevron,33,46,21,100,0.210000
2025-09-25,Chewy,42,52,6,100,0.060000
2025-09-25,Chipotle Mexican Grill,30,61,9,100,0.090000
2025-09-25,Chord Energy,94,6,0,100,0.000000
2025-09-25,Church & Dwight,32,60,8,100,0.080000
2025-09-25,Ciena,43,52,5,100,0.050000
2025-09-25,Cigna,43,47,10,100,0.100000
2025-09-25,Cinemark,30,59,11,100,0.110000
2025-09-25,Cintas,35,63,2,100,0.020000
2025-09-25,Cisco Systems,32,64,4,100,0.040000
2025-09-25,Citigroup,30,68,2,100,0.020000
2025-09-25,Citizens Financial Group,38,58,4,100,0.040000
2025-09-25,Civitas Resources,36,47,17,100,0.170000
2025-09-25,Clean Harbors,72,17,11,100,0.110000
2025-09-25,Clear Channel Outdoor Hldgs,9,2,0,11,0.000000
2025-09-25,Cleveland-Cliffs,21,64,15,100,0.150000
2025-09-25,Clorox,33,51,16,100,0.160000
2025-09-25,Cognizant Technology Solutions,37,58,5,100,0.050000
2025-09-25,Coherent,31,67,2,100,0.020000
2025-09-25,Coinbase Global,17,72,11,100,0.110000
2025-09-25,Colgate-Palmolive,36,52,12,100,0.120000
2025-09-25,Columbia Banking System,36,61,3,100,0.030000
2025-09-25,Columbia Sportswear,28,56,16,100,0.160000
2025-09-25,Comcast,36,45,19,100,0.190000
2025-09-25,Comerica,49,40,11,100,0.110000
2025-09-25,Comfort Systems USA,94,6,0,100,0.000000
2025-09-25,CommScope,22,75,3,100,0.030000
2025-09-25,Commercial Metals,29,63,8,100,0.080000
2025-09-25,Community Health Systems,27,56,17,100,0.170000
2025-09-25,Compass Group,32,52,16,100,0.160000
2025-09-25,Conagra Brands,36,54,10,100,0.100000
2025-09-25,Concentrix,32,62,6,100,0.060000
2025-09-25,Conduent,29,58,13,100,0.130000
2025-09-25,ConocoPhillips,49,42,9,100,0.090000
2025-09-25,Consol Energy,79,19,2,100,0.020000
2025-09-25,Consolidated Edison,36,58,6,100,0.060000
2025-09-25,Constellation Brands,18,55,27,100,0.270000
2025-09-25,Constellation Energy,81,18,1,100,0.010000
2025-09-25,Continental Resources,40,48,12,100,0.120000
2025-09-25,Cooper Cos,3,23,3,29,0.103448
2025-09-25,Cooper-Standard,30,64,6,100,0.060000
2025-09-25,Copart,43,54,3,100,0.030000
2025-09-25,Core & Main,32,56,12,100,0.120000
2025-09-25,Corebridge Financial,42,54,4,100,0.040000
2025-09-25,Cornerstone Building Brands,26,63,11,100,0.110000
2025-09-25,Corning,40,52,8,100,0.080000
2025-09-25,Corpay,27,70,2,99,0.020202
2025-09-25,Corteva,28,66,6,100,0.060000
2025-09-25,Costco,21,71,8,100,0.080000
2025-09-25,Coterra Energy,80,17,3,100,0.030000
2025-09-25,Coty,24,61,15,100,0.150000
2025-09-25,Country Financial,24,61,15,100,0.150000
2025-09-25,Coupang,38,53,9,100,0.090000
2025-09-25,Cracker Barrel Old Country Store,16,67,17,100,0.170000
2025-09-25,Crocs,29,61,10,100,0.100000
2025-09-25,CrossAmerica Partners,26,70,4,100,0.040000
2025-09-25,CrowdStrike,36,50,14,100,0.140000
2025-09-25,Crown Castle,42,54,4,100,0.040000
2025-09-25,Crown Holdings,30,65,5,100,0.050000
2025-09-25,Cullen Frost Bankers,43,52,5,100,0.050000
2025-09-25,Cummins Inc,63,35,2,100,0.020000
2025-09-25,Curtiss-Wright,47,51,2,100,0.020000
2025-09-25,DR Horton,23,71,6,100,0.060000
2025-09-25,DTE Energy,74,19,7,100,0.070000
2025-09-25,DXC Technology,29,69,2,100,0.020000
2025-09-25,DaVita,27,53,20,100,0.200000
2025-09-25,Dana Incorporated,35,58,7,100,0.070000
2025-09-25,Danaher,49,44,7,100,0.070000
2025-09-25,Darden Restaurants,36,52,12,100,0.120000
2025-09-25,Darling Ingredients,89,7,4,100,0.040000
2025-09-25,Deckers Outdoor,38,51,11,100,0.110000
2025-09-25,Deere,29,58,13,100,0.130000
2025-09-25,Delek US,41,51,8,100,0.080000
2025-09-25,Dell Technologies,38,61,1,100,0.010000
2025-09-25,Delta Air Lines,22,62,18,102,0.176471
2025-09-25,Dentsply Sirona,27,68,5,100,0.050000
2025-09-25,Designer Brands,18,71,11,100,0.110000
2025-09-25,Devon Energy,91,8,1,100,0.010000
2025-09-25,DexCom,23,64,13,100,0.130000
2025-09-25,Diamondback Energy,84,14,2,100,0.020000
2025-09-25,Dicks Sporting Goods,28,67,5,100,0.050000
2025-09-25,Diebold Nixdorf,33,66,1,100,0.010000
2025-09-25,Digital Realty Trust,83,17,0,100,0.000000
2025-09-25,Dillards,29,57,14,100,0.140000
2025-09-25,Discover Financial,35,56,9,100,0.090000
2025-09-25,DocuSign,39,51,10,100,0.100000
2025-09-25,Dollar General,18,59,23,100,0.230000
2025-09-25,Dollar Tree,38,51,11,100,0.110000
2025-09-25,Dominion Energy,67,27,6,100,0.060000
2025-09-25,Dominos Pizza Inc,16,33,1,50,0.020000
2025-09-25,Domtar,25,65,10,100,0.100000
2025-09-25,Donaldson Company,45,49,6,100,0.060000
2025-09-25,DoorDash,42,38,13,93,0.139785
2025-09-25,Dover Corporation,47,52,1,100,0.010000
2025-09-25,DraftKings,57,39,4,100,0.040000
2025-09-25,Dream Finders Homes,83,15,2,100,0.020000
2025-09-25,Dropbox,26,68,6,100,0.060000
2025-09-25,DuPont,30,61,9,100,0.090000
2025-09-25,Duke Energy,83,11,7,101,0.069307
2025-09-25,Dycom Industries,34,62,4,100,0.040000
2025-09-25,EMCOR Group,29,68,3,100,0.030000
2025-09-25,EOG Resources,49,44,7,100,0.070000
2025-09-25,EPAM Systems,34,63,3,100,0.030000
2025-09-25,EQT,35,57,8,100,0.080000
2025-09-25,ESAB,38,57,5,100,0.050000
2025-09-25,East West Bancorp,45,50,5,100,0.050000
2025-09-25,Eastman Chemical,30,53,17,100,0.170000
2025-09-25,Ebay,30,60,10,100,0.100000
2025-09-25,EchoStar,20,70,10,100,0.100000
2025-09-25,Ecolab,43,54,3,100,0.030000
2025-09-25,Edison International,23,56,21,100,0.210000
2025-09-25,Edward Jones,32,59,9,100,0.090000
2025-09-25,Edwards Lifesciences,47,38,15,100,0.150000
2025-09-25,Elanco Animal Health,41,56,3,100,0.030000
2025-09-25,Electronic Arts,19,67,14,100,0.140000
2025-09-25,Elevance Health,42,45,13,100,0.130000
2025-09-25,Eli Lilly,21,72,7,100,0.070000
2025-09-25,Emerson Electric,49,47,4,100,0.040000
2025-09-25,EnLink Midstream,43,50,7,100,0.070000
2025-09-25,Encompass Health,29,62,9,100,0.090000
2025-09-25,Endeavor Group,18,74,8,100,0.080000
2025-09-25,Endeavor Group Holdings,17,73,10,100,0.100000
2025-09-25,EnerSys,38,53,9,100,0.090000
2025-09-25,Energizer Holdings,85,15,0,100,0.000000
2025-09-25,Energy Transfer,85,12,3,100,0.030000
2025-09-25,Ensign Group,41,57,2,100,0.020000
2025-09-25,Entegris,37,56,7,100,0.070000
2025-09-25,Entergy,46,48,6,100,0.060000
2025-09-25,Enterprise Products Partners,44,41,15,100,0.150000
2025-09-25,Envista,27,67,6,100,0.060000
2025-09-25,Equifax,46,47,7,100,0.070000
2025-09-25,Equinix,47,49,4,100,0.040000
2025-09-25,Equitable Holdings,36,58,6,100,0.060000
2025-09-25,Equity Residential,31,62,7,100,0.070000
2025-09-25,Erie Insurance,26,59,15,100,0.150000
2025-09-25,Estée Lauder,32,57,11,100,0.110000
2025-09-25,Etsy,21,55,24,100,0.240000
2025-09-25,Euronet Worldwide,29,64,7,100,0.070000
2025-09-25,Evergy,46,46,8,100,0.080000
2025-09-25,Eversource Energy,73,21,6,100,0.060000
2025-09-25,Exact Sciences,29,48,23,100,0.230000
2025-09-25,Exelon,37,56,7,100,0.070000
2025-09-25,Expand Energy Corporation,95,5,0,100,0.000000
2025-09-25,Expedia,49,43,8,100,0.080000
2025-09-25,Expeditors International of Washington,30,64,6,100,0.060000
2025-09-25,Extra Space Storage,21,66,13,100,0.130000
2025-09-25,Exxon Mobil,48,48,4,100,0.040000
2025-09-25,F5,38,57,5,100,0.050000
2025-09-25,FM Global,35,46,19,100,0.190000
2025-09-25,FMC Corporation,36,53,11,100,0.110000
2025-09-25,FTI Consulting,31,55,14,100,0.140000
2025-09-25,Fannie Mae,19,71,10,100,0.100000
2025-09-25,Farmers Insurance Exchange,18,64,18,100,0.180000
2025-09-25,Fastenal,66,31,3,100,0.030000
2025-09-25,FedEx,32,52,17,101,0.168317
2025-09-25,Federated Mutual Insurance,20,23,6,49,0.122449
2025-09-25,Ferguson Enterprises,39,54,7,100,0.070000
2025-09-25,Fidelity National Financial,36,56,8,100,0.080000
2025-09-25,Fidelity National Information Services,51,38,11,100,0.110000
2025-09-25,Fifth Third Bancorp,53,44,3,100,0.030000
2025-09-25,First American Financial,31,58,11,100,0.110000
2025-09-25,First Citizens BancShares,38,56,6,100,0.060000
2025-09-25,First Horizon,45,54,1,100,0.010000
2025-09-25,First National of Nebraska,18,34,1,53,0.018868
2025-09-25,First Solar,35,60,5,100,0.050000
2025-09-25,FirstCash,31,60,9,100,0.090000
2025-09-25,FirstEnergy,47,40,13,100,0.130000
2025-09-25,Fiserv,32,66,2,100,0.020000
2025-09-25,Five Below,32,55,13,100,0.130000
2025-09-25,Flagstar Financial,28,59,13,100,0.130000
2025-09-25,Floor & Decor,32,60,8,100,0.080000
2025-09-25,Flowers Foods,20,65,15,100,0.150000
2025-09-25,Flowserve,26,70,4,100,0.040000
2025-09-25,Fluor,36,49,15,100,0.150000
2025-09-25,Foot Locker,12,72,16,100,0.160000
2025-09-25,Ford Motor,27,60,15,102,0.147059
2025-09-25,Fortinet,27,45,28,100,0.280000
2025-09-25,Fortive,23,65,12,100,0.120000
2025-09-25,Fortune Brands Innovations,29,65,6,100,0.060000
2025-09-25,Franklin Resources,33,58,9,100,0.090000
2025-09-25,Freddie Mac,25,67,8,100,0.080000
2025-09-25,Freeport-McMoRan,16,56,26,98,0.265306
2025-09-25,Frontier Airlines,27,64,9,100,0.090000
2025-09-25,Frontier Communications,39,56,5,100,0.050000
2025-09-25,G-III Apparel Group,35,58,7,100,0.070000
2025-09-25,GE HealthCare Technologies,34,61,5,100,0.050000
2025-09-25,GE Vernova,50,46,4,100,0.040000
2025-09-25,GMS,23,72,5,100,0.050000
2025-09-25,GXO Logistics,34,59,7,100,0.070000
2025-09-25,GameStop,23,62,15,100,0.150000
2025-09-25,Gannett,29,62,9,100,0.090000
2025-09-25,Garrett Motion Inc,37,59,4,100,0.040000
2025-09-25,Gartner,25,67,8,100,0.080000
2025-09-25,Gen Digital,48,49,3,100,0.030000
2025-09-25,Generac,32,62,6,100,0.060000
2025-09-25,General Dynamics,91,9,0,100,0.000000
2025-09-25,General Mills,45,50,5,100,0.050000
2025-09-25,General Motors,38,57,7,102,0.068627
2025-09-25,Genesis Energy,76,21,3,100,0.030000
2025-09-25,Genuine Parts,35,64,1,100,0.010000
2025-09-25,Genworth Financial,49,47,4,100,0.040000
2025-09-25,Gilead Sciences,36,58,6,100,0.060000
2025-09-25,Global Partners,38,49,13,100,0.130000
2025-09-25,Global Payments,37,61,2,100,0.020000
2025-09-25,Globe Life,32,60,8,100,0.080000
2025-09-25,GoDaddy,40,53,7,100,0.070000
2025-09-25,Goldman Sachs,30,62,8,100,0.080000
2025-09-25,Goodyear Tire & Rubber,23,68,9,100,0.090000
2025-09-25,Graham Holdings Company,29,67,4,100,0.040000
2025-09-25,Granite Construction,39,58,3,100,0.030000
2025-09-25,Graphic Packaging,13,69,18,100,0.180000
2025-09-25,Gray Television,25,64,11,100,0.110000
2025-09-25,Graybar Electric,13,26,3,42,0.071429
2025-09-25,Green Plains Inc,36,52,12,100,0.120000
2025-09-25,Greif,21,76,3,100,0.030000
2025-09-25,Griffon Corporation,37,56,7,100,0.070000
2025-09-25,Grocery Outlet Holding,30,62,8,100,0.080000
2025-09-25,Group 1 Automotive,30,64,6,100,0.060000
2025-09-25,Guardian Life insurance,48,50,2,100,0.020000
2025-09-25,Guess Inc,31,64,5,100,0.050000
2025-09-25,GuideWell Mutual,19,25,1,45,0.022222
2025-09-25,HB Fuller,19,77,4,100,0.040000
2025-09-25,HCA Healthcare,43,55,2,100,0.020000
2025-09-25,HEICO,31,61,8,100,0.080000
2025-09-25,HF SInclair,26,59,15,100,0.150000
2025-09-25,HP,30,66,4,100,0.040000
2025-09-25,Halliburton,17,62,21,100,0.210000
2025-09-25,Hanesbrands,25,72,3,100,0.030000
2025-09-25,Hanover Insurance Group,41,48,11,100,0.110000
2025-09-25,Harley-Davidson,18,72,10,100,0.100000
2025-09-25,Hasbro,33,52,15,100,0.150000
2025-09-25,Hawaiian Airlines Inc,36,62,2,100,0.020000
2025-09-25,Hawaiian Electric Industries,32,60,8,100,0.080000
2025-09-25,Helmerich & Payne,23,63,14,100,0.140000
2025-09-25,Henry Schein,28,69,3,100,0.030000
2025-09-25,Herc Rentals,34,56,10,100,0.100000
2025-09-25,Hershey,34,58,8,100,0.080000
2025-09-25,Hertz,15,68,17,100,0.170000
2025-09-25,Hewlett Packard Enterprise,22,76,2,100,0.020000
2025-09-25,Hillenbrand,22,68,10,100,0.100000
2025-09-25,Hilton Grand Vacations,89,11,0,100,0.000000
2025-09-25,Hilton Worldwide,39,56,5,100,0.050000
2025-09-25,Hologic,28,65,7,100,0.070000
2025-09-25,Home Depot,44,45,11,100,0.110000
2025-09-25,Honeywell,46,39,15,100,0.150000
2025-09-25,Hormel Foods,30,63,7,100,0.070000
2025-09-25,Host Hotels & Resorts,21,76,3,100,0.030000
2025-09-25,Hovnanian Enterprises,34,58,8,100,0.080000
2025-09-25,Howmet Aerospace,36,60,4,100,0.040000
2025-09-25,Hub Group,23,66,11,100,0.110000
2025-09-25,Hubbell,17,67,16,100,0.160000
2025-09-25,Humana,47,41,12,100,0.120000
2025-09-25,Huntington Bancshares,37,61,2,100,0.020000
2025-09-25,Huntington Ingalls Industries,30,57,13,100,0.130000
2025-09-25,Huntsman,14,57,29,100,0.290000
2025-09-25,Hyatt Hotels,39,59,2,100,0.020000
2025-09-25,Hyster-Yale,26,70,4,100,0.040000
2025-09-25,IAC,29,61,10,100,0.100000
2025-09-25,IBM,47,51,4,102,0.039216
2025-09-25,IDEX,31,61,8,100,0.080000
2025-09-25,IDEXX Laboratories,56,41,3,100,0.030000
2025-09-25,IQVIA,46,49,5,100,0.050000
2025-09-25,ITT,42,53,5,100,0.050000
2025-09-25,Icahn Enterprises,26,57,17,100,0.170000
2025-09-25,Illinois Tool Works,41,52,7,100,0.070000
2025-09-25,Illumina Inc,22,66,12,100,0.120000
2025-09-25,Incyte,42,57,1,100,0.010000
2025-09-25,Ingersoll Rand,34,61,5,100,0.050000
2025-09-25,Ingles Markets,27,50,23,100,0.230000
2025-09-25,Ingram Micro,23,47,30,100,0.300000
2025-09-25,Ingredion,47,48,5,100,0.050000
2025-09-25,Insight Enterprises,30,60,10,100,0.100000
2025-09-25,Insperity,33,56,11,100,0.110000
2025-09-25,Instacart,27,66,9,102,0.088235
2025-09-25,Installed Building Products,25,67,8,100,0.080000
2025-09-25,Intel,19,69,13,101,0.128713
2025-09-25,Interactive Brokers,44,49,7,100,0.070000
2025-09-25,Intercontinental Exchange,42,56,2,100,0.020000
2025-09-25,International Flavors & Fragrances,28,66,6,100,0.060000
2025-09-25,International Paper,20,73,7,100,0.070000
2025-09-25,Interpublic Group,35,60,5,100,0.050000
2025-09-25,Intuit,47,47,6,100,0.060000
2025-09-25,Intuitive Surgical,42,50,8,100,0.080000
2025-09-25,Iron Mountain,27,59,14,100,0.140000
2025-09-25,JB Hunt Transport Services,22,67,11,100,0.110000
2025-09-25,JELD-WEN Holding,21,70,9,100,0.090000
2025-09-25,JM Smucker,33,59,8,100,0.080000
2025-09-25,JPMorgan Chase,32,61,9,102,0.088235
2025-09-25,Jabil,24,74,2,100,0.020000
2025-09-25,Jackson Financial,36,59,5,100,0.050000
2025-09-25,Jacobs Solutions,53,45,2,100,0.020000
2025-09-25,Jefferies Financial,34,61,5,100,0.050000
2025-09-25,JetBlue Airways,30,55,15,100,0.150000
2025-09-25,Johnson & Johnson,45,47,8,100,0.080000
2025-09-25,Jones Lang LaSalle,44,54,2,100,0.020000
2025-09-25,Juniper Networks,27,65,8,100,0.080000
2025-09-25,KB Home,36,59,5,100,0.050000
2025-09-25,KBR,50,45,5,100,0.050000
2025-09-25,KKR & Co,58,40,2,100,0.020000
2025-09-25,KLA,31,51,18,100,0.180000
2025-09-25,Kaiser Aluminum,26,69,5,100,0.050000
2025-09-25,Kellanova,33,57,10,100,0.100000
2025-09-25,Kelly Services Inc,25,67,8,100,0.080000
2025-09-25,Kemper Corporation,35,60,5,100,0.050000
2025-09-25,Kenvue,13,68,21,102,0.205882
2025-09-25,Keurig Dr Pepper,18,65,17,100,0.170000
2025-09-25,KeyCorp,39,57,4,100,0.040000
2025-09-25,Keysight Technologies,35,60,5,100,0.050000
2025-09-25,Kimberly-Clark,36,54,10,100,0.100000
2025-09-25,Kinder Morgan,93,5,2,100,0.020000
2025-09-25,Kirby Corporation,23,65,7,95,0.073684
2025-09-25,Knife River Corporation,24,50,6,80,0.075000
2025-09-25,Knight Swift Transportation,30,63,7,100,0.070000
2025-09-25,Kohl's,30,55,15,100,0.150000
2025-09-25,Kontoor Brands,33,62,5,100,0.050000
2025-09-25,Korn Ferry,52,40,8,100,0.080000
2025-09-25,Kraft Heinz,30,56,14,100,0.140000
2025-09-25,Kroger,30,54,17,101,0.168317
2025-09-25,Kyndryl,32,63,5,100,0.050000
2025-09-25,L3Harris Technologies,29,65,6,100,0.060000
2025-09-25,LCI Industries,32,63,5,100,0.050000
2025-09-25,LKQ,25,65,10,100,0.100000
2025-09-25,LPL Financial,62,36,2,100,0.020000
2025-09-25,Labcorp Holdings,46,50,4,100,0.040000
2025-09-25,Lam Research,44,51,5,100,0.050000
2025-09-25,Lamb Weston,22,69,9,100,0.090000
2025-09-25,Land O'Lakes,23,63,14,100,0.140000
2025-09-25,Landstar System,23,52,25,100,0.250000
2025-09-25,Las Vegas Sands,25,64,11,100,0.110000
2025-09-25,Lear Corporation,34,56,10,100,0.100000
2025-09-25,Leggett & Platt,21,71,8,100,0.080000
2025-09-25,Leidos,44,51,5,100,0.050000
2025-09-25,Lennar,15,63,22,100,0.220000
2025-09-25,Lennox International,35,59,6,100,0.060000
2025-09-25,Levi Strauss,25,73,2,100,0.020000
2025-09-25,Liberty Energy,90,10,0,100,0.000000
2025-09-25,Liberty Media,94,5,1,100,0.010000
2025-09-25,Liberty Mutual Insurance,81,13,6,100,0.060000
2025-09-25,Light & Wonder,25,60,15,100,0.150000
2025-09-25,Lincoln Electric,36,60,4,100,0.040000
2025-09-25,Lincoln National,31,55,14,100,0.140000
2025-09-25,Lithia Motors,40,57,3,100,0.030000
2025-09-25,Live Nation Entertainment,41,41,18,100,0.180000
2025-09-25,Lockheed Martin,36,52,12,100,0.120000
2025-09-25,Loews,39,58,3,100,0.030000
2025-09-25,Louisiana-Pacific Corporation,33,63,4,100,0.040000
2025-09-25,Lowe's,27,49,24,100,0.240000
2025-09-25,Lululemon athletica,21,58,21,100,0.210000
2025-09-25,Lumen Technologies,22,69,9,100,0.090000
2025-09-25,Lyft,14,65,22,101,0.217822
2025-09-25,M&T Bank,27,64,9,100,0.090000
2025-09-25,M/I Homes,24,68,8,100,0.080000
2025-09-25,MDU Resources Group,38,56,6,100,0.060000
2025-09-25,MGM Resorts International,29,62,9,100,0.090000
2025-09-25,MKS Instruments,41,48,11,100,0.110000
2025-09-25,MRC Global,38,59,3,100,0.030000
2025-09-25,MSC Industrial Direct,21,71,8,100,0.080000
2025-09-25,MSCI,32,62,6,100,0.060000
2025-09-25,MYR Group,32,58,10,100,0.100000
2025-09-25,Macys,26,67,7,100,0.070000
2025-09-25,ManpowerGroup,25,62,13,100,0.130000
2025-09-25,Marathon Oil,22,62,16,100,0.160000
2025-09-25,Marathon Petroleum,41,54,5,100,0.050000
2025-09-25,Markel Group,43,49,8,100,0.080000
2025-09-25,Marriott International,39,57,4,100,0.040000
2025-09-25,Marriott Vacations Worldwide,32,56,12,100,0.120000
2025-09-25,Marsh & McLennan,55,38,7,100,0.070000
2025-09-25,Martin Marietta Materials,30,57,13,100,0.130000
2025-09-25,Marvell Technology,33,57,10,100,0.100000
2025-09-25,MasTec,38,60,2,100,0.020000
2025-09-25,Masco,32,58,10,100,0.100000
2025-09-25,Mass Mutual,27,62,4,93,0.043011
2025-09-25,MasterBrand,33,65,2,100,0.020000
2025-09-25,Mastercard,38,58,4,100,0.040000
2025-09-25,Matador Resources,30,61,9,100,0.090000
2025-09-25,Match Group,19,54,27,100,0.270000
2025-09-25,Mativ,26,69,5,100,0.050000
2025-09-25,Matson Inc,37,54,9,100,0.090000
2025-09-25,Mattel,30,58,12,100,0.120000
2025-09-25,Maximus,23,71,6,100,0.060000
2025-09-25,McCormick & Company,42,45,13,100,0.130000
2025-09-25,McDonalds,24,58,18,100,0.180000
2025-09-25,McKesson,42,54,4,100,0.040000
2025-09-25,Medical Mutual of Ohio,26,63,11,100,0.110000
2025-09-25,Merck,37,54,9,100,0.090000
2025-09-25,Mercury General,26,57,17,100,0.170000
2025-09-25,Meritage Homes,26,63,11,100,0.110000
2025-09-25,MetLife,36,57,7,100,0.070000
2025-09-25,Meta Platforms,45,43,12,100,0.120000
2025-09-25,Mettler-Toledo International,31,66,3,100,0.030000
2025-09-25,Microchip Technology,42,53,5,100,0.050000
2025-09-25,Micron Technology,32,55,5,92,0.054348
2025-09-25,Microsoft,25,65,10,100,0.100000
2025-09-25,Middleby,23,76,1,100,0.010000
2025-09-25,MillerKnoll,28,65,7,100,0.070000
2025-09-25,Moderna,40,45,17,102,0.166667
2025-09-25,ModivCare,30,51,19,100,0.190000
2025-09-25,Mohawk Industries,32,61,7,100,0.070000
2025-09-25,Molina Healthcare,35,54,11,100,0.110000
2025-09-25,Molson Coors Beverage,20,69,10,99,0.101010
2025-09-25,Mondelez,35,54,11,100,0.110000
2025-09-25,Monster Beverage,45,51,4,100,0.040000
2025-09-25,Moodys Corporation,4,11,3,18,0.166667
2025-09-25,Moog Inc,36,59,5,100,0.050000
2025-09-25,Morgan Stanley,18,71,3,92,0.032609
2025-09-25,Motorola Solutions,51,46,3,100,0.030000
2025-09-25,Mueller Industries,45,49,6,100,0.060000
2025-09-25,Murphy Oil,29,66,5,100,0.050000
2025-09-25,Murphy USA,33,58,9,100,0.090000
2025-09-25,Mutual of Omaha,48,47,5,100,0.050000
2025-09-25,NCR Atleos,34,61,5,100,0.050000
2025-09-25,NCR Voyix,27,64,9,100,0.090000
2025-09-25,NGL Energy Partners,84,12,4,100,0.040000
2025-09-25,NLV Financial,3,5,1,9,0.111111
2025-09-25,NOV,23,64,13,100,0.130000
2025-09-25,NRG Energy,82,15,3,100,0.030000
2025-09-25,NVR Inc,36,59,5,100,0.050000
2025-09-25,Nasdaq Inc,37,60,3,100,0.030000
2025-09-25,Nationwide Insurance,18,62,20,100,0.200000
2025-09-25,Navient,39,48,13,100,0.130000
2025-09-25,NetApp,31,65,4,100,0.040000
2025-09-25,Netflix,21,61,20,102,0.196078
2025-09-25,NeueHealth,58,40,2,100,0.020000
2025-09-25,New York Life Insurance,41,50,9,100,0.090000
2025-09-25,NewMarket Corporation,36,41,3,80,0.037500
2025-09-25,Newell Brands,29,62,9,100,0.090000
2025-09-25,Newmont,27,65,8,100,0.080000
2025-09-25,News Corp,19,68,13,100,0.130000
2025-09-25,Nexstar Media Group,18,73,9,100,0.090000
2025-09-25,NextEra Energy,87,12,1,100,0.010000
2025-09-25,NiSource,45,47,8,100,0.080000
2025-09-25,Nike,19,76,7,102,0.068627
2025-09-25,Nordson,39,59,2,100,0.020000
2025-09-25,Nordstrom,33,61,6,100,0.060000
2025-09-25,Norfolk Southern,33,56,5,94,0.053191
2025-09-25,Northern Trust,94,5,1,100,0.010000
2025-09-25,Northrop Grumman,32,64,4,100,0.040000
2025-09-25,Northwestern Mutual,33,52,15,100,0.150000
2025-09-25,Nucor,27,57,16,100,0.160000
2025-09-25,Nvidia,25,63,13,101,0.128713
2025-09-25,O'Reilly Automotive,65,32,3,100,0.030000
2025-09-25,O-I Glass,40,48,12,100,0.120000
2025-09-25,ODP Business Solutions,19,52,2,73,0.027397
2025-09-25,OGE Energy,90,9,1,100,0.010000
2025-09-25,ON Semiconductor,26,65,9,100,0.090000
2025-09-25,Occidental Petroleum,35,52,13,100,0.130000
2025-09-25,Old Dominion Freight Line,40,47,13,100,0.130000
2025-09-25,Old National Bancorp,31,69,0,100,0.000000
2025-09-25,Old Republic International,49,49,2,100,0.020000
2025-09-25,Olin,20,62,18,100,0.180000
2025-09-25,Omnicom Group,36,57,7,100,0.070000
2025-09-25,OneMain,43,54,3,100,0.030000
2025-09-25,Oneok,49,48,3,100,0.030000
2025-09-25,Opendoor Technologies,20,53,27,100,0.270000
2025-09-25,Option Care Health,94,6,0,100,0.000000
2025-09-25,Oracle,22,69,8,99,0.080808
2025-09-25,Organon,26,61,13,100,0.130000
2025-09-25,Oscar Health,29,62,9,100,0.090000
2025-09-25,Oshkosh Corporation,42,49,9,100,0.090000
2025-09-25,Otis Worldwide,38,53,9,100,0.090000
2025-09-25,Ovintiv,43,52,5,100,0.050000
2025-09-25,Owens & Minor,27,58,15,100,0.150000
2025-09-25,Owens Corning,20,76,4,100,0.040000
2025-09-25,PACS Group,26,53,21,100,0.210000
2025-09-25,PBF Energy,79,19,2,100,0.020000
2025-09-25,PC Connection Inc,43,38,4,85,0.047059
2025-09-25,PENN Entertainment,87,13,0,100,0.000000
2025-09-25,PG&E,45,36,19,100,0.190000
2025-09-25,PNC Financial Services,46,49,5,100,0.050000
2025-09-25,PPG Industries,36,58,6,100,0.060000
2025-09-25,PPL Corporation,41,57,2,100,0.020000
2025-09-25,PVH,34,52,14,100,0.140000
2025-09-25,Paccar,32,59,9,100,0.090000
2025-09-25,Pacific Life,39,58,3,100,0.030000
2025-09-25,Packaging Corp of America,16,76,8,100,0.080000
2025-09-25,Palo Alto Networks,38,50,12,100,0.120000
2025-09-25,Par Pacific,35,62,3,100,0.030000
2025-09-25,Paramount Global,25,64,11,100,0.110000
2025-09-25,Park Hotels & Resorts,27,65,8,100,0.080000
2025-09-25,Parker-Hannifin,56,44,0,100,0.000000
2025-09-25,Parsons Corporation,42,51,7,100,0.070000
2025-09-25,Patrick Industries,37,59,4,100,0.040000
2025-09-25,Patterson Companies Inc,12,47,2,61,0.032787
2025-09-25,Patterson-UTI Energy,60,33,7,100,0.070000
2025-09-25,PayPal,36,54,9,99,0.090909
2025-09-25,Paychex,35,55,10,100,0.100000
2025-09-25,Peabody Energy,72,23,5,100,0.050000
2025-09-25,Peloton Interactive,36,57,7,100,0.070000
2025-09-25,Penn Mutual Life Insurance,32,63,5,100,0.050000
2025-09-25,PennyMac Financial Services,29,66,5,100,0.050000
2025-09-25,Penske Automotive,32,65,3,100,0.030000
2025-09-25,PepsiCo,49,44,7,100,0.070000
2025-09-25,Performance Food,39,58,3,100,0.030000
2025-09-25,Permian Resources,40,58,2,100,0.020000
2025-09-25,Petco Health and Wellness,75,23,2,100,0.020000
2025-09-25,Peter Kiewit Sons',9,22,13,44,0.295455
2025-09-25,Pfizer,25,64,11,100,0.110000
2025-09-25,Philip Morris International,51,48,1,100,0.010000
2025-09-25,Phillips 66,41,53,6,100,0.060000
2025-09-25,Pinnacle West Capital,34,52,14,100,0.140000
2025-09-25,Pinterest,31,63,6,100,0.060000
2025-09-25,Pioneer Natural Resources,47,36,17,100,0.170000
2025-09-25,Pitney Bowes,33,65,2,100,0.020000
2025-09-25,Plains GP,33,52,15,100,0.150000
2025-09-25,Playtika Holding,26,62,12,100,0.120000
2025-09-25,Plexus Corp,32,64,4,100,0.040000
2025-09-25,Polaris Inc,44,52,4,100,0.040000
2025-09-25,Pool Corporation,31,63,6,100,0.060000
2025-09-25,Popular Inc,96,3,1,100,0.010000
2025-09-25,Portland General Electric,35,57,8,100,0.080000
2025-09-25,Post Holdings,24,68,8,100,0.080000
2025-09-25,PrIncipal Financial,42,52,6,100,0.060000
2025-09-25,PriceSmart,33,62,5,100,0.050000
2025-09-25,Primerica,38,56,6,100,0.060000
2025-09-25,Primoris Services,41,58,1,100,0.010000
2025-09-25,ProFrac Holding,28,59,13,100,0.130000
2025-09-25,Procter & Gamble,40,48,12,100,0.120000
2025-09-25,Progressive Insurance,32,57,11,100,0.110000
2025-09-25,Prologis,39,57,4,100,0.040000
2025-09-25,Prudential Financial,41,55,4,100,0.040000
2025-09-25,Public Service Enterprise Group,46,50,4,100,0.040000
2025-09-25,Public Storage,42,44,14,100,0.140000
2025-09-25,Publix Super Markets,38,58,4,100,0.040000
2025-09-25,Puget Sound Energy,57,34,9,100,0.090000
2025-09-25,PulteGroup,28,66,6,100,0.060000
2025-09-25,Pure Storage,32,63,5,100,0.050000
2025-09-25,QVC Group,23,67,10,100,0.100000
2025-09-25,QXO Building Products,0,8,2,10,0.200000
2025-09-25,Qorvo,46,45,9,100,0.090000
2025-09-25,Qualcomm,35,57,6,98,0.061224
2025-09-25,Quanta Services,45,53,2,100,0.020000
2025-09-25,Quest Diagnostics,26,65,9,100,0.090000
2025-09-25,QuidelOrtho,31,62,7,100,0.070000
2025-09-25,REV Group,45,48,7,100,0.070000
2025-09-25,RPM International,28,65,7,100,0.070000
2025-09-25,RTX,41,48,10,99,0.101010
2025-09-25,RXO Inc,30,62,8,100,0.080000
2025-09-25,Rackspace Technology,24,64,12,100,0.120000
2025-09-25,Radius Recycling,13,61,26,100,0.260000
2025-09-25,Ralph Lauren,27,67,6,100,0.060000
2025-09-25,Range Resources,44,51,5,100,0.050000
2025-09-25,Raymond James Financial,28,69,3,100,0.030000
2025-09-25,Realty Income,49,38,13,100,0.130000
2025-09-25,Regal Rexnord,32,60,8,100,0.080000
2025-09-25,Regeneron Pharmaceuticals,47,47,6,100,0.060000
2025-09-25,Regions Financial,43,52,5,100,0.050000
2025-09-25,Reinsurance Group of America,39,55,6,100,0.060000
2025-09-25,Reliance Inc,42,50,8,100,0.080000
2025-09-25,Republic Services,34,45,21,100,0.210000
2025-09-25,ResMed,24,71,5,100,0.050000
2025-09-25,Resideo Technologies,40,53,7,100,0.070000
2025-09-25,Restoration Hardware,23,61,16,100,0.160000
2025-09-25,Revvity,30,60,10,100,0.100000
2025-09-25,Rithm Capital,22,74,4,100,0.040000
2025-09-25,Rivian Automotive,38,52,12,102,0.117647
2025-09-25,Robert Half,33,56,11,100,0.110000
2025-09-25,Roblox,24,47,29,100,0.290000
2025-09-25,Rocket Companies,22,72,6,100,0.060000
2025-09-25,Rockwell Automation,35,64,1,100,0.010000
2025-09-25,Roku,50,45,7,102,0.068627
2025-09-25,Rollins Inc,26,69,5,100,0.050000
2025-09-25,Roper Technologies,31,66,3,100,0.030000
2025-09-25,Ross Stores,38,56,6,100,0.060000
2025-09-25,Rush Enterprises,32,57,11,100,0.110000
2025-09-25,Ryder System,44,55,1,100,0.010000
2025-09-25,Ryerson Holding,17,72,6,95,0.063158
2025-09-25,S&P Global,27,66,7,100,0.070000
2025-09-25,SBA Communications,40,50,10,100,0.100000
2025-09-25,SS&C Technologies,40,58,2,100,0.020000
2025-09-25,Sabre Corporation,27,66,7,100,0.070000
2025-09-25,Saia Inc,48,49,3,100,0.030000
2025-09-25,Salesforce,14,59,27,100,0.270000
2025-09-25,Sallie Mae,32,61,7,100,0.070000
2025-09-25,Sally Beauty,94,5,1,100,0.010000
2025-09-25,Sanmina,27,69,4,100,0.040000
2025-09-25,ScanSource,45,51,4,100,0.040000
2025-09-25,Schneider National,30,64,6,100,0.060000
2025-09-25,Science Applications International,32,57,11,100,0.110000
2025-09-25,Scotts Miracle-Gro,39,50,11,100,0.110000
2025-09-25,Seaboard,27,58,15,100,0.150000
2025-09-25,Sealed Air Corporation,27,66,7,100,0.070000
2025-09-25,Securian Financial,30,62,8,100,0.080000
2025-09-25,Select Medical Holdings,28,65,7,100,0.070000
2025-09-25,Selective Insurance Group,32,51,17,100,0.170000
2025-09-25,Sempra,32,57,3,92,0.032609
2025-09-25,Sentry Insurance Group,4,6,0,10,0.000000
2025-09-25,Service Corp International,4,14,5,23,0.217391
2025-09-25,ServiceNow,29,58,13,100,0.130000
2025-09-25,Sherwin-Williams,17,63,12,92,0.130435
2025-09-25,Shift4 Payments,24,68,8,100,0.080000
2025-09-25,Silgan,17,59,24,100,0.240000
2025-09-25,Simon Property Group,42,53,5,100,0.050000
2025-09-25,Sinclair,10,65,17,92,0.184783
2025-09-25,Sirius XM,28,69,3,100,0.030000
2025-09-25,SiteOne Landscape Supply,26,68,6,100,0.060000
2025-09-25,Skechers USA,24,72,4,100,0.040000
2025-09-25,SkyWest,16,56,28,100,0.280000
2025-09-25,Skyline Champion,43,13,1,57,0.017544
2025-09-25,Skyworks Solutions,33,62,5,100,0.050000
2025-09-25,Smurfit Westrock,21,65,14,100,0.140000
2025-09-25,Snap Inc,28,55,17,100,0.170000
2025-09-25,Snap-on,15,75,10,100,0.100000
2025-09-25,Snowflake Inc,53,47,0,100,0.000000
2025-09-25,Solventum,34,62,4,100,0.040000
2025-09-25,Sonic Automotive,20,78,2,100,0.020000
2025-09-25,Sonoco Products,26,64,10,100,0.100000
2025-09-25,Southern Company,43,55,2,100,0.020000
2025-09-25,Southwest Airlines,26,65,11,102,0.107843
2025-09-25,Southwest Gas Holdings,37,58,5,100,0.050000
2025-09-25,SpartanNash,21,77,2,100,0.020000
2025-09-25,Spectrum Brands,29,59,12,100,0.120000
2025-09-25,Spire Inc,53,43,4,100,0.040000
2025-09-25,Spirit AeroSystems,37,47,16,100,0.160000
2025-09-25,Spirit Airlines,18,63,11,92,0.119565
2025-09-25,Splunk,41,49,10,100,0.100000
2025-09-25,Sprouts Farmers Market,24,73,3,100,0.030000
2025-09-25,Stagwell,29,61,10,100,0.100000
2025-09-25,Stanley Black & Decker,26,65,9,100,0.090000
2025-09-25,Starbucks,18,61,21,100,0.210000
2025-09-25,State Farm Insurance,17,61,22,100,0.220000
2025-09-25,State Street,26,62,12,100,0.120000
2025-09-25,Steel Dynamics,88,9,3,100,0.030000
2025-09-25,Steelcase,25,72,3,100,0.030000
2025-09-25,Stericycle,10,39,51,100,0.510000
2025-09-25,Stifel Financial,35,61,4,100,0.040000
2025-09-25,StoneX Group,34,62,4,100,0.040000
2025-09-25,Stryker,29,59,12,100,0.120000
2025-09-25,Summit Materials,25,67,8,100,0.080000
2025-09-25,Sun Communities,42,46,12,100,0.120000
2025-09-25,Super Micro Computer,88,12,2,102,0.019608
2025-09-25,Surgery Partners,31,58,11,100,0.110000
2025-09-25,Sylvamo,21,62,17,100,0.170000
2025-09-25,Synchrony Financial,55,41,4,100,0.040000
2025-09-25,Synopsys,25,57,18,100,0.180000
2025-09-25,Synovus Financial,41,54,5,100,0.050000
2025-09-25,Sysco,49,45,6,100,0.060000
2025-09-25,T Rowe Price,45,53,2,100,0.020000
2025-09-25,TD Synnex,52,46,2,100,0.020000
2025-09-25,TEGNA,22,72,6,100,0.060000
2025-09-25,THOR Industries,24,70,6,100,0.060000
2025-09-25,TIAA,23,69,8,100,0.080000
2025-09-25,TJX,56,39,5,100,0.050000
2025-09-25,Take-Two Interactive Software,37,59,4,100,0.040000
2025-09-25,Talen Energy,91,8,1,100,0.010000
2025-09-25,Tapestry,33,59,8,100,0.080000
2025-09-25,Targa Resources,47,47,6,100,0.060000
2025-09-25,Target Corporation,47,50,3,100,0.030000
2025-09-25,Taylor Morrison Home,30,64,6,100,0.060000
2025-09-25,Teladoc Health,35,53,12,100,0.120000
2025-09-25,Teledyne Technologies,35,64,1,100,0.010000
2025-09-25,Teleflex,23,70,7,100,0.070000
2025-09-25,Telephone & Data Systems,5,19,0,24,0.000000
2025-09-25,TelevisaUnivision,31,56,13,100,0.130000
2025-09-25,Tempur Sealy International,29,61,10,100,0.100000
2025-09-25,Tenet Healthcare,38,54,8,100,0.080000
2025-09-25,Teradyne,26,70,4,100,0.040000
2025-09-25,Terex,19,75,6,100,0.060000
2025-09-25,Tesla,30,53,16,99,0.161616
2025-09-25,Tetra Tech,41,50,9,100,0.090000
2025-09-25,Texas Instruments,26,65,9,100,0.090000
2025-09-25,Texas Roadhouse,35,56,9,100,0.090000
2025-09-25,Textron,24,69,7,100,0.070000
2025-09-25,The Andersons Inc,28,70,2,100,0.020000
2025-09-25,The Coca-Cola Company,29,61,10,100,0.100000
2025-09-25,The Greenbrier Companies,26,67,7,100,0.070000
2025-09-25,The Hartford,23,53,24,100,0.240000
2025-09-25,The Mosaic Company,32,61,7,100,0.070000
2025-09-25,Thermo Fisher Scientific,38,57,5,100,0.050000
2025-09-25,Thrivent Financial for Lutherans,30,58,4,92,0.043478
2025-09-25,Timken,23,68,9,100,0.090000
2025-09-25,Titan Machinery,17,72,11,100,0.110000
2025-09-25,Toast Inc,33,58,9,100,0.090000
2025-09-25,Toll Brothers,8,89,3,100,0.030000
2025-09-25,TopBuild,22,77,1,100,0.010000
2025-09-25,Topgolf Callaway Brands,24,64,12,100,0.120000
2025-09-25,Toro Company,27,66,7,100,0.070000
2025-09-25,Tractor Supply,25,71,4,100,0.040000
2025-09-25,TransDigm,41,52,7,100,0.070000
2025-09-25,TransUnion,37,50,13,100,0.130000
2025-09-25,Travelers Insurance,38,44,18,100,0.180000
2025-09-25,TreeHouse Foods,20,63,17,100,0.170000
2025-09-25,Tri Pointe Homes,28,67,5,100,0.050000
2025-09-25,TriNet Group,30,65,5,100,0.050000
2025-09-25,Trimble Inc,33,64,3,100,0.030000
2025-09-25,Trinity Industries,29,57,14,100,0.140000
2025-09-25,TruStage,48,46,6,100,0.060000
2025-09-25,Truist Financial,36,59,5,100,0.050000
2025-09-25,Tutor Perini Corporation,57,38,5,100,0.050000
2025-09-25,Twilio,41,53,6,100,0.060000
2025-09-25,Tyson Foods,24,63,13,100,0.130000
2025-09-25,U-Haul,11,41,48,100,0.480000
2025-09-25,UFP Industries,24,71,5,100,0.050000
2025-09-25,UGI Utilities Inc,28,38,16,82,0.195122
2025-09-25,UL Solutions,47,52,1,100,0.010000
2025-09-25,UPS,22,45,31,98,0.316327
2025-09-25,US Bancorp,33,63,4,100,0.040000
2025-09-25,US Foods,51,46,3,100,0.030000
2025-09-25,USAA,28,55,17,100,0.170000
2025-09-25,Uber,18,61,20,99,0.202020
2025-09-25,Ulta Beauty,82,15,3,100,0.030000
2025-09-25,Under Armour,26,67,7,100,0.070000
2025-09-25,Union Pacific,33,54,5,92,0.054348
2025-09-25,United Airlines,54,32,6,92,0.065217
2025-09-25,United Natural Foods,82,14,4,100,0.040000
2025-09-25,United Rentals,94,4,2,100,0.020000
2025-09-25,United States Steel,50,44,6,100,0.060000
2025-09-25,UnitedHealth,44,43,13,100,0.130000
2025-09-25,Universal Corporation,31,61,8,100,0.080000
2025-09-25,Universal Health Services,35,56,9,100,0.090000
2025-09-25,Unum Group,41,52,7,100,0.070000
2025-09-25,Upbound Group,42,56,2,100,0.020000
2025-09-25,Urban Outfitters,45,53,2,100,0.020000
2025-09-25,V2X,48,43,9,100,0.090000
2025-09-25,VF Corporation,23,58,19,100,0.190000
2025-09-25,VICI Properties,35,62,3,100,0.030000
2025-09-25,Vail Resorts,23,58,19,100,0.190000
2025-09-25,Valero Energy,87,11,2,100,0.020000
2025-09-25,Valley National Bancorp,26,70,4,100,0.040000
2025-09-25,Valmont Industries,40,54,6,100,0.060000
2025-09-25,Valvoline Inc,37,57,6,100,0.060000
2025-09-25,Ventas Inc,40,60,0,100,0.000000
2025-09-25,Verisk Analytics,36,49,15,100,0.150000
2025-09-25,Verizon,41,52,7,100,0.070000
2025-09-25,Vertex Pharmaceuticals,45,39,16,100,0.160000
2025-09-25,Vertiv,46,51,3,100,0.030000
2025-09-25,Viasat,33,57,10,100,0.100000
2025-09-25,Viatris,28,61,11,100,0.110000
2025-09-25,Victorias Secret,27,57,16,100,0.160000
2025-09-25,Visa Inc,65,32,3,100,0.030000
2025-09-25,Vishay Intertechnology,27,64,9,100,0.090000
2025-09-25,Vista Outdoor,21,64,15,100,0.150000
2025-09-25,Visteon,43,57,0,100,0.000000
2025-09-25,Vistra,44,51,5,100,0.050000
2025-09-25,Vontier,41,57,2,100,0.020000
2025-09-25,Voya Financial,42,55,3,100,0.030000
2025-09-25,Vulcan Materials,31,57,12,100,0.120000
2025-09-25,WEC Energy,85,15,0,100,0.000000
2025-09-25,WESCO International,39,56,5,100,0.050000
2025-09-25,WEX,38,60,2,100,0.020000
2025-09-25,WR Berkley,38,54,8,100,0.080000
2025-09-25,WW Grainger,34,58,8,100,0.080000
2025-09-25,Wabash National,20,57,23,100,0.230000
2025-09-25,Walmart,32,48,20,100,0.200000
2025-09-25,Walt Disney,36,56,10,102,0.098039
2025-09-25,Warner Bros Discovery,17,71,12,100,0.120000
2025-09-25,Warner Music Group,22,70,8,100,0.080000
2025-09-25,Waters Corporation,42,53,5,100,0.050000
2025-09-25,Watsco,27,60,13,100,0.130000
2025-09-25,Wayfair,35,65,0,100,0.000000
2025-09-25,Webster Financial,31,59,10,100,0.100000
2025-09-25,Weis Markets,23,66,11,100,0.110000
2025-09-25,Wells Fargo,78,17,5,100,0.050000
2025-09-25,Welltower,64,35,1,100,0.010000
2025-09-25,Werner Enterprises,33,56,11,100,0.110000
2025-09-25,West Pharmaceutical Services,42,51,7,100,0.070000
2025-09-25,Western & Southern Financial,30,66,4,100,0.040000
2025-09-25,Western Alliance Bancorp,20,53,20,93,0.215054
2025-09-25,Western Digital,25,71,4,100,0.040000
2025-09-25,Western Midstream Partners,32,62,6,100,0.060000
2025-09-25,Western Union,23,70,7,100,0.070000
2025-09-25,Westinghouse Air Brake Technologies,31,63,6,100,0.060000
2025-09-25,Weyerhaeuser,30,63,7,100,0.070000
2025-09-25,Whirlpool,26,58,16,100,0.160000
2025-09-25,Williams Companies,53,41,6,100,0.060000
2025-09-25,Williams-Sonoma,24,70,6,100,0.060000
2025-09-25,Winnebago Industries,20,64,16,100,0.160000
2025-09-25,Wintrust Financial,35,64,1,100,0.010000
2025-09-25,Woodward Inc,32,66,2,100,0.020000
2025-09-25,Workday,30,60,10,100,0.100000
2025-09-25,World Kinect,32,62,6,100,0.060000
2025-09-25,Worthington Enterprises,33,66,1,100,0.010000
2025-09-25,Wynn Resorts,23,68,9,100,0.090000
2025-09-25,XPO,28,62,10,100,0.100000
2025-09-25,Xcel Energy,47,33,12,92,0.130435
2025-09-25,Xerox,22,62,16,100,0.160000
2025-09-25,Xylem Inc,45,49,6,100,0.060000
2025-09-25,Yum Brands,29,65,6,100,0.060000
2025-09-25,Yum China,38,54,8,100,0.080000
2025-09-25,Zebra Technologies,32,61,7,100,0.070000
2025-09-25,Zimmer Biomet,34,64,2,100,0.020000
2025-09-25,Zions Bancorp,37,51,12,100,0.120000
2025-09-25,Zoetis,50,45,5,100,0.050000
2025-09-25,Zoom Video Communications,31,55,14,100,0.140000
2025-09-25,eXp World,27,69,4,100,0.040000
2025-09-25,iHeartMedia,25,69,6,100,0.060000
2025-09-26,3M,31,62,7,100,0.070000
2025-09-26,A O Smith,23,76,1,100,0.010000
2025-09-26,A-Mark Precious Metals,88,12,0,100,0.000000
2025-09-26,ABM Industries,26,59,15,100,0.150000
2025-09-26,ADT,37,43,20,100,0.200000
2025-09-26,AECOM,44,50,6,100,0.060000
2025-09-26,AES,37,55,8,100,0.080000
2025-09-26,AGCO,31,63,6,100,0.060000
2025-09-26,AGNC Investment,34,55,11,100,0.110000
2025-09-26,AIG,30,63,7,100,0.070000
2025-09-26,AMC Entertainment,78,17,5,100,0.050000
2025-09-26,AMC Networks,26,62,12,100,0.120000
2025-09-26,AMN Healthcare Services,19,65,16,100,0.160000
2025-09-26,APA,32,55,13,100,0.130000
2025-09-26,APi Group,34,58,8,100,0.080000
2025-09-26,ARKO,25,70,5,100,0.050000
2025-09-26,ASGN,26,69,5,100,0.050000
2025-09-26,AT&T,32,57,11,100,0.110000
2025-09-26,ATI Inc,34,63,3,100,0.030000
2025-09-26,AbbVie,38,49,13,100,0.130000
2025-09-26,Abbott Laboratories,53,42,5,100,0.050000
2025-09-26,Abercrombie & Fitch,31,61,8,100,0.080000
2025-09-26,Academy Sports and Outdoors,30,62,8,100,0.080000
2025-09-26,Acadia Healthcare,18,67,15,100,0.150000
2025-09-26,Ace Hardware,25,62,13,100,0.130000
2025-09-26,Acuity Inc,28,37,6,71,0.084507
2025-09-26,Adams Resources & Energy,19,6,1,26,0.038462
2025-09-26,AdaptHealth,32,59,9,100,0.090000
2025-09-26,Adobe,42,52,6,100,0.060000
2025-09-26,Advance Auto Parts,22,62,16,100,0.160000
2025-09-26,Advanced Drainage Systems,82,17,1,100,0.010000
2025-09-26,Advanced Micro Devices,81,19,2,102,0.019608
2025-09-26,Advantage Solutions,74,24,2,100,0.020000
2025-09-26,Aflac,38,45,17,100,0.170000
2025-09-26,Agilent Technologies,32,63,5,100,0.050000
2025-09-26,Agilon Health,26,64,10,100,0.100000
2025-09-26,Air Lease,30,66,4,100,0.040000
2025-09-26,Air Products & Chemicals,25,63,12,100,0.120000
2025-09-26,Airbnb,32,56,12,100,0.120000
2025-09-26,Akamai Technologies,40,49,11,100,0.110000
2025-09-26,Alaska Air,33,62,5,100,0.050000
2025-09-26,Albemarle Corporation,32,60,8,100,0.080000
2025-09-26,Albertsons,40,51,9,100,0.090000
2025-09-26,Alcoa Corporation,24,58,18,100,0.180000
2025-09-26,Alexandria Real Estate Equities,39,54,7,100,0.070000
2025-09-26,Alight Solutions,27,68,5,100,0.050000
2025-09-26,Align Technology,16,67,17,100,0.170000
2025-09-26,Allegiant Travel Company,22,70,8,100,0.080000
2025-09-26,Alliance Resource Partners,32,57,11,100,0.110000
2025-09-26,Alliant Energy,79,20,1,100,0.010000
2025-09-26,Allison Transmission,28,62,10,100,0.100000
2025-09-26,Allstate,59,28,13,100,0.130000
2025-09-26,Ally Financial,34,63,3,100,0.030000
2025-09-26,Alpha Metallurgical Resources,36,52,12,100,0.120000
2025-09-26,Alphabet,31,53,16,100,0.160000
2025-09-26,Altice USA,33,58,9,100,0.090000
2025-09-26,Altria,50,43,7,100,0.070000
2025-09-26,Amazon,26,65,12,103,0.116505
2025-09-26,Ameren,36,49,15,100,0.150000
2025-09-26,American Airlines,17,32,49,98,0.500000
2025-09-26,American Axle & Manufacturing,32,55,13,100,0.130000
2025-09-26,American Eagle Outfitters,33,53,14,100,0.140000
2025-09-26,American Electric Power,39,52,9,100,0.090000
2025-09-26,American Express,43,55,2,100,0.020000
2025-09-26,American Family Insurance,47,47,6,100,0.060000
2025-09-26,American Financial Group,29,60,11,100,0.110000
2025-09-26,American Tower,51,42,7,100,0.070000
2025-09-26,American Water Works,43,53,4,100,0.040000
2025-09-26,Americold Realty Trust,73,22,5,100,0.050000
2025-09-26,Ameriprise Financial,47,45,8,100,0.080000
2025-09-26,Ametek,29,67,4,100,0.040000
2025-09-26,Amgen,28,57,15,100,0.150000
2025-09-26,Amica Mutual Insurance,24,67,5,96,0.052083
2025-09-26,Amkor Technology,39,56,5,100,0.050000
2025-09-26,Amphenol,30,68,2,100,0.020000
2025-09-26,Analog Devices,35,60,5,100,0.050000
2025-09-26,Antero Resources,37,62,1,100,0.010000
2025-09-26,Anywhere Real Estate Inc,35,56,5,96,0.052083
2025-09-26,Apollo Global Management,29,65,6,100,0.060000
2025-09-26,AppLovin,32,59,9,100,0.090000
2025-09-26,Apple,30,61,9,100,0.090000
2025-09-26,Applied Industrial Technologies,29,69,2,100,0.020000
2025-09-26,Applied Materials,18,61,21,100,0.210000
2025-09-26,AptarGroup,30,66,4,100,0.040000
2025-09-26,Aramark,42,52,6,100,0.060000
2025-09-26,ArcBest,27,69,4,100,0.040000
2025-09-26,Arch Resources,61,29,10,100,0.100000
2025-09-26,Archer Daniels Midland,42,50,8,100,0.080000
2025-09-26,Ares Management,40,60,0,100,0.000000
2025-09-26,Arista Networks,32,58,10,100,0.100000
2025-09-26,Arrow Electronics,27,69,4,100,0.040000
2025-09-26,Arthur J Gallagher,36,62,2,100,0.020000
2025-09-26,Asbury Automotive Group,29,62,9,100,0.090000
2025-09-26,Assurant,40,52,8,100,0.080000
2025-09-26,Atkore,21,68,11,100,0.110000
2025-09-26,Atlassian,19,62,19,100,0.190000
2025-09-26,Atmos Energy,85,11,4,100,0.040000
2025-09-26,Auto-Owners Insurance,32,61,7,100,0.070000
2025-09-26,AutoNation,28,60,12,100,0.120000
2025-09-26,AutoZone,24,64,12,100,0.120000
2025-09-26,Autodesk,27,71,2,100,0.020000
2025-09-26,Autoliv,46,50,4,100,0.040000
2025-09-26,Automatic Data Processing,43,49,8,100,0.080000
2025-09-26,AvalonBay Communities,32,62,6,100,0.060000
2025-09-26,Avantor,31,58,11,100,0.110000
2025-09-26,Avery Dennison,29,68,3,100,0.030000
2025-09-26,Avient,31,60,9,100,0.090000
2025-09-26,Avis Budget,19,69,12,100,0.120000
2025-09-26,Avnet,23,72,5,100,0.050000
2025-09-26,BJ's Wholesale Club,29,60,11,100,0.110000
2025-09-26,BOK Financial,38,53,9,100,0.090000
2025-09-26,BWX Technologies,43,55,2,100,0.020000
2025-09-26,Baker Hughes,42,57,1,100,0.010000
2025-09-26,Ball Corporation,30,69,1,100,0.010000
2025-09-26,Bank of America,44,52,4,100,0.040000
2025-09-26,Bank of New York Mellon,52,45,3,100,0.030000
2025-09-26,Bath & Body Works,38,50,12,100,0.120000
2025-09-26,Baxter International,22,67,11,100,0.110000
2025-09-26,Becton Dickinson,40,54,6,100,0.060000
2025-09-26,Belden,31,61,8,100,0.080000
2025-09-26,Benchmark Electronics,21,74,5,100,0.050000
2025-09-26,Berkshire Hathaway,28,54,20,102,0.196078
2025-09-26,Berry Global,24,65,11,100,0.110000
2025-09-26,Best Buy,92,7,1,100,0.010000
2025-09-26,Bio-Rad Laboratories,24,68,8,100,0.080000
2025-09-26,Biogen,26,65,11,102,0.107843
2025-09-26,BlackRock,28,68,5,101,0.049505
2025-09-26,Blackstone,31,60,9,100,0.090000
2025-09-26,Bloomin Brands,11,76,13,100,0.130000
2025-09-26,BlueLinx,22,74,4,100,0.040000
2025-09-26,Boeing,35,65,6,106,0.056604
2025-09-26,Boise Cascade,15,72,13,100,0.130000
2025-09-26,Booking Holdings,34,58,8,100,0.080000
2025-09-26,Booz Allen Hamilton,24,63,13,100,0.130000
2025-09-26,BorgWarner,54,41,5,100,0.050000
2025-09-26,Boston Properties,21,77,2,100,0.020000
2025-09-26,Boston Scientific,42,52,6,100,0.060000
2025-09-26,Boyd Gaming,22,61,10,93,0.107527
2025-09-26,Bread Financial,47,51,2,100,0.020000
2025-09-26,BrightSpring Health Services,31,61,8,100,0.080000
2025-09-26,BrightView Holdings,29,66,5,100,0.050000
2025-09-26,Brighthouse Financial,32,64,4,100,0.040000
2025-09-26,Brinker International,42,56,2,100,0.020000
2025-09-26,Brinks Company,13,6,3,22,0.136364
2025-09-26,Bristol-Myers Squibb,22,62,16,100,0.160000
2025-09-26,Broadcom,37,60,5,102,0.049020
2025-09-26,Broadridge Financial Solutions,59,40,1,100,0.010000
2025-09-26,Brookdale Senior Living,33,56,11,100,0.110000
2025-09-26,Brown & Brown,26,60,14,100,0.140000
2025-09-26,Brown-Forman,16,71,13,100,0.130000
2025-09-26,Bruker,21,64,15,100,0.150000
2025-09-26,Brunswick Corporation,45,44,11,100,0.110000
2025-09-26,Builders FirstSource,38,55,7,100,0.070000
2025-09-26,Burlington Stores,31,66,3,100,0.030000
2025-09-26,CACI International,54,43,3,100,0.030000
2025-09-26,CBRE Group,30,69,1,100,0.010000
2025-09-26,CDW,35,58,7,100,0.070000
2025-09-26,CF Industries,36,58,6,100,0.060000
2025-09-26,CH Robinson Worldwide,36,60,4,100,0.040000
2025-09-26,CHS,40,52,8,100,0.080000
2025-09-26,CIncinnati Financial,36,57,7,100,0.070000
2025-09-26,CME Group,23,73,4,100,0.040000
2025-09-26,CMS Energy,85,12,3,100,0.030000
2025-09-26,CNO Financial Group,32,65,3,100,0.030000
2025-09-26,CNX Resources,42,54,4,100,0.040000
2025-09-26,CSX,31,62,7,100,0.070000
2025-09-26,CVS Health,40,45,15,100,0.150000
2025-09-26,Cabot Corporation,33,62,5,100,0.050000
2025-09-26,Cadence,30,56,14,100,0.140000
2025-09-26,Caesars Entertainment,75,23,2,100,0.020000
2025-09-26,Cal-Maine Foods,53,43,4,100,0.040000
2025-09-26,Caleres Inc,32,62,6,100,0.060000
2025-09-26,California Resources,42,48,10,100,0.100000
2025-09-26,Calumet Inc,31,45,10,86,0.116279
2025-09-26,Campbell Soup,31,61,8,100,0.080000
2025-09-26,Camping World,26,64,10,100,0.100000
2025-09-26,Capital One,35,52,13,100,0.130000
2025-09-26,CarMax,14,55,23,92,0.250000
2025-09-26,Cardinal Health,38,54,8,100,0.080000
2025-09-26,Carlisle Companies,32,61,7,100,0.070000
2025-09-26,Carlyle Group,30,66,4,100,0.040000
2025-09-26,Carpenter Technology,35,60,5,100,0.050000
2025-09-26,Carrier Global,33,57,10,100,0.100000
2025-09-26,Carters Inc,16,28,2,46,0.043478
2025-09-26,Carvana,29,62,9,100,0.090000
2025-09-26,Caseys General Stores,32,61,7,100,0.070000
2025-09-26,Catalent,21,72,7,100,0.070000
2025-09-26,Caterpillar,24,69,7,100,0.070000
2025-09-26,Cboe Global Markets,31,69,0,100,0.000000
2025-09-26,Celanese,23,51,26,100,0.260000
2025-09-26,Cencora,55,42,3,100,0.030000
2025-09-26,Centene,31,44,25,100,0.250000
2025-09-26,CenterPoint Energy,76,20,4,100,0.040000
2025-09-26,Central Garden & Pet,23,73,4,100,0.040000
2025-09-26,Century Communities,30,66,4,100,0.040000
2025-09-26,ChampionX,37,62,1,100,0.010000
2025-09-26,Charles River Laboratories International,26,62,12,100,0.120000
2025-09-26,Charles Schwab,35,60,6,101,0.059406
2025-09-26,Chart Industries,34,62,4,100,0.040000
2025-09-26,Charter Communications,23,62,15,100,0.150000
2025-09-26,Cheesecake Factory,26,57,17,100,0.170000
2025-09-26,Chefs Warehouse,42,52,6,100,0.060000
2025-09-26,Chemours,34,50,16,100,0.160000
2025-09-26,Cheniere Energy,90,10,0,100,0.000000
2025-09-26,Chevron,32,45,23,100,0.230000
2025-09-26,Chewy,42,49,9,100,0.090000
2025-09-26,Chipotle Mexican Grill,27,64,9,100,0.090000
2025-09-26,Chord Energy,92,8,0,100,0.000000
2025-09-26,Church & Dwight,31,60,9,100,0.090000
2025-09-26,Ciena,39,56,5,100,0.050000
2025-09-26,Cigna,38,51,11,100,0.110000
2025-09-26,Cinemark,28,58,14,100,0.140000
2025-09-26,Cintas,38,57,5,100,0.050000
2025-09-26,Cisco Systems,26,63,11,100,0.110000
2025-09-26,Citigroup,28,64,9,101,0.089109
2025-09-26,Citizens Financial Group,37,59,4,100,0.040000
2025-09-26,Civitas Resources,25,55,20,100,0.200000
2025-09-26,Clean Harbors,75,14,11,100,0.110000
2025-09-26,Clear Channel Outdoor Hldgs,7,2,1,10,0.100000
2025-09-26,Cleveland-Cliffs,21,66,13,100,0.130000
2025-09-26,Clorox,30,54,16,100,0.160000
2025-09-26,Cognizant Technology Solutions,37,58,5,100,0.050000
2025-09-26,Coherent,29,70,1,100,0.010000
2025-09-26,Coinbase Global,18,71,11,100,0.110000
2025-09-26,Colgate-Palmolive,34,58,8,100,0.080000
2025-09-26,Columbia Banking System,37,60,3,100,0.030000
2025-09-26,Columbia Sportswear,28,56,16,100,0.160000
2025-09-26,Comcast,35,45,20,100,0.200000
2025-09-26,Comerica,45,44,11,100,0.110000
2025-09-26,Comfort Systems USA,93,7,0,100,0.000000
2025-09-26,CommScope,22,75,3,100,0.030000
2025-09-26,Commercial Metals,31,62,7,100,0.070000
2025-09-26,Community Health Systems,25,58,17,100,0.170000
2025-09-26,Compass Group,30,54,16,100,0.160000
2025-09-26,Conagra Brands,33,56,11,100,0.110000
2025-09-26,Concentrix,29,62,9,100,0.090000
2025-09-26,Conduent,29,58,13,100,0.130000
2025-09-26,ConocoPhillips,50,40,10,100,0.100000
2025-09-26,Consol Energy,78,20,2,100,0.020000
2025-09-26,Consolidated Edison,35,59,6,100,0.060000
2025-09-26,Constellation Brands,16,58,26,100,0.260000
2025-09-26,Constellation Energy,79,20,1,100,0.010000
2025-09-26,Continental Resources,37,51,12,100,0.120000
2025-09-26,Cooper Cos,3,23,3,29,0.103448
2025-09-26,Cooper-Standard,30,65,5,100,0.050000
2025-09-26,Copart,47,49,4,100,0.040000
2025-09-26,Core & Main,27,61,12,100,0.120000
2025-09-26,Corebridge Financial,38,58,4,100,0.040000
2025-09-26,Cornerstone Building Brands,26,62,12,100,0.120000
2025-09-26,Corning,36,53,11,100,0.110000
2025-09-26,Corpay,25,73,1,99,0.010101
2025-09-26,Corteva,31,64,5,100,0.050000
2025-09-26,Costco,31,59,8,98,0.081633
2025-09-26,Coterra Energy,80,17,3,100,0.030000
2025-09-26,Coty,27,57,16,100,0.160000
2025-09-26,Country Financial,24,60,16,100,0.160000
2025-09-26,Coupang,29,59,12,100,0.120000
2025-09-26,Cracker Barrel Old Country Store,20,66,14,100,0.140000
2025-09-26,Crocs,29,62,9,100,0.090000
2025-09-26,CrossAmerica Partners,24,71,5,100,0.050000
2025-09-26,CrowdStrike,34,51,15,100,0.150000
2025-09-26,Crown Castle,42,55,3,100,0.030000
2025-09-26,Crown Holdings,37,59,4,100,0.040000
2025-09-26,Cullen Frost Bankers,40,56,4,100,0.040000
2025-09-26,Cummins Inc,58,40,2,100,0.020000
2025-09-26,Curtiss-Wright,47,51,2,100,0.020000
2025-09-26,DR Horton,24,70,6,100,0.060000
2025-09-26,DTE Energy,73,21,6,100,0.060000
2025-09-26,DXC Technology,28,69,3,100,0.030000
2025-09-26,DaVita,28,52,20,100,0.200000
2025-09-26,Dana Incorporated,35,58,7,100,0.070000
2025-09-26,Danaher,53,41,6,100,0.060000
2025-09-26,Darden Restaurants,35,55,10,100,0.100000
2025-09-26,Darling Ingredients,87,9,4,100,0.040000
2025-09-26,Deckers Outdoor,35,54,11,100,0.110000
2025-09-26,Deere,29,60,11,100,0.110000
2025-09-26,Delek US,40,54,6,100,0.060000
2025-09-26,Dell Technologies,40,58,2,100,0.020000
2025-09-26,Delta Air Lines,21,57,22,100,0.220000
2025-09-26,Dentsply Sirona,30,67,3,100,0.030000
2025-09-26,Designer Brands,18,69,13,100,0.130000
2025-09-26,Devon Energy,91,8,1,100,0.010000
2025-09-26,DexCom,19,69,12,100,0.120000
2025-09-26,Diamondback Energy,85,13,2,100,0.020000
2025-09-26,Dicks Sporting Goods,27,68,5,100,0.050000
2025-09-26,Diebold Nixdorf,33,66,1,100,0.010000
2025-09-26,Digital Realty Trust,84,16,0,100,0.000000
2025-09-26,Dillards,29,57,14,100,0.140000
2025-09-26,Discover Financial,33,59,8,100,0.080000
2025-09-26,DocuSign,39,48,13,100,0.130000
2025-09-26,Dollar General,18,61,21,100,0.210000
2025-09-26,Dollar Tree,39,54,7,100,0.070000
2025-09-26,Dominion Energy,68,27,5,100,0.050000
2025-09-26,Dominos Pizza Inc,15,33,3,51,0.058824
2025-09-26,Domtar,26,64,10,100,0.100000
2025-09-26,Donaldson Company,45,49,6,100,0.060000
2025-09-26,DoorDash,37,47,16,100,0.160000
2025-09-26,Dover Corporation,47,52,1,100,0.010000
2025-09-26,DraftKings,59,29,4,92,0.043478
2025-09-26,Dream Finders Homes,80,18,2,100,0.020000
2025-09-26,Dropbox,29,66,5,100,0.050000
2025-09-26,DuPont,30,61,9,100,0.090000
2025-09-26,Duke Energy,83,11,8,102,0.078431
2025-09-26,Dycom Industries,35,61,4,100,0.040000
2025-09-26,EMCOR Group,31,66,3,100,0.030000
2025-09-26,EOG Resources,46,47,7,100,0.070000
2025-09-26,EPAM Systems,34,63,3,100,0.030000
2025-09-26,EQT,37,57,6,100,0.060000
2025-09-26,ESAB,35,60,5,100,0.050000
2025-09-26,East West Bancorp,41,55,4,100,0.040000
2025-09-26,Eastman Chemical,21,57,22,100,0.220000
2025-09-26,Ebay,28,63,9,100,0.090000
2025-09-26,EchoStar,16,74,10,100,0.100000
2025-09-26,Ecolab,46,51,3,100,0.030000
2025-09-26,Edison International,29,53,18,100,0.180000
2025-09-26,Edward Jones,36,57,7,100,0.070000
2025-09-26,Edwards Lifesciences,41,40,19,100,0.190000
2025-09-26,Elanco Animal Health,41,56,3,100,0.030000
2025-09-26,Electronic Arts,23,64,13,100,0.130000
2025-09-26,Elevance Health,37,46,17,100,0.170000
2025-09-26,Eli Lilly,12,75,13,100,0.130000
2025-09-26,Emerson Electric,48,49,3,100,0.030000
2025-09-26,EnLink Midstream,42,50,8,100,0.080000
2025-09-26,Encompass Health,30,62,8,100,0.080000
2025-09-26,Endeavor Group,17,74,9,100,0.090000
2025-09-26,Endeavor Group Holdings,19,71,10,100,0.100000
2025-09-26,EnerSys,38,55,7,100,0.070000
2025-09-26,Energizer Holdings,84,16,0,100,0.000000
2025-09-26,Energy Transfer,85,11,4,100,0.040000
2025-09-26,Ensign Group,42,55,3,100,0.030000
2025-09-26,Entegris,31,62,7,100,0.070000
2025-09-26,Entergy,38,55,6,99,0.060606
2025-09-26,Enterprise Products Partners,44,38,18,100,0.180000
2025-09-26,Envista,25,66,9,100,0.090000
2025-09-26,Equifax,43,47,10,100,0.100000
2025-09-26,Equinix,41,59,0,100,0.000000
2025-09-26,Equitable Holdings,39,56,5,100,0.050000
2025-09-26,Equity Residential,34,61,5,100,0.050000
2025-09-26,Erie Insurance,27,59,14,100,0.140000
2025-09-26,Estée Lauder,30,59,11,100,0.110000
2025-09-26,Etsy,21,53,28,102,0.274510
2025-09-26,Euronet Worldwide,27,66,7,100,0.070000
2025-09-26,Evergy,46,42,7,95,0.073684
2025-09-26,Eversource Energy,70,24,6,100,0.060000
2025-09-26,Exact Sciences,28,49,23,100,0.230000
2025-09-26,Exelon,38,57,5,100,0.050000
2025-09-26,Expand Energy Corporation,94,6,0,100,0.000000
2025-09-26,Expedia,46,45,9,100,0.090000
2025-09-26,Expeditors International of Washington,28,67,5,100,0.050000
2025-09-26,Extra Space Storage,22,65,13,100,0.130000
2025-09-26,Exxon Mobil,48,47,5,100,0.050000
2025-09-26,F5,38,57,5,100,0.050000
2025-09-26,FM Global,35,46,19,100,0.190000
2025-09-26,FMC Corporation,39,47,14,100,0.140000
2025-09-26,FTI Consulting,29,61,10,100,0.100000
2025-09-26,Fannie Mae,16,72,12,100,0.120000
2025-09-26,Farmers Insurance Exchange,19,63,18,100,0.180000
2025-09-26,Fastenal,66,33,1,100,0.010000
2025-09-26,FedEx,32,47,21,100,0.210000
2025-09-26,Federated Mutual Insurance,20,21,6,47,0.127660
2025-09-26,Ferguson Enterprises,37,57,6,100,0.060000
2025-09-26,Fidelity National Financial,34,58,8,100,0.080000
2025-09-26,Fidelity National Information Services,47,41,12,100,0.120000
2025-09-26,Fifth Third Bancorp,45,52,3,100,0.030000
2025-09-26,First American Financial,32,56,12,100,0.120000
2025-09-26,First Citizens BancShares,38,58,4,100,0.040000
2025-09-26,First Horizon,41,58,1,100,0.010000
2025-09-26,First National of Nebraska,18,34,1,53,0.018868
2025-09-26,First Solar,35,62,3,100,0.030000
2025-09-26,FirstCash,31,60,9,100,0.090000
2025-09-26,FirstEnergy,46,39,15,100,0.150000
2025-09-26,Fiserv,30,61,9,100,0.090000
2025-09-26,Five Below,34,54,12,100,0.120000
2025-09-26,Flagstar Financial,25,62,13,100,0.130000
2025-09-26,Floor & Decor,35,57,8,100,0.080000
2025-09-26,Flowers Foods,21,64,15,100,0.150000
2025-09-26,Flowserve,28,69,3,100,0.030000
2025-09-26,Fluor,36,49,15,100,0.150000
2025-09-26,Foot Locker,12,72,16,100,0.160000
2025-09-26,Ford Motor,25,59,16,100,0.160000
2025-09-26,Fortinet,25,44,31,100,0.310000
2025-09-26,Fortive,21,65,14,100,0.140000
2025-09-26,Fortune Brands Innovations,27,66,7,100,0.070000
2025-09-26,Franklin Resources,34,58,8,100,0.080000
2025-09-26,Freddie Mac,24,68,8,100,0.080000
2025-09-26,Freeport-McMoRan,10,59,23,92,0.250000
2025-09-26,Frontier Airlines,24,64,12,100,0.120000
2025-09-26,Frontier Communications,40,54,6,100,0.060000
2025-09-26,G-III Apparel Group,31,63,6,100,0.060000
2025-09-26,GE HealthCare Technologies,33,61,6,100,0.060000
2025-09-26,GE Vernova,47,48,5,100,0.050000
2025-09-26,GMS,25,70,5,100,0.050000
2025-09-26,GXO Logistics,32,61,7,100,0.070000
2025-09-26,GameStop,26,60,14,100,0.140000
2025-09-26,Gannett,27,61,12,100,0.120000
2025-09-26,Garrett Motion Inc,38,57,5,100,0.050000
2025-09-26,Gartner,24,66,10,100,0.100000
2025-09-26,Gen Digital,49,49,2,100,0.020000
2025-09-26,Generac,28,65,7,100,0.070000
2025-09-26,General Dynamics,90,9,1,100,0.010000
2025-09-26,General Mills,37,59,4,100,0.040000
2025-09-26,General Motors,35,59,6,100,0.060000
2025-09-26,Genesis Energy,77,20,3,100,0.030000
2025-09-26,Genuine Parts,39,60,1,100,0.010000
2025-09-26,Genworth Financial,52,44,4,100,0.040000
2025-09-26,Gilead Sciences,38,59,3,100,0.030000
2025-09-26,Global Partners,39,48,13,100,0.130000
2025-09-26,Global Payments,34,64,2,100,0.020000
2025-09-26,Globe Life,37,56,7,100,0.070000
2025-09-26,GoDaddy,35,58,7,100,0.070000
2025-09-26,Goldman Sachs,34,60,7,101,0.069307
2025-09-26,Goodyear Tire & Rubber,22,69,9,100,0.090000
2025-09-26,Graham Holdings Company,26,70,4,100,0.040000
2025-09-26,Granite Construction,40,57,3,100,0.030000
2025-09-26,Graphic Packaging,14,71,15,100,0.150000
2025-09-26,Gray Television,23,65,12,100,0.120000
2025-09-26,Graybar Electric,12,28,3,43,0.069767
2025-09-26,Green Plains Inc,37,52,11,100,0.110000
2025-09-26,Greif,21,75,4,100,0.040000
2025-09-26,Griffon Corporation,32,63,5,100,0.050000
2025-09-26,Grocery Outlet Holding,31,62,7,100,0.070000
2025-09-26,Group 1 Automotive,26,69,5,100,0.050000
2025-09-26,Guardian Life insurance,49,49,2,100,0.020000
2025-09-26,Guess Inc,29,65,6,100,0.060000
2025-09-26,GuideWell Mutual,19,26,0,45,0.000000
2025-09-26,HB Fuller,19,77,4,100,0.040000
2025-09-26,HCA Healthcare,40,56,4,100,0.040000
2025-09-26,HEICO,30,61,9,100,0.090000
2025-09-26,HF SInclair,27,61,12,100,0.120000
2025-09-26,HP,27,68,5,100,0.050000
2025-09-26,Halliburton,20,61,19,100,0.190000
2025-09-26,Hanesbrands,25,72,3,100,0.030000
2025-09-26,Hanover Insurance Group,39,49,12,100,0.120000
2025-09-26,Harley-Davidson,21,69,10,100,0.100000
2025-09-26,Hasbro,33,52,15,100,0.150000
2025-09-26,Hawaiian Airlines Inc,35,63,2,100,0.020000
2025-09-26,Hawaiian Electric Industries,32,60,8,100,0.080000
2025-09-26,Helmerich & Payne,18,65,17,100,0.170000
2025-09-26,Henry Schein,24,72,4,100,0.040000
2025-09-26,Herc Rentals,35,55,10,100,0.100000
2025-09-26,Hershey,28,64,8,100,0.080000
2025-09-26,Hertz,19,65,16,100,0.160000
2025-09-26,Hewlett Packard Enterprise,20,79,1,100,0.010000
2025-09-26,Hillenbrand,20,69,11,100,0.110000
2025-09-26,Hilton Grand Vacations,89,11,0,100,0.000000
2025-09-26,Hilton Worldwide,44,52,4,100,0.040000
2025-09-26,Hologic,22,70,8,100,0.080000
2025-09-26,Home Depot,34,49,17,100,0.170000
2025-09-26,Honeywell,40,45,15,100,0.150000
2025-09-26,Hormel Foods,29,64,7,100,0.070000
2025-09-26,Host Hotels & Resorts,24,72,4,100,0.040000
2025-09-26,Hovnanian Enterprises,33,57,10,100,0.100000
2025-09-26,Howmet Aerospace,35,62,3,100,0.030000
2025-09-26,Hub Group,21,66,13,100,0.130000
2025-09-26,Hubbell,18,67,15,100,0.150000
2025-09-26,Humana,50,40,10,100,0.100000
2025-09-26,Huntington Bancshares,36,62,2,100,0.020000
2025-09-26,Huntington Ingalls Industries,35,54,11,100,0.110000
2025-09-26,Huntsman,13,57,30,100,0.300000
2025-09-26,Hyatt Hotels,36,60,4,100,0.040000
2025-09-26,Hyster-Yale,23,74,3,100,0.030000
2025-09-26,IAC,33,60,7,100,0.070000
2025-09-26,IBM,31,62,6,99,0.060606
2025-09-26,IDEX,35,57,8,100,0.080000
2025-09-26,IDEXX Laboratories,57,41,2,100,0.020000
2025-09-26,IQVIA,54,39,7,100,0.070000
2025-09-26,ITT,41,55,4,100,0.040000
2025-09-26,Icahn Enterprises,26,57,17,100,0.170000
2025-09-26,Illinois Tool Works,36,58,6,100,0.060000
2025-09-26,Illumina Inc,19,71,10,100,0.100000
2025-09-26,Incyte,40,56,4,100,0.040000
2025-09-26,Ingersoll Rand,31,64,5,100,0.050000
2025-09-26,Ingles Markets,27,49,24,100,0.240000
2025-09-26,Ingram Micro,22,49,29,100,0.290000
2025-09-26,Ingredion,45,48,7,100,0.070000
2025-09-26,Insight Enterprises,26,62,12,100,0.120000
2025-09-26,Insperity,34,55,11,100,0.110000
2025-09-26,Instacart,33,59,8,100,0.080000
2025-09-26,Installed Building Products,22,69,9,100,0.090000
2025-09-26,Intel,18,71,13,102,0.127451
2025-09-26,Interactive Brokers,40,53,7,100,0.070000
2025-09-26,Intercontinental Exchange,42,54,4,100,0.040000
2025-09-26,International Flavors & Fragrances,31,61,8,100,0.080000
2025-09-26,International Paper,19,75,6,100,0.060000
2025-09-26,Interpublic Group,34,63,3,100,0.030000
2025-09-26,Intuit,49,48,3,100,0.030000
2025-09-26,Intuitive Surgical,41,49,10,100,0.100000
2025-09-26,Iron Mountain,26,61,13,100,0.130000
2025-09-26,JB Hunt Transport Services,22,66,12,100,0.120000
2025-09-26,JELD-WEN Holding,21,71,8,100,0.080000
2025-09-26,JM Smucker,35,57,8,100,0.080000
2025-09-26,JPMorgan Chase,34,61,9,104,0.086538
2025-09-26,Jabil,25,68,7,100,0.070000
2025-09-26,Jackson Financial,35,60,5,100,0.050000
2025-09-26,Jacobs Solutions,53,46,1,100,0.010000
2025-09-26,Jefferies Financial,28,66,6,100,0.060000
2025-09-26,JetBlue Airways,31,52,17,100,0.170000
2025-09-26,Johnson & Johnson,44,47,9,100,0.090000
2025-09-26,Jones Lang LaSalle,44,55,1,100,0.010000
2025-09-26,Juniper Networks,27,66,7,100,0.070000
2025-09-26,KB Home,32,63,5,100,0.050000
2025-09-26,KBR,44,53,3,100,0.030000
2025-09-26,KKR & Co,57,40,3,100,0.030000
2025-09-26,KLA,31,52,17,100,0.170000
2025-09-26,Kaiser Aluminum,23,67,10,100,0.100000
2025-09-26,Kellanova,29,61,10,100,0.100000
2025-09-26,Kelly Services Inc,22,70,8,100,0.080000
2025-09-26,Kemper Corporation,33,62,5,100,0.050000
2025-09-26,Kenvue,13,66,21,100,0.210000
2025-09-26,Keurig Dr Pepper,17,70,13,100,0.130000
2025-09-26,KeyCorp,38,57,5,100,0.050000
2025-09-26,Keysight Technologies,33,62,5,100,0.050000
2025-09-26,Kimberly-Clark,39,51,10,100,0.100000
2025-09-26,Kinder Morgan,94,4,2,100,0.020000
2025-09-26,Kirby Corporation,27,65,8,100,0.080000
2025-09-26,Knife River Corporation,23,49,5,77,0.064935
2025-09-26,Knight Swift Transportation,26,68,6,100,0.060000
2025-09-26,Kohl's,31,54,15,100,0.150000
2025-09-26,Kontoor Brands,39,57,4,100,0.040000
2025-09-26,Korn Ferry,54,38,8,100,0.080000
2025-09-26,Kraft Heinz,31,58,11,100,0.110000
2025-09-26,Kroger,38,51,12,101,0.118812
2025-09-26,Kyndryl,31,65,4,100,0.040000
2025-09-26,L3Harris Technologies,30,64,6,100,0.060000
2025-09-26,LCI Industries,31,64,5,100,0.050000
2025-09-26,LKQ,25,65,10,100,0.100000
2025-09-26,LPL Financial,66,32,2,100,0.020000
2025-09-26,Labcorp Holdings,44,52,4,100,0.040000
2025-09-26,Lam Research,39,56,5,100,0.050000
2025-09-26,Lamb Weston,23,68,9,100,0.090000
2025-09-26,Land O'Lakes,32,60,8,100,0.080000
2025-09-26,Landstar System,23,52,25,100,0.250000
2025-09-26,Las Vegas Sands,32,60,8,100,0.080000
2025-09-26,Lear Corporation,33,56,11,100,0.110000
2025-09-26,Leggett & Platt,19,73,8,100,0.080000
2025-09-26,Leidos,41,54,5,100,0.050000
2025-09-26,Lennar,14,67,19,100,0.190000
2025-09-26,Lennox International,33,59,8,100,0.080000
2025-09-26,Levi Strauss,24,74,2,100,0.020000
2025-09-26,Liberty Energy,90,10,0,100,0.000000
2025-09-26,Liberty Media,94,5,1,100,0.010000
2025-09-26,Liberty Mutual Insurance,81,13,6,100,0.060000
2025-09-26,Light & Wonder,22,64,14,100,0.140000
2025-09-26,Lincoln Electric,39,57,4,100,0.040000
2025-09-26,Lincoln National,32,55,13,100,0.130000
2025-09-26,Lithia Motors,37,60,3,100,0.030000
2025-09-26,Live Nation Entertainment,46,40,14,100,0.140000
2025-09-26,Lockheed Martin,41,46,13,100,0.130000
2025-09-26,Loews,38,58,4,100,0.040000
2025-09-26,Louisiana-Pacific Corporation,33,62,5,100,0.050000
2025-09-26,Lowe's,40,52,8,100,0.080000
2025-09-26,Lululemon athletica,23,56,21,100,0.210000
2025-09-26,Lumen Technologies,24,66,10,100,0.100000
2025-09-26,Lyft,15,57,28,100,0.280000
2025-09-26,M&T Bank,35,58,7,100,0.070000
2025-09-26,M/I Homes,26,66,8,100,0.080000
2025-09-26,MDU Resources Group,36,58,6,100,0.060000
2025-09-26,MGM Resorts International,32,60,8,100,0.080000
2025-09-26,MKS Instruments,39,51,10,100,0.100000
2025-09-26,MRC Global,38,59,3,100,0.030000
2025-09-26,MSC Industrial Direct,24,68,8,100,0.080000
2025-09-26,MSCI,22,71,7,100,0.070000
2025-09-26,MYR Group,31,60,9,100,0.090000
2025-09-26,Macys,25,68,7,100,0.070000
2025-09-26,ManpowerGroup,27,63,10,100,0.100000
2025-09-26,Marathon Oil,27,62,11,100,0.110000
2025-09-26,Marathon Petroleum,42,53,5,100,0.050000
2025-09-26,Markel Group,40,52,8,100,0.080000
2025-09-26,Marriott International,39,57,4,100,0.040000
2025-09-26,Marriott Vacations Worldwide,34,54,12,100,0.120000
2025-09-26,Marsh & McLennan,50,43,7,100,0.070000
2025-09-26,Martin Marietta Materials,30,56,14,100,0.140000
2025-09-26,Marvell Technology,33,54,5,92,0.054348
2025-09-26,MasTec,37,60,3,100,0.030000
2025-09-26,Masco,30,60,10,100,0.100000
2025-09-26,Mass Mutual,19,43,4,66,0.060606
2025-09-26,MasterBrand,33,65,2,100,0.020000
2025-09-26,Mastercard,38,57,5,100,0.050000
2025-09-26,Matador Resources,29,63,8,100,0.080000
2025-09-26,Match Group,18,56,26,100,0.260000
2025-09-26,Mativ,25,70,5,100,0.050000
2025-09-26,Matson Inc,36,56,8,100,0.080000
2025-09-26,Mattel,35,53,12,100,0.120000
2025-09-26,Maximus,26,69,5,100,0.050000
2025-09-26,McCormick & Company,40,48,12,100,0.120000
2025-09-26,McDonalds,24,57,19,100,0.190000
2025-09-26,McKesson,41,54,5,100,0.050000
2025-09-26,Medical Mutual of Ohio,26,64,10,100,0.100000
2025-09-26,Merck,34,59,7,100,0.070000
2025-09-26,Mercury General,24,56,20,100,0.200000
2025-09-26,Meritage Homes,26,63,11,100,0.110000
2025-09-26,MetLife,30,60,10,100,0.100000
2025-09-26,Meta Platforms,37,49,14,100,0.140000
2025-09-26,Mettler-Toledo International,29,69,2,100,0.020000
2025-09-26,Microchip Technology,39,57,4,100,0.040000
2025-09-26,Micron Technology,35,62,3,100,0.030000
2025-09-26,Microsoft,25,57,18,100,0.180000
2025-09-26,Middleby,20,77,3,100,0.030000
2025-09-26,MillerKnoll,27,65,8,100,0.080000
2025-09-26,Moderna,35,48,17,100,0.170000
2025-09-26,ModivCare,27,52,21,100,0.210000
2025-09-26,Mohawk Industries,35,59,6,100,0.060000
2025-09-26,Molina Healthcare,28,58,14,100,0.140000
2025-09-26,Molson Coors Beverage,24,64,12,100,0.120000
2025-09-26,Mondelez,32,56,12,100,0.120000
2025-09-26,Monster Beverage,44,49,7,100,0.070000
2025-09-26,Moodys Corporation,4,11,2,17,0.117647
2025-09-26,Moog Inc,39,55,6,100,0.060000
2025-09-26,Morgan Stanley,20,74,5,99,0.050505
2025-09-26,Motorola Solutions,50,47,3,100,0.030000
2025-09-26,Mueller Industries,46,48,6,100,0.060000
2025-09-26,Murphy Oil,26,69,5,100,0.050000
2025-09-26,Murphy USA,33,59,8,100,0.080000
2025-09-26,Mutual of Omaha,44,50,6,100,0.060000
2025-09-26,NCR Atleos,36,60,4,100,0.040000
2025-09-26,NCR Voyix,29,63,8,100,0.080000
2025-09-26,NGL Energy Partners,82,12,6,100,0.060000
2025-09-26,NLV Financial,3,5,1,9,0.111111
2025-09-26,NOV,27,62,11,100,0.110000
2025-09-26,NRG Energy,85,13,2,100,0.020000
2025-09-26,NVR Inc,38,57,5,100,0.050000
2025-09-26,Nasdaq Inc,36,62,2,100,0.020000
2025-09-26,Nationwide Insurance,18,61,21,100,0.210000
2025-09-26,Navient,37,48,15,100,0.150000
2025-09-26,NetApp,28,68,4,100,0.040000
2025-09-26,Netflix,22,62,20,104,0.192308
2025-09-26,NeueHealth,58,39,2,99,0.020202
2025-09-26,New York Life Insurance,43,48,9,100,0.090000
2025-09-26,NewMarket Corporation,30,39,2,71,0.028169
2025-09-26,Newell Brands,29,61,10,100,0.100000
2025-09-26,Newmont,30,60,10,100,0.100000
2025-09-26,News Corp,18,71,11,100,0.110000
2025-09-26,Nexstar Media Group,17,74,9,100,0.090000
2025-09-26,NextEra Energy,84,15,1,100,0.010000
2025-09-26,NiSource,45,48,7,100,0.070000
2025-09-26,Nike,24,71,6,101,0.059406
2025-09-26,Nordson,36,61,3,100,0.030000
2025-09-26,Nordstrom,36,59,5,100,0.050000
2025-09-26,Norfolk Southern,36,57,7,100,0.070000
2025-09-26,Northern Trust,92,7,1,100,0.010000
2025-09-26,Northrop Grumman,31,65,4,100,0.040000
2025-09-26,Northwestern Mutual,30,53,17,100,0.170000
2025-09-26,Nucor,24,61,15,100,0.150000
2025-09-26,Nvidia,23,62,15,100,0.150000
2025-09-26,O'Reilly Automotive,65,32,3,100,0.030000
2025-09-26,O-I Glass,39,49,12,100,0.120000
2025-09-26,ODP Business Solutions,19,50,2,71,0.028169
2025-09-26,OGE Energy,87,12,1,100,0.010000
2025-09-26,ON Semiconductor,24,65,11,100,0.110000
2025-09-26,Occidental Petroleum,36,50,14,100,0.140000
2025-09-26,Old Dominion Freight Line,38,49,13,100,0.130000
2025-09-26,Old National Bancorp,28,72,0,100,0.000000
2025-09-26,Old Republic International,48,50,2,100,0.020000
2025-09-26,Olin,21,60,19,100,0.190000
2025-09-26,Omnicom Group,35,58,7,100,0.070000
2025-09-26,OneMain,43,55,2,100,0.020000
2025-09-26,Oneok,46,51,3,100,0.030000
2025-09-26,Opendoor Technologies,23,51,26,100,0.260000
2025-09-26,Option Care Health,95,5,0,100,0.000000
2025-09-26,Oracle,29,65,6,100,0.060000
2025-09-26,Organon,26,60,14,100,0.140000
2025-09-26,Oscar Health,24,67,9,100,0.090000
2025-09-26,Oshkosh Corporation,40,51,9,100,0.090000
2025-09-26,Otis Worldwide,31,58,11,100,0.110000
2025-09-26,Ovintiv,41,54,5,100,0.050000
2025-09-26,Owens & Minor,26,59,15,100,0.150000
2025-09-26,Owens Corning,22,75,3,100,0.030000
2025-09-26,PACS Group,27,42,19,88,0.215909
2025-09-26,PBF Energy,81,17,2,100,0.020000
2025-09-26,PC Connection Inc,47,40,4,91,0.043956
2025-09-26,PENN Entertainment,88,12,0,100,0.000000
2025-09-26,PG&E,42,41,17,100,0.170000
2025-09-26,PNC Financial Services,43,52,5,100,0.050000
2025-09-26,PPG Industries,32,62,6,100,0.060000
2025-09-26,PPL Corporation,41,56,3,100,0.030000
2025-09-26,PVH,26,55,19,100,0.190000
2025-09-26,Paccar,39,53,8,100,0.080000
2025-09-26,Pacific Life,39,57,4,100,0.040000
2025-09-26,Packaging Corp of America,16,74,10,100,0.100000
2025-09-26,Palo Alto Networks,35,53,12,100,0.120000
2025-09-26,Par Pacific,30,64,6,100,0.060000
2025-09-26,Paramount Global,29,62,9,100,0.090000
2025-09-26,Park Hotels & Resorts,28,64,8,100,0.080000
2025-09-26,Parker-Hannifin,55,45,0,100,0.000000
2025-09-26,Parsons Corporation,41,52,7,100,0.070000
2025-09-26,Patrick Industries,37,59,4,100,0.040000
2025-09-26,Patterson Companies Inc,12,47,2,61,0.032787
2025-09-26,Patterson-UTI Energy,58,34,8,100,0.080000
2025-09-26,PayPal,35,59,6,100,0.060000
2025-09-26,Paychex,35,55,10,100,0.100000
2025-09-26,Peabody Energy,71,24,5,100,0.050000
2025-09-26,Peloton Interactive,39,54,7,100,0.070000
2025-09-26,Penn Mutual Life Insurance,34,62,4,100,0.040000
2025-09-26,PennyMac Financial Services,32,64,4,100,0.040000
2025-09-26,Penske Automotive,28,69,3,100,0.030000
2025-09-26,PepsiCo,42,53,5,100,0.050000
2025-09-26,Performance Food,38,59,3,100,0.030000
2025-09-26,Permian Resources,41,58,1,100,0.010000
2025-09-26,Petco Health and Wellness,72,26,2,100,0.020000
2025-09-26,Peter Kiewit Sons',7,21,11,39,0.282051
2025-09-26,Pfizer,24,60,16,100,0.160000
2025-09-26,Philip Morris International,57,41,2,100,0.020000
2025-09-26,Phillips 66,43,50,7,100,0.070000
2025-09-26,Pinnacle West Capital,29,57,14,100,0.140000
2025-09-26,Pinterest,30,67,3,100,0.030000
2025-09-26,Pioneer Natural Resources,50,34,16,100,0.160000
2025-09-26,Pitney Bowes,32,65,3,100,0.030000
2025-09-26,Plains GP,32,52,16,100,0.160000
2025-09-26,Playtika Holding,26,63,11,100,0.110000
2025-09-26,Plexus Corp,36,61,3,100,0.030000
2025-09-26,Polaris Inc,45,50,5,100,0.050000
2025-09-26,Pool Corporation,33,61,6,100,0.060000
2025-09-26,Popular Inc,96,3,1,100,0.010000
2025-09-26,Portland General Electric,34,58,8,100,0.080000
2025-09-26,Post Holdings,24,68,8,100,0.080000
2025-09-26,PrIncipal Financial,44,51,5,100,0.050000
2025-09-26,PriceSmart,30,65,5,100,0.050000
2025-09-26,Primerica,39,56,5,100,0.050000
2025-09-26,Primoris Services,43,56,1,100,0.010000
2025-09-26,ProFrac Holding,30,56,14,100,0.140000
2025-09-26,Procter & Gamble,40,49,11,100,0.110000
2025-09-26,Progressive Insurance,27,61,12,100,0.120000
2025-09-26,Prologis,41,55,4,100,0.040000
2025-09-26,Prudential Financial,37,59,4,100,0.040000
2025-09-26,Public Service Enterprise Group,43,51,6,100,0.060000
2025-09-26,Public Storage,44,45,11,100,0.110000
2025-09-26,Publix Super Markets,35,61,4,100,0.040000
2025-09-26,Puget Sound Energy,56,35,9,100,0.090000
2025-09-26,PulteGroup,27,68,5,100,0.050000
2025-09-26,Pure Storage,38,62,0,100,0.000000
2025-09-26,QVC Group,22,67,11,100,0.110000
2025-09-26,QXO Building Products,1,8,1,10,0.100000
2025-09-26,Qorvo,46,48,6,100,0.060000
2025-09-26,Qualcomm,26,70,7,103,0.067961
2025-09-26,Quanta Services,42,56,2,100,0.020000
2025-09-26,Quest Diagnostics,26,66,8,100,0.080000
2025-09-26,QuidelOrtho,34,59,7,100,0.070000
2025-09-26,REV Group,47,47,6,100,0.060000
2025-09-26,RPM International,27,65,8,100,0.080000
2025-09-26,RTX,36,53,11,100,0.110000
2025-09-26,RXO Inc,29,62,9,100,0.090000
2025-09-26,Rackspace Technology,25,63,12,100,0.120000
2025-09-26,Radius Recycling,14,60,26,100,0.260000
2025-09-26,Ralph Lauren,28,67,5,100,0.050000
2025-09-26,Range Resources,47,48,5,100,0.050000
2025-09-26,Raymond James Financial,35,62,3,100,0.030000
2025-09-26,Realty Income,36,47,17,100,0.170000
2025-09-26,Regal Rexnord,33,60,7,100,0.070000
2025-09-26,Regeneron Pharmaceuticals,43,51,6,100,0.060000
2025-09-26,Regions Financial,41,54,5,100,0.050000
2025-09-26,Reinsurance Group of America,36,57,7,100,0.070000
2025-09-26,Reliance Inc,42,49,9,100,0.090000
2025-09-26,Republic Services,36,45,19,100,0.190000
2025-09-26,ResMed,23,72,5,100,0.050000
2025-09-26,Resideo Technologies,38,55,7,100,0.070000
2025-09-26,Restoration Hardware,29,58,13,100,0.130000
2025-09-26,Revvity,31,60,9,100,0.090000
2025-09-26,Rithm Capital,19,77,4,100,0.040000
2025-09-26,Rivian Automotive,34,58,10,102,0.098039
2025-09-26,Robert Half,34,55,11,100,0.110000
2025-09-26,Roblox,27,55,18,100,0.180000
2025-09-26,Rocket Companies,20,75,5,100,0.050000
2025-09-26,Rockwell Automation,35,63,2,100,0.020000
2025-09-26,Roku,55,41,5,101,0.049505
2025-09-26,Rollins Inc,28,66,6,100,0.060000
2025-09-26,Roper Technologies,30,65,5,100,0.050000
2025-09-26,Ross Stores,35,59,6,100,0.060000
2025-09-26,Rush Enterprises,34,56,10,100,0.100000
2025-09-26,Ryder System,47,52,1,100,0.010000
2025-09-26,Ryerson Holding,16,69,6,91,0.065934
2025-09-26,S&P Global,24,67,9,100,0.090000
2025-09-26,SBA Communications,41,49,10,100,0.100000
2025-09-26,SS&C Technologies,43,55,2,100,0.020000
2025-09-26,Sabre Corporation,28,67,5,100,0.050000
2025-09-26,Saia Inc,47,50,3,100,0.030000
2025-09-26,Salesforce,16,53,31,100,0.310000
2025-09-26,Sallie Mae,32,61,7,100,0.070000
2025-09-26,Sally Beauty,96,3,1,100,0.010000
2025-09-26,Sanmina,27,69,4,100,0.040000
2025-09-26,ScanSource,41,55,4,100,0.040000
2025-09-26,Schneider National,33,60,7,100,0.070000
2025-09-26,Science Applications International,30,60,10,100,0.100000
2025-09-26,Scotts Miracle-Gro,40,48,12,100,0.120000
2025-09-26,Seaboard,25,60,15,100,0.150000
2025-09-26,Sealed Air Corporation,23,68,9,100,0.090000
2025-09-26,Securian Financial,28,64,8,100,0.080000
2025-09-26,Select Medical Holdings,27,65,8,100,0.080000
2025-09-26,Selective Insurance Group,25,56,19,100,0.190000
2025-09-26,Sempra,31,60,2,93,0.021505
2025-09-26,Sentry Insurance Group,3,6,0,9,0.000000
2025-09-26,Service Corp International,3,14,5,22,0.227273
2025-09-26,ServiceNow,25,63,12,100,0.120000
2025-09-26,Sherwin-Williams,14,64,14,92,0.152174
2025-09-26,Shift4 Payments,22,70,8,100,0.080000
2025-09-26,Silgan,20,58,22,100,0.220000
2025-09-26,Simon Property Group,41,54,5,100,0.050000
2025-09-26,Sinclair,12,69,19,100,0.190000
2025-09-26,Sirius XM,24,71,5,100,0.050000
2025-09-26,SiteOne Landscape Supply,28,65,7,100,0.070000
2025-09-26,Skechers USA,23,73,4,100,0.040000
2025-09-26,SkyWest,14,58,28,100,0.280000
2025-09-26,Skyline Champion,43,13,1,57,0.017544
2025-09-26,Skyworks Solutions,32,62,6,100,0.060000
2025-09-26,Smurfit Westrock,19,68,13,100,0.130000
2025-09-26,Snap Inc,28,50,22,100,0.220000
2025-09-26,Snap-on,19,72,9,100,0.090000
2025-09-26,Snowflake Inc,51,49,0,100,0.000000
2025-09-26,Solventum,31,63,6,100,0.060000
2025-09-26,Sonic Automotive,17,81,2,100,0.020000
2025-09-26,Sonoco Products,23,68,9,100,0.090000
2025-09-26,Southern Company,42,56,2,100,0.020000
2025-09-26,Southwest Airlines,24,63,13,100,0.130000
2025-09-26,Southwest Gas Holdings,40,55,5,100,0.050000
2025-09-26,SpartanNash,17,79,4,100,0.040000
2025-09-26,Spectrum Brands,28,60,12,100,0.120000
2025-09-26,Spire Inc,51,46,3,100,0.030000
2025-09-26,Spirit AeroSystems,37,46,17,100,0.170000
2025-09-26,Spirit Airlines,16,70,14,100,0.140000
2025-09-26,Splunk,40,50,10,100,0.100000
2025-09-26,Sprouts Farmers Market,26,69,5,100,0.050000
2025-09-26,Stagwell,28,62,10,100,0.100000
2025-09-26,Stanley Black & Decker,23,68,9,100,0.090000
2025-09-26,Starbucks,6,66,20,92,0.217391
2025-09-26,State Farm Insurance,20,60,20,100,0.200000
2025-09-26,State Street,27,63,10,100,0.100000
2025-09-26,Steel Dynamics,87,10,3,100,0.030000
2025-09-26,Steelcase,26,71,3,100,0.030000
2025-09-26,Stericycle,12,38,50,100,0.500000
2025-09-26,Stifel Financial,35,61,4,100,0.040000
2025-09-26,StoneX Group,35,62,3,100,0.030000
2025-09-26,Stryker,25,63,12,100,0.120000
2025-09-26,Summit Materials,24,67,9,100,0.090000
2025-09-26,Sun Communities,39,51,10,100,0.100000
2025-09-26,Super Micro Computer,86,9,5,100,0.050000
2025-09-26,Surgery Partners,30,59,11,100,0.110000
2025-09-26,Sylvamo,25,60,15,100,0.150000
2025-09-26,Synchrony Financial,56,40,4,100,0.040000
2025-09-26,Synopsys,27,59,14,100,0.140000
2025-09-26,Synovus Financial,41,55,4,100,0.040000
2025-09-26,Sysco,50,44,6,100,0.060000
2025-09-26,T Rowe Price,49,47,4,100,0.040000
2025-09-26,TD Synnex,39,59,2,100,0.020000
2025-09-26,TEGNA,23,70,7,100,0.070000
2025-09-26,THOR Industries,28,67,5,100,0.050000
2025-09-26,TIAA,25,68,7,100,0.070000
2025-09-26,TJX,53,39,8,100,0.080000
2025-09-26,Take-Two Interactive Software,37,59,4,100,0.040000
2025-09-26,Talen Energy,85,14,1,100,0.010000
2025-09-26,Tapestry,23,68,9,100,0.090000
2025-09-26,Targa Resources,48,46,6,100,0.060000
2025-09-26,Target Corporation,47,47,6,100,0.060000
2025-09-26,Taylor Morrison Home,29,63,8,100,0.080000
2025-09-26,Teladoc Health,35,57,8,100,0.080000
2025-09-26,Teledyne Technologies,34,64,2,100,0.020000
2025-09-26,Teleflex,22,69,9,100,0.090000
2025-09-26,Telephone & Data Systems,5,16,0,21,0.000000
2025-09-26,TelevisaUnivision,29,56,15,100,0.150000
2025-09-26,Tempur Sealy International,31,60,9,100,0.090000
2025-09-26,Tenet Healthcare,38,54,8,100,0.080000
2025-09-26,Teradyne,28,67,5,100,0.050000
2025-09-26,Terex,20,73,7,100,0.070000
2025-09-26,Tesla,19,65,19,103,0.184466
2025-09-26,Tetra Tech,45,47,8,100,0.080000
2025-09-26,Texas Instruments,22,70,8,100,0.080000
2025-09-26,Texas Roadhouse,37,58,5,100,0.050000
2025-09-26,Textron,26,66,8,100,0.080000
2025-09-26,The Andersons Inc,30,68,2,100,0.020000
2025-09-26,The Coca-Cola Company,29,63,8,100,0.080000
2025-09-26,The Greenbrier Companies,23,70,7,100,0.070000
2025-09-26,The Hartford,31,45,24,100,0.240000
2025-09-26,The Mosaic Company,32,61,7,100,0.070000
2025-09-26,Thermo Fisher Scientific,42,53,5,100,0.050000
2025-09-26,Thrivent Financial for Lutherans,21,39,3,63,0.047619
2025-09-26,Timken,24,68,8,100,0.080000
2025-09-26,Titan Machinery,18,72,10,100,0.100000
2025-09-26,Toast Inc,31,62,7,100,0.070000
2025-09-26,Toll Brothers,14,84,2,100,0.020000
2025-09-26,TopBuild,21,78,1,100,0.010000
2025-09-26,Topgolf Callaway Brands,22,65,13,100,0.130000
2025-09-26,Toro Company,28,65,7,100,0.070000
2025-09-26,Tractor Supply,25,71,4,100,0.040000
2025-09-26,TransDigm,41,52,7,100,0.070000
2025-09-26,TransUnion,36,50,14,100,0.140000
2025-09-26,Travelers Insurance,35,47,18,100,0.180000
2025-09-26,TreeHouse Foods,20,63,17,100,0.170000
2025-09-26,Tri Pointe Homes,25,70,5,100,0.050000
2025-09-26,TriNet Group,27,66,7,100,0.070000
2025-09-26,Trimble Inc,36,61,3,100,0.030000
2025-09-26,Trinity Industries,28,58,14,100,0.140000
2025-09-26,TruStage,48,46,6,100,0.060000
2025-09-26,Truist Financial,40,57,3,100,0.030000
2025-09-26,Tutor Perini Corporation,59,36,5,100,0.050000
2025-09-26,Twilio,38,55,7,100,0.070000
2025-09-26,Tyson Foods,26,62,12,100,0.120000
2025-09-26,U-Haul,10,40,50,100,0.500000
2025-09-26,UFP Industries,25,69,6,100,0.060000
2025-09-26,UGI Utilities Inc,24,39,15,78,0.192308
2025-09-26,UL Solutions,46,52,2,100,0.020000
2025-09-26,UPS,19,49,32,100,0.320000
2025-09-26,US Bancorp,41,55,4,100,0.040000
2025-09-26,US Foods,41,54,5,100,0.050000
2025-09-26,USAA,29,54,17,100,0.170000
2025-09-26,Uber,16,63,23,102,0.225490
2025-09-26,Ulta Beauty,79,16,5,100,0.050000
2025-09-26,Under Armour,21,69,10,100,0.100000
2025-09-26,Union Pacific,40,55,5,100,0.050000
2025-09-26,United Airlines,68,25,7,100,0.070000
2025-09-26,United Natural Foods,81,15,4,100,0.040000
2025-09-26,United Rentals,94,4,2,100,0.020000
2025-09-26,United States Steel,52,43,5,100,0.050000
2025-09-26,UnitedHealth,40,46,14,100,0.140000
2025-09-26,Universal Corporation,35,57,8,100,0.080000
2025-09-26,Universal Health Services,34,57,9,100,0.090000
2025-09-26,Unum Group,40,55,5,100,0.050000
2025-09-26,Upbound Group,42,56,2,100,0.020000
2025-09-26,Urban Outfitters,41,56,3,100,0.030000
2025-09-26,V2X,49,46,5,100,0.050000
2025-09-26,VF Corporation,24,54,22,100,0.220000
2025-09-26,VICI Properties,37,60,3,100,0.030000
2025-09-26,Vail Resorts,26,57,17,100,0.170000
2025-09-26,Valero Energy,86,12,2,100,0.020000
2025-09-26,Valley National Bancorp,25,71,4,100,0.040000
2025-09-26,Valmont Industries,38,55,7,100,0.070000
2025-09-26,Valvoline Inc,36,58,6,100,0.060000
2025-09-26,Ventas Inc,46,54,0,100,0.000000
2025-09-26,Verisk Analytics,35,49,16,100,0.160000
2025-09-26,Verizon,36,59,5,100,0.050000
2025-09-26,Vertex Pharmaceuticals,44,42,14,100,0.140000
2025-09-26,Vertiv,45,52,3,100,0.030000
2025-09-26,Viasat,36,55,9,100,0.090000
2025-09-26,Viatris,27,59,14,100,0.140000
2025-09-26,Victorias Secret,25,59,16,100,0.160000
2025-09-26,Visa Inc,66,31,3,100,0.030000
2025-09-26,Vishay Intertechnology,27,65,8,100,0.080000
2025-09-26,Vista Outdoor,18,66,16,100,0.160000
2025-09-26,Visteon,45,55,0,100,0.000000
2025-09-26,Vistra,40,52,8,100,0.080000
2025-09-26,Vontier,39,58,3,100,0.030000
2025-09-26,Voya Financial,40,57,3,100,0.030000
2025-09-26,Vulcan Materials,30,57,13,100,0.130000
2025-09-26,WEC Energy,85,15,0,100,0.000000
2025-09-26,WESCO International,36,60,4,100,0.040000
2025-09-26,WEX,42,56,2,100,0.020000
2025-09-26,WR Berkley,41,52,7,100,0.070000
2025-09-26,WW Grainger,32,58,10,100,0.100000
2025-09-26,Wabash National,24,57,19,100,0.190000
2025-09-26,Walmart,22,53,26,101,0.257426
2025-09-26,Walt Disney,43,55,6,104,0.057692
2025-09-26,Warner Bros Discovery,13,72,15,100,0.150000
2025-09-26,Warner Music Group,24,72,4,100,0.040000
2025-09-26,Waters Corporation,43,53,4,100,0.040000
2025-09-26,Watsco,26,61,13,100,0.130000
2025-09-26,Wayfair,36,63,1,100,0.010000
2025-09-26,Webster Financial,28,64,8,100,0.080000
2025-09-26,Weis Markets,24,64,12,100,0.120000
2025-09-26,Wells Fargo,73,23,4,100,0.040000
2025-09-26,Welltower,60,39,1,100,0.010000
2025-09-26,Werner Enterprises,33,56,11,100,0.110000
2025-09-26,West Pharmaceutical Services,42,48,10,100,0.100000
2025-09-26,Western & Southern Financial,29,68,3,100,0.030000
2025-09-26,Western Alliance Bancorp,21,49,21,91,0.230769
2025-09-26,Western Digital,29,68,3,100,0.030000
2025-09-26,Western Midstream Partners,35,60,5,100,0.050000
2025-09-26,Western Union,23,69,8,100,0.080000
2025-09-26,Westinghouse Air Brake Technologies,28,66,6,100,0.060000
2025-09-26,Weyerhaeuser,28,63,9,100,0.090000
2025-09-26,Whirlpool,26,56,18,100,0.180000
2025-09-26,Williams Companies,54,40,6,100,0.060000
2025-09-26,Williams-Sonoma,27,68,5,100,0.050000
2025-09-26,Winnebago Industries,21,65,14,100,0.140000
2025-09-26,Wintrust Financial,36,63,1,100,0.010000
2025-09-26,Woodward Inc,31,67,2,100,0.020000
2025-09-26,Workday,24,67,9,100,0.090000
2025-09-26,World Kinect,33,61,6,100,0.060000
2025-09-26,Worthington Enterprises,33,65,2,100,0.020000
2025-09-26,Wynn Resorts,24,67,9,100,0.090000
2025-09-26,XPO,22,68,10,100,0.100000
2025-09-26,Xcel Energy,50,33,17,100,0.170000
2025-09-26,Xerox,22,68,10,100,0.100000
2025-09-26,Xylem Inc,45,50,5,100,0.050000
2025-09-26,Yum Brands,25,68,7,100,0.070000
2025-09-26,Yum China,41,51,8,100,0.080000
2025-09-26,Zebra Technologies,33,59,8,100,0.080000
2025-09-26,Zimmer Biomet,42,56,2,100,0.020000
2025-09-26,Zions Bancorp,36,51,13,100,0.130000
2025-09-26,Zoetis,50,44,6,100,0.060000
2025-09-26,Zoom Video Communications,30,57,13,100,0.130000
2025-09-26,eXp World,28,68,4,100,0.040000
2025-09-26,iHeartMedia,27,69,4,100,0.040000
2025-09-27,3M,32,60,8,100,0.080000
2025-09-27,A O Smith,23,76,1,100,0.010000
2025-09-27,A-Mark Precious Metals,89,11,0,100,0.000000
2025-09-27,ABM Industries,27,52,21,100,0.210000
2025-09-27,ADT,34,45,21,100,0.210000
2025-09-27,AECOM,43,47,10,100,0.100000
2025-09-27,AES,38,48,14,100,0.140000
2025-09-27,AGCO,36,57,7,100,0.070000
2025-09-27,AGNC Investment,30,51,19,100,0.190000
2025-09-27,AIG,28,61,11,100,0.110000
2025-09-27,AMC Entertainment,82,13,5,100,0.050000
2025-09-27,AMC Networks,27,55,18,100,0.180000
2025-09-27,AMN Healthcare Services,20,59,21,100,0.210000
2025-09-27,APA,35,49,16,100,0.160000
2025-09-27,APi Group,35,54,11,100,0.110000
2025-09-27,ARKO,27,65,8,100,0.080000
2025-09-27,ASGN,27,59,14,100,0.140000
2025-09-27,AT&T,28,52,16,96,0.166667
2025-09-27,ATI Inc,34,62,4,100,0.040000
2025-09-27,AbbVie,47,40,13,100,0.130000
2025-09-27,Abbott Laboratories,53,41,6,100,0.060000
2025-09-27,Abercrombie & Fitch,34,62,4,100,0.040000
2025-09-27,Academy Sports and Outdoors,29,62,9,100,0.090000
2025-09-27,Acadia Healthcare,17,65,18,100,0.180000
2025-09-27,Ace Hardware,27,60,13,100,0.130000
2025-09-27,Acuity Inc,35,35,8,78,0.102564
2025-09-27,Adams Resources & Energy,16,4,1,21,0.047619
2025-09-27,AdaptHealth,33,54,13,100,0.130000
2025-09-27,Adobe,45,43,6,94,0.063830
2025-09-27,Advance Auto Parts,22,57,21,100,0.210000
2025-09-27,Advanced Drainage Systems,82,12,6,100,0.060000
2025-09-27,Advanced Micro Devices,84,8,12,104,0.115385
2025-09-27,Advantage Solutions,76,18,6,100,0.060000
2025-09-27,Aflac,39,35,26,100,0.260000
2025-09-27,Agilent Technologies,32,61,7,100,0.070000
2025-09-27,Agilon Health,27,55,18,100,0.180000
2025-09-27,Air Lease,29,63,8,100,0.080000
2025-09-27,Air Products & Chemicals,25,64,11,100,0.110000
2025-09-27,Airbnb,29,58,13,100,0.130000
2025-09-27,Akamai Technologies,44,44,12,100,0.120000
2025-09-27,Alaska Air,32,65,3,100,0.030000
2025-09-27,Albemarle Corporation,30,57,13,100,0.130000
2025-09-27,Albertsons,37,48,15,100,0.150000
2025-09-27,Alcoa Corporation,23,59,18,100,0.180000
2025-09-27,Alexandria Real Estate Equities,41,52,7,100,0.070000
2025-09-27,Alight Solutions,26,64,10,100,0.100000
2025-09-27,Align Technology,15,59,26,100,0.260000
2025-09-27,Allegiant Travel Company,22,69,9,100,0.090000
2025-09-27,Alliance Resource Partners,33,47,20,100,0.200000
2025-09-27,Alliant Energy,80,14,6,100,0.060000
2025-09-27,Allison Transmission,28,56,16,100,0.160000
2025-09-27,Allstate,60,29,11,100,0.110000
2025-09-27,Ally Financial,38,56,6,100,0.060000
2025-09-27,Alpha Metallurgical Resources,36,48,16,100,0.160000
2025-09-27,Alphabet,30,49,21,100,0.210000
2025-09-27,Altice USA,32,50,18,100,0.180000
2025-09-27,Altria,50,42,8,100,0.080000
2025-09-27,Amazon,27,62,15,104,0.144231
2025-09-27,Ameren,37,44,19,100,0.190000
2025-09-27,American Airlines,14,28,60,102,0.588235
2025-09-27,American Axle & Manufacturing,32,55,13,100,0.130000
2025-09-27,American Eagle Outfitters,34,53,13,100,0.130000
2025-09-27,American Electric Power,39,53,8,100,0.080000
2025-09-27,American Express,44,43,5,92,0.054348
2025-09-27,American Family Insurance,48,41,11,100,0.110000
2025-09-27,American Financial Group,27,58,15,100,0.150000
2025-09-27,American Tower,48,42,10,100,0.100000
2025-09-27,American Water Works,45,49,6,100,0.060000
2025-09-27,Americold Realty Trust,72,23,5,100,0.050000
2025-09-27,Ameriprise Financial,48,42,10,100,0.100000
2025-09-27,Ametek,30,61,9,100,0.090000
2025-09-27,Amgen,29,58,13,100,0.130000
2025-09-27,Amica Mutual Insurance,24,66,6,96,0.062500
2025-09-27,Amkor Technology,35,58,7,100,0.070000
2025-09-27,Amphenol,29,67,4,100,0.040000
2025-09-27,Analog Devices,39,53,8,100,0.080000
2025-09-27,Antero Resources,39,53,8,100,0.080000
2025-09-27,Anywhere Real Estate Inc,36,60,4,100,0.040000
2025-09-27,Apollo Global Management,33,61,6,100,0.060000
2025-09-27,AppLovin,32,59,9,100,0.090000
2025-09-27,Apple,43,52,15,110,0.136364
2025-09-27,Applied Industrial Technologies,30,66,4,100,0.040000
2025-09-27,Applied Materials,22,52,26,100,0.260000
2025-09-27,AptarGroup,30,63,7,100,0.070000
2025-09-27,Aramark,45,47,8,100,0.080000
2025-09-27,ArcBest,26,63,11,100,0.110000
2025-09-27,Arch Resources,62,26,12,100,0.120000
2025-09-27,Archer Daniels Midland,42,45,13,100,0.130000
2025-09-27,Ares Management,35,62,3,100,0.030000
2025-09-27,Arista Networks,33,57,10,100,0.100000
2025-09-27,Arrow Electronics,24,67,9,100,0.090000
2025-09-27,Arthur J Gallagher,36,60,4,100,0.040000
2025-09-27,Asbury Automotive Group,28,60,12,100,0.120000
2025-09-27,Assurant,40,49,11,100,0.110000
2025-09-27,Atkore,26,57,17,100,0.170000
2025-09-27,Atlassian,24,54,22,100,0.220000
2025-09-27,Atmos Energy,88,10,2,100,0.020000
2025-09-27,Auto-Owners Insurance,31,59,10,100,0.100000
2025-09-27,AutoNation,27,58,15,100,0.150000
2025-09-27,AutoZone,26,53,21,100,0.210000
2025-09-27,Autodesk,27,72,1,100,0.010000
2025-09-27,Autoliv,47,46,7,100,0.070000
2025-09-27,Automatic Data Processing,39,54,7,100,0.070000
2025-09-27,AvalonBay Communities,34,60,6,100,0.060000
2025-09-27,Avantor,30,51,19,100,0.190000
2025-09-27,Avery Dennison,23,70,7,100,0.070000
2025-09-27,Avient,28,62,10,100,0.100000
2025-09-27,Avis Budget,19,61,20,100,0.200000
2025-09-27,Avnet,20,70,10,100,0.100000
2025-09-27,BJ's Wholesale Club,30,56,14,100,0.140000
2025-09-27,BOK Financial,39,51,10,100,0.100000
2025-09-27,BWX Technologies,43,53,4,100,0.040000
2025-09-27,Baker Hughes,44,48,8,100,0.080000
2025-09-27,Ball Corporation,30,66,4,100,0.040000
2025-09-27,Bank of America,39,52,9,100,0.090000
2025-09-27,Bank of New York Mellon,48,47,5,100,0.050000
2025-09-27,Bath & Body Works,36,49,15,100,0.150000
2025-09-27,Baxter International,24,58,18,100,0.180000
2025-09-27,Becton Dickinson,45,48,7,100,0.070000
2025-09-27,Belden,31,57,12,100,0.120000
2025-09-27,Benchmark Electronics,22,69,9,100,0.090000
2025-09-27,Berkshire Hathaway,27,48,25,100,0.250000
2025-09-27,Berry Global,22,62,16,100,0.160000
2025-09-27,Best Buy,90,8,2,100,0.020000
2025-09-27,Bio-Rad Laboratories,22,65,13,100,0.130000
2025-09-27,Biogen,30,63,7,100,0.070000
2025-09-27,BlackRock,37,47,16,100,0.160000
2025-09-27,Blackstone,35,52,13,100,0.130000
2025-09-27,Bloomin Brands,12,69,19,100,0.190000
2025-09-27,BlueLinx,24,67,9,100,0.090000
2025-09-27,Boeing,29,59,15,103,0.145631
2025-09-27,Boise Cascade,15,50,35,100,0.350000
2025-09-27,Booking Holdings,35,52,13,100,0.130000
2025-09-27,Booz Allen Hamilton,26,54,20,100,0.200000
2025-09-27,BorgWarner,55,39,6,100,0.060000
2025-09-27,Boston Properties,21,71,8,100,0.080000
2025-09-27,Boston Scientific,42,51,7,100,0.070000
2025-09-27,Boyd Gaming,24,54,22,100,0.220000
2025-09-27,Bread Financial,46,50,4,100,0.040000
2025-09-27,BrightSpring Health Services,29,60,11,100,0.110000
2025-09-27,BrightView Holdings,25,65,10,100,0.100000
2025-09-27,Brighthouse Financial,35,58,7,100,0.070000
2025-09-27,Brinker International,45,49,6,100,0.060000
2025-09-27,Brinks Company,13,4,6,23,0.260870
2025-09-27,Bristol-Myers Squibb,27,55,18,100,0.180000
2025-09-27,Broadcom,34,56,10,100,0.100000
2025-09-27,Broadridge Financial Solutions,59,40,1,100,0.010000
2025-09-27,Brookdale Senior Living,31,53,16,100,0.160000
2025-09-27,Brown & Brown,29,56,15,100,0.150000
2025-09-27,Brown-Forman,18,64,18,100,0.180000
2025-09-27,Bruker,25,53,22,100,0.220000
2025-09-27,Brunswick Corporation,44,42,14,100,0.140000
2025-09-27,Builders FirstSource,35,57,8,100,0.080000
2025-09-27,Burlington Stores,28,65,7,100,0.070000
2025-09-27,CACI International,53,40,7,100,0.070000
2025-09-27,CBRE Group,31,67,2,100,0.020000
2025-09-27,CDW,37,57,6,100,0.060000
2025-09-27,CF Industries,32,60,8,100,0.080000
2025-09-27,CH Robinson Worldwide,36,53,11,100,0.110000
2025-09-27,CHS,39,51,10,100,0.100000
2025-09-27,CIncinnati Financial,37,54,9,100,0.090000
2025-09-27,CME Group,28,65,7,100,0.070000
2025-09-27,CMS Energy,86,9,5,100,0.050000
2025-09-27,CNO Financial Group,31,64,5,100,0.050000
2025-09-27,CNX Resources,39,55,6,100,0.060000
2025-09-27,CSX,32,55,13,100,0.130000
2025-09-27,CVS Health,44,45,11,100,0.110000
2025-09-27,Cabot Corporation,34,60,6,100,0.060000
2025-09-27,Cadence,28,58,14,100,0.140000
2025-09-27,Caesars Entertainment,76,19,5,100,0.050000
2025-09-27,Cal-Maine Foods,54,41,5,100,0.050000
2025-09-27,Caleres Inc,29,58,13,100,0.130000
2025-09-27,California Resources,45,48,7,100,0.070000
2025-09-27,Calumet Inc,31,43,14,88,0.159091
2025-09-27,Campbell Soup,34,51,15,100,0.150000
2025-09-27,Camping World,23,62,15,100,0.150000
2025-09-27,Capital One,33,48,19,100,0.190000
2025-09-27,CarMax,11,41,46,98,0.469388
2025-09-27,Cardinal Health,37,51,12,100,0.120000
2025-09-27,Carlisle Companies,33,55,12,100,0.120000
2025-09-27,Carlyle Group,33,61,6,100,0.060000
2025-09-27,Carpenter Technology,32,61,7,100,0.070000
2025-09-27,Carrier Global,35,48,17,100,0.170000
2025-09-27,Carters Inc,16,25,3,44,0.068182
2025-09-27,Carvana,33,56,11,100,0.110000
2025-09-27,Caseys General Stores,32,57,11,100,0.110000
2025-09-27,Catalent,21,65,14,100,0.140000
2025-09-27,Caterpillar,24,64,12,100,0.120000
2025-09-27,Cboe Global Markets,35,60,5,100,0.050000
2025-09-27,Celanese,24,43,33,100,0.330000
2025-09-27,Cencora,55,40,5,100,0.050000
2025-09-27,Centene,31,37,32,100,0.320000
2025-09-27,CenterPoint Energy,73,15,12,100,0.120000
2025-09-27,Central Garden & Pet,23,71,6,100,0.060000
2025-09-27,Century Communities,32,62,6,100,0.060000
2025-09-27,ChampionX,37,61,2,100,0.020000
2025-09-27,Charles River Laboratories International,22,63,15,100,0.150000
2025-09-27,Charles Schwab,40,52,8,100,0.080000
2025-09-27,Chart Industries,34,57,9,100,0.090000
2025-09-27,Charter Communications,28,44,28,100,0.280000
2025-09-27,Cheesecake Factory,27,56,17,100,0.170000
2025-09-27,Chefs Warehouse,38,54,8,100,0.080000
2025-09-27,Chemours,35,44,21,100,0.210000
2025-09-27,Cheniere Energy,90,9,1,100,0.010000
2025-09-27,Chevron,32,44,24,100,0.240000
2025-09-27,Chewy,39,48,13,100,0.130000
2025-09-27,Chipotle Mexican Grill,29,62,9,100,0.090000
2025-09-27,Chord Energy,92,3,5,100,0.050000
2025-09-27,Church & Dwight,29,61,10,100,0.100000
2025-09-27,Ciena,43,52,5,100,0.050000
2025-09-27,Cigna,40,47,13,100,0.130000
2025-09-27,Cinemark,25,60,15,100,0.150000
2025-09-27,Cintas,39,51,10,100,0.100000
2025-09-27,Cisco Systems,27,59,14,100,0.140000
2025-09-27,Citigroup,25,60,17,102,0.166667
2025-09-27,Citizens Financial Group,36,59,5,100,0.050000
2025-09-27,Civitas Resources,28,43,29,100,0.290000
2025-09-27,Clean Harbors,74,12,14,100,0.140000
2025-09-27,Clear Channel Outdoor Hldgs,8,2,0,10,0.000000
2025-09-27,Cleveland-Cliffs,22,54,24,100,0.240000
2025-09-27,Clorox,29,53,18,100,0.180000
2025-09-27,Cognizant Technology Solutions,38,51,11,100,0.110000
2025-09-27,Coherent,34,58,8,100,0.080000
2025-09-27,Coinbase Global,17,66,17,100,0.170000
2025-09-27,Colgate-Palmolive,43,43,14,100,0.140000
2025-09-27,Columbia Banking System,32,64,4,100,0.040000
2025-09-27,Columbia Sportswear,26,50,24,100,0.240000
2025-09-27,Comcast,30,46,24,100,0.240000
2025-09-27,Comerica,44,44,12,100,0.120000
2025-09-27,Comfort Systems USA,94,5,1,100,0.010000
2025-09-27,CommScope,21,77,2,100,0.020000
2025-09-27,Commercial Metals,32,53,15,100,0.150000
2025-09-27,Community Health Systems,26,53,21,100,0.210000
2025-09-27,Compass Group,29,49,22,100,0.220000
2025-09-27,Conagra Brands,33,51,16,100,0.160000
2025-09-27,Concentrix,24,55,21,100,0.210000
2025-09-27,Conduent,29,49,22,100,0.220000
2025-09-27,ConocoPhillips,44,42,14,100,0.140000
2025-09-27,Consol Energy,76,17,7,100,0.070000
2025-09-27,Consolidated Edison,36,52,12,100,0.120000
2025-09-27,Constellation Brands,16,48,36,100,0.360000
2025-09-27,Constellation Energy,79,14,7,100,0.070000
2025-09-27,Continental Resources,33,52,15,100,0.150000
2025-09-27,Cooper Cos,3,20,6,29,0.206897
2025-09-27,Cooper-Standard,28,66,6,100,0.060000
2025-09-27,Copart,46,41,13,100,0.130000
2025-09-27,Core & Main,27,54,19,100,0.190000
2025-09-27,Corebridge Financial,36,53,11,100,0.110000
2025-09-27,Cornerstone Building Brands,25,62,13,100,0.130000
2025-09-27,Corning,37,51,12,100,0.120000
2025-09-27,Corpay,25,72,2,99,0.020202
2025-09-27,Corteva,31,58,11,100,0.110000
2025-09-27,Costco,30,54,16,100,0.160000
2025-09-27,Coterra Energy,79,14,7,100,0.070000
2025-09-27,Coty,26,51,23,100,0.230000
2025-09-27,Country Financial,26,57,17,100,0.170000
2025-09-27,Coupang,34,56,10,100,0.100000
2025-09-27,Cracker Barrel Old Country Store,16,63,21,100,0.210000
2025-09-27,Crocs,31,59,10,100,0.100000
2025-09-27,CrossAmerica Partners,23,73,4,100,0.040000
2025-09-27,CrowdStrike,36,45,19,100,0.190000
2025-09-27,Crown Castle,40,54,6,100,0.060000
2025-09-27,Crown Holdings,32,62,6,100,0.060000
2025-09-27,Cullen Frost Bankers,43,51,6,100,0.060000
2025-09-27,Cummins Inc,57,39,4,100,0.040000
2025-09-27,Curtiss-Wright,45,52,3,100,0.030000
2025-09-27,DR Horton,24,65,11,100,0.110000
2025-09-27,DTE Energy,71,17,12,100,0.120000
2025-09-27,DXC Technology,29,67,4,100,0.040000
2025-09-27,DaVita,30,46,24,100,0.240000
2025-09-27,Dana Incorporated,35,55,10,100,0.100000
2025-09-27,Danaher,53,39,8,100,0.080000
2025-09-27,Darden Restaurants,34,44,22,100,0.220000
2025-09-27,Darling Ingredients,89,7,4,100,0.040000
2025-09-27,Deckers Outdoor,33,50,17,100,0.170000
2025-09-27,Deere,29,54,17,100,0.170000
2025-09-27,Delek US,41,46,13,100,0.130000
2025-09-27,Dell Technologies,41,54,5,100,0.050000
2025-09-27,Delta Air Lines,18,53,29,100,0.290000
2025-09-27,Dentsply Sirona,29,65,6,100,0.060000
2025-09-27,Designer Brands,16,66,18,100,0.180000
2025-09-27,Devon Energy,91,4,5,100,0.050000
2025-09-27,DexCom,17,67,16,100,0.160000
2025-09-27,Diamondback Energy,86,7,7,100,0.070000
2025-09-27,Dicks Sporting Goods,28,65,7,100,0.070000
2025-09-27,Diebold Nixdorf,33,63,4,100,0.040000
2025-09-27,Digital Realty Trust,82,18,0,100,0.000000
2025-09-27,Dillards,26,56,18,100,0.180000
2025-09-27,Discover Financial,32,52,16,100,0.160000
2025-09-27,DocuSign,41,44,15,100,0.150000
2025-09-27,Dollar General,22,53,25,100,0.250000
2025-09-27,Dollar Tree,35,50,15,100,0.150000
2025-09-27,Dominion Energy,65,26,9,100,0.090000
2025-09-27,Dominos Pizza Inc,16,24,8,48,0.166667
2025-09-27,Domtar,28,63,9,100,0.090000
2025-09-27,Donaldson Company,42,50,8,100,0.080000
2025-09-27,DoorDash,40,43,17,100,0.170000
2025-09-27,Dover Corporation,48,51,1,100,0.010000
2025-09-27,DraftKings,56,40,4,100,0.040000
2025-09-27,Dream Finders Homes,83,12,5,100,0.050000
2025-09-27,Dropbox,32,63,5,100,0.050000
2025-09-27,DuPont,27,62,11,100,0.110000
2025-09-27,Duke Energy,77,12,11,100,0.110000
2025-09-27,Dycom Industries,33,60,7,100,0.070000
2025-09-27,EMCOR Group,30,65,5,100,0.050000
2025-09-27,EOG Resources,43,46,11,100,0.110000
2025-09-27,EPAM Systems,33,59,8,100,0.080000
2025-09-27,EQT,35,57,8,100,0.080000
2025-09-27,ESAB,35,51,14,100,0.140000
2025-09-27,East West Bancorp,39,55,6,100,0.060000
2025-09-27,Eastman Chemical,22,48,30,100,0.300000
2025-09-27,Ebay,28,64,8,100,0.080000
2025-09-27,EchoStar,18,70,12,100,0.120000
2025-09-27,Ecolab,46,50,4,100,0.040000
2025-09-27,Edison International,24,53,23,100,0.230000
2025-09-27,Edward Jones,37,55,8,100,0.080000
2025-09-27,Edwards Lifesciences,43,35,22,100,0.220000
2025-09-27,Elanco Animal Health,38,57,5,100,0.050000
2025-09-27,Electronic Arts,15,71,6,92,0.065217
2025-09-27,Elevance Health,42,38,20,100,0.200000
2025-09-27,Eli Lilly,17,63,20,100,0.200000
2025-09-27,Emerson Electric,46,48,6,100,0.060000
2025-09-27,EnLink Midstream,42,51,7,100,0.070000
2025-09-27,Encompass Health,27,64,9,100,0.090000
2025-09-27,Endeavor Group,15,72,13,100,0.130000
2025-09-27,Endeavor Group Holdings,20,70,10,100,0.100000
2025-09-27,EnerSys,38,51,11,100,0.110000
2025-09-27,Energizer Holdings,86,11,3,100,0.030000
2025-09-27,Energy Transfer,81,10,9,100,0.090000
2025-09-27,Ensign Group,40,55,5,100,0.050000
2025-09-27,Entegris,30,56,14,100,0.140000
2025-09-27,Entergy,40,53,7,100,0.070000
2025-09-27,Enterprise Products Partners,42,40,18,100,0.180000
2025-09-27,Envista,24,63,13,100,0.130000
2025-09-27,Equifax,41,26,32,99,0.323232
2025-09-27,Equinix,40,55,5,100,0.050000
2025-09-27,Equitable Holdings,37,49,14,100,0.140000
2025-09-27,Equity Residential,33,58,9,100,0.090000
2025-09-27,Erie Insurance,26,56,18,100,0.180000
2025-09-27,Estée Lauder,28,57,15,100,0.150000
2025-09-27,Etsy,26,49,25,100,0.250000
2025-09-27,Euronet Worldwide,28,61,11,100,0.110000
2025-09-27,Evergy,45,40,7,92,0.076087
2025-09-27,Eversource Energy,72,15,13,100,0.130000
2025-09-27,Exact Sciences,31,44,25,100,0.250000
2025-09-27,Exelon,38,53,9,100,0.090000
2025-09-27,Expand Energy Corporation,95,3,2,100,0.020000
2025-09-27,Expedia,48,40,12,100,0.120000
2025-09-27,Expeditors International of Washington,30,64,6,100,0.060000
2025-09-27,Extra Space Storage,19,65,16,100,0.160000
2025-09-27,Exxon Mobil,39,53,8,100,0.080000
2025-09-27,F5,41,50,9,100,0.090000
2025-09-27,FM Global,33,43,24,100,0.240000
2025-09-27,FMC Corporation,39,46,15,100,0.150000
2025-09-27,FTI Consulting,32,53,15,100,0.150000
2025-09-27,Fannie Mae,16,65,19,100,0.190000
2025-09-27,Farmers Insurance Exchange,20,51,29,100,0.290000
2025-09-27,Fastenal,57,42,1,100,0.010000
2025-09-27,FedEx,32,49,19,100,0.190000
2025-09-27,Federated Mutual Insurance,19,21,8,48,0.166667
2025-09-27,Ferguson Enterprises,35,57,8,100,0.080000
2025-09-27,Fidelity National Financial,34,54,12,100,0.120000
2025-09-27,Fidelity National Information Services,44,42,14,100,0.140000
2025-09-27,Fifth Third Bancorp,48,46,6,100,0.060000
2025-09-27,First American Financial,31,53,16,100,0.160000
2025-09-27,First Citizens BancShares,40,54,6,100,0.060000
2025-09-27,First Horizon,43,56,1,100,0.010000
2025-09-27,First National of Nebraska,16,36,2,54,0.037037
2025-09-27,First Solar,37,57,6,100,0.060000
2025-09-27,FirstCash,29,55,16,100,0.160000
2025-09-27,FirstEnergy,46,33,21,100,0.210000
2025-09-27,Fiserv,32,55,13,100,0.130000
2025-09-27,Five Below,29,59,12,100,0.120000
2025-09-27,Flagstar Financial,27,55,18,100,0.180000
2025-09-27,Floor & Decor,35,53,12,100,0.120000
2025-09-27,Flowers Foods,21,57,22,100,0.220000
2025-09-27,Flowserve,27,66,7,100,0.070000
2025-09-27,Fluor,31,43,26,100,0.260000
2025-09-27,Foot Locker,10,75,15,100,0.150000
2025-09-27,Ford Motor,29,53,20,102,0.196078
2025-09-27,Fortinet,25,36,39,100,0.390000
2025-09-27,Fortive,19,58,23,100,0.230000
2025-09-27,Fortune Brands Innovations,27,62,11,100,0.110000
2025-09-27,Franklin Resources,36,51,13,100,0.130000
2025-09-27,Freddie Mac,22,70,8,100,0.080000
2025-09-27,Freeport-McMoRan,12,51,37,100,0.370000
2025-09-27,Frontier Airlines,28,58,14,100,0.140000
2025-09-27,Frontier Communications,41,49,10,100,0.100000
2025-09-27,G-III Apparel Group,30,54,16,100,0.160000
2025-09-27,GE HealthCare Technologies,32,61,7,100,0.070000
2025-09-27,GE Vernova,49,50,1,100,0.010000
2025-09-27,GMS,26,65,9,100,0.090000
2025-09-27,GXO Logistics,32,58,10,100,0.100000
2025-09-27,GameStop,25,58,17,100,0.170000
2025-09-27,Gannett,29,57,14,100,0.140000
2025-09-27,Garrett Motion Inc,37,57,6,100,0.060000
2025-09-27,Gartner,25,64,11,100,0.110000
2025-09-27,Gen Digital,47,46,7,100,0.070000
2025-09-27,Generac,32,53,15,100,0.150000
2025-09-27,General Dynamics,94,3,3,100,0.030000
2025-09-27,General Mills,37,52,11,100,0.110000
2025-09-27,General Motors,34,56,12,102,0.117647
2025-09-27,Genesis Energy,78,16,6,100,0.060000
2025-09-27,Genuine Parts,40,57,3,100,0.030000
2025-09-27,Genworth Financial,51,43,6,100,0.060000
2025-09-27,Gilead Sciences,35,58,7,100,0.070000
2025-09-27,Global Partners,42,42,16,100,0.160000
2025-09-27,Global Payments,40,55,5,100,0.050000
2025-09-27,Globe Life,35,55,10,100,0.100000
2025-09-27,GoDaddy,36,55,9,100,0.090000
2025-09-27,Goldman Sachs,23,59,19,101,0.188119
2025-09-27,Goodyear Tire & Rubber,23,65,12,100,0.120000
2025-09-27,Graham Holdings Company,29,64,7,100,0.070000
2025-09-27,Granite Construction,40,55,5,100,0.050000
2025-09-27,Graphic Packaging,14,68,18,100,0.180000
2025-09-27,Gray Television,21,63,16,100,0.160000
2025-09-27,Graybar Electric,14,26,5,45,0.111111
2025-09-27,Green Plains Inc,33,52,15,100,0.150000
2025-09-27,Greif,21,74,5,100,0.050000
2025-09-27,Griffon Corporation,35,57,8,100,0.080000
2025-09-27,Grocery Outlet Holding,32,58,10,100,0.100000
2025-09-27,Group 1 Automotive,24,69,7,100,0.070000
2025-09-27,Guardian Life insurance,48,50,2,100,0.020000
2025-09-27,Guess Inc,30,60,10,100,0.100000
2025-09-27,GuideWell Mutual,20,25,0,45,0.000000
2025-09-27,HB Fuller,19,72,9,100,0.090000
2025-09-27,HCA Healthcare,38,53,9,100,0.090000
2025-09-27,HEICO,32,56,12,100,0.120000
2025-09-27,HF SInclair,24,59,17,100,0.170000
2025-09-27,HP,23,62,15,100,0.150000
2025-09-27,Halliburton,22,51,27,100,0.270000
2025-09-27,Hanesbrands,23,70,7,100,0.070000
2025-09-27,Hanover Insurance Group,37,49,14,100,0.140000
2025-09-27,Harley-Davidson,22,62,16,100,0.160000
2025-09-27,Hasbro,31,46,23,100,0.230000
2025-09-27,Hawaiian Airlines Inc,36,61,3,100,0.030000
2025-09-27,Hawaiian Electric Industries,33,54,13,100,0.130000
2025-09-27,Helmerich & Payne,16,64,20,100,0.200000
2025-09-27,Henry Schein,26,64,10,100,0.100000
2025-09-27,Herc Rentals,32,55,13,100,0.130000
2025-09-27,Hershey,38,48,14,100,0.140000
2025-09-27,Hertz,16,65,19,100,0.190000
2025-09-27,Hewlett Packard Enterprise,19,80,1,100,0.010000
2025-09-27,Hillenbrand,26,66,8,100,0.080000
2025-09-27,Hilton Grand Vacations,90,9,1,100,0.010000
2025-09-27,Hilton Worldwide,45,50,5,100,0.050000
2025-09-27,Hologic,27,64,9,100,0.090000
2025-09-27,Home Depot,31,52,17,100,0.170000
2025-09-27,Honeywell,48,42,10,100,0.100000
2025-09-27,Hormel Foods,29,61,10,100,0.100000
2025-09-27,Host Hotels & Resorts,24,67,9,100,0.090000
2025-09-27,Hovnanian Enterprises,32,53,15,100,0.150000
2025-09-27,Howmet Aerospace,35,58,7,100,0.070000
2025-09-27,Hub Group,21,56,23,100,0.230000
2025-09-27,Hubbell,17,65,18,100,0.180000
2025-09-27,Humana,54,31,15,100,0.150000
2025-09-27,Huntington Bancshares,36,59,5,100,0.050000
2025-09-27,Huntington Ingalls Industries,35,49,16,100,0.160000
2025-09-27,Huntsman,13,52,35,100,0.350000
2025-09-27,Hyatt Hotels,36,61,3,100,0.030000
2025-09-27,Hyster-Yale,22,71,7,100,0.070000
2025-09-27,IAC,32,56,12,100,0.120000
2025-09-27,IBM,39,54,7,100,0.070000
2025-09-27,IDEX,35,55,10,100,0.100000
2025-09-27,IDEXX Laboratories,56,38,6,100,0.060000
2025-09-27,IQVIA,56,37,7,100,0.070000
2025-09-27,ITT,45,48,7,100,0.070000
2025-09-27,Icahn Enterprises,28,51,21,100,0.210000
2025-09-27,Illinois Tool Works,34,56,10,100,0.100000
2025-09-27,Illumina Inc,24,64,12,100,0.120000
2025-09-27,Incyte,37,56,7,100,0.070000
2025-09-27,Ingersoll Rand,33,56,11,100,0.110000
2025-09-27,Ingles Markets,26,49,25,100,0.250000
2025-09-27,Ingram Micro,20,46,34,100,0.340000
2025-09-27,Ingredion,49,40,11,100,0.110000
2025-09-27,Insight Enterprises,25,56,19,100,0.190000
2025-09-27,Insperity,37,48,15,100,0.150000
2025-09-27,Instacart,32,59,9,100,0.090000
2025-09-27,Installed Building Products,22,65,13,100,0.130000
2025-09-27,Intel,19,63,17,99,0.171717
2025-09-27,Interactive Brokers,38,52,10,100,0.100000
2025-09-27,Intercontinental Exchange,41,56,3,100,0.030000
2025-09-27,International Flavors & Fragrances,30,54,16,100,0.160000
2025-09-27,International Paper,22,64,14,100,0.140000
2025-09-27,Interpublic Group,37,56,7,100,0.070000
2025-09-27,Intuit,51,42,7,100,0.070000
2025-09-27,Intuitive Surgical,38,48,14,100,0.140000
2025-09-27,Iron Mountain,28,57,15,100,0.150000
2025-09-27,JB Hunt Transport Services,21,61,18,100,0.180000
2025-09-27,JELD-WEN Holding,20,71,9,100,0.090000
2025-09-27,JM Smucker,35,54,11,100,0.110000
2025-09-27,JPMorgan Chase,39,52,9,100,0.090000
2025-09-27,Jabil,28,59,13,100,0.130000
2025-09-27,Jackson Financial,35,59,6,100,0.060000
2025-09-27,Jacobs Solutions,50,46,4,100,0.040000
2025-09-27,Jefferies Financial,27,64,9,100,0.090000
2025-09-27,JetBlue Airways,33,45,22,100,0.220000
2025-09-27,Johnson & Johnson,48,43,9,100,0.090000
2025-09-27,Jones Lang LaSalle,46,52,2,100,0.020000
2025-09-27,Juniper Networks,25,64,11,100,0.110000
2025-09-27,KB Home,32,59,9,100,0.090000
2025-09-27,KBR,47,39,14,100,0.140000
2025-09-27,KKR & Co,54,40,6,100,0.060000
2025-09-27,KLA,30,50,20,100,0.200000
2025-09-27,Kaiser Aluminum,26,61,13,100,0.130000
2025-09-27,Kellanova,32,53,15,100,0.150000
2025-09-27,Kelly Services Inc,29,63,8,100,0.080000
2025-09-27,Kemper Corporation,34,54,12,100,0.120000
2025-09-27,Kenvue,11,56,33,100,0.330000
2025-09-27,Keurig Dr Pepper,18,64,18,100,0.180000
2025-09-27,KeyCorp,40,50,10,100,0.100000
2025-09-27,Keysight Technologies,31,64,5,100,0.050000
2025-09-27,Kimberly-Clark,40,48,12,100,0.120000
2025-09-27,Kinder Morgan,94,4,2,100,0.020000
2025-09-27,Kirby Corporation,28,60,12,100,0.120000
2025-09-27,Knife River Corporation,25,45,9,79,0.113924
2025-09-27,Knight Swift Transportation,26,58,16,100,0.160000
2025-09-27,Kohl's,30,51,19,100,0.190000
2025-09-27,Kontoor Brands,36,56,8,100,0.080000
2025-09-27,Korn Ferry,52,35,13,100,0.130000
2025-09-27,Kraft Heinz,31,52,17,100,0.170000
2025-09-27,Kroger,41,45,16,102,0.156863
2025-09-27,Kyndryl,33,61,6,100,0.060000
2025-09-27,L3Harris Technologies,31,63,6,100,0.060000
2025-09-27,LCI Industries,32,62,6,100,0.060000
2025-09-27,LKQ,25,59,16,100,0.160000
2025-09-27,LPL Financial,65,32,3,100,0.030000
2025-09-27,Labcorp Holdings,42,52,6,100,0.060000
2025-09-27,Lam Research,38,54,8,100,0.080000
2025-09-27,Lamb Weston,24,64,12,100,0.120000
2025-09-27,Land O'Lakes,34,57,9,100,0.090000
2025-09-27,Landstar System,18,48,34,100,0.340000
2025-09-27,Las Vegas Sands,35,56,9,100,0.090000
2025-09-27,Lear Corporation,35,50,15,100,0.150000
2025-09-27,Leggett & Platt,18,71,11,100,0.110000
2025-09-27,Leidos,36,56,8,100,0.080000
2025-09-27,Lennar,18,62,20,100,0.200000
2025-09-27,Lennox International,32,61,7,100,0.070000
2025-09-27,Levi Strauss,27,71,2,100,0.020000
2025-09-27,Liberty Energy,89,8,3,100,0.030000
2025-09-27,Liberty Media,94,5,1,100,0.010000
2025-09-27,Liberty Mutual Insurance,80,9,11,100,0.110000
2025-09-27,Light & Wonder,24,62,14,100,0.140000
2025-09-27,Lincoln Electric,45,50,5,100,0.050000
2025-09-27,Lincoln National,30,54,16,100,0.160000
2025-09-27,Lithia Motors,37,58,5,100,0.050000
2025-09-27,Live Nation Entertainment,47,27,26,100,0.260000
2025-09-27,Lockheed Martin,49,41,10,100,0.100000
2025-09-27,Loews,37,57,6,100,0.060000
2025-09-27,Louisiana-Pacific Corporation,35,51,14,100,0.140000
2025-09-27,Lowe's,45,37,18,100,0.180000
2025-09-27,Lululemon athletica,4,2,1,7,0.142857
2025-09-27,Lumen Technologies,25,63,12,100,0.120000
2025-09-27,Lyft,12,60,30,102,0.294118
2025-09-27,M&T Bank,31,57,12,100,0.120000
2025-09-27,M/I Homes,25,65,10,100,0.100000
2025-09-27,MDU Resources Group,38,55,7,100,0.070000
2025-09-27,MGM Resorts International,29,58,13,100,0.130000
2025-09-27,MKS Instruments,39,49,12,100,0.120000
2025-09-27,MRC Global,36,61,3,100,0.030000
2025-09-27,MSC Industrial Direct,23,65,12,100,0.120000
2025-09-27,MSCI,33,59,8,100,0.080000
2025-09-27,MYR Group,33,52,15,100,0.150000
2025-09-27,Macys,27,64,9,100,0.090000
2025-09-27,ManpowerGroup,24,57,19,100,0.190000
2025-09-27,Marathon Oil,26,58,16,100,0.160000
2025-09-27,Marathon Petroleum,45,49,6,100,0.060000
2025-09-27,Markel Group,41,47,12,100,0.120000
2025-09-27,Marriott International,37,58,5,100,0.050000
2025-09-27,Marriott Vacations Worldwide,34,52,14,100,0.140000
2025-09-27,Marsh & McLennan,50,40,10,100,0.100000
2025-09-27,Martin Marietta Materials,31,51,18,100,0.180000
2025-09-27,Marvell Technology,37,48,7,92,0.076087
2025-09-27,MasTec,39,58,3,100,0.030000
2025-09-27,Masco,31,57,12,100,0.120000
2025-09-27,Mass Mutual,25,69,6,100,0.060000
2025-09-27,MasterBrand,30,65,5,100,0.050000
2025-09-27,Mastercard,41,49,10,100,0.100000
2025-09-27,Matador Resources,31,60,9,100,0.090000
2025-09-27,Match Group,16,44,40,100,0.400000
2025-09-27,Mativ,26,66,8,100,0.080000
2025-09-27,Matson Inc,36,50,14,100,0.140000
2025-09-27,Mattel,32,49,19,100,0.190000
2025-09-27,Maximus,25,67,8,100,0.080000
2025-09-27,McCormick & Company,38,45,17,100,0.170000
2025-09-27,McDonalds,24,51,25,100,0.250000
2025-09-27,McKesson,39,56,5,100,0.050000
2025-09-27,Medical Mutual of Ohio,27,60,13,100,0.130000
2025-09-27,Merck,36,50,14,100,0.140000
2025-09-27,Mercury General,23,55,22,100,0.220000
2025-09-27,Meritage Homes,25,60,15,100,0.150000
2025-09-27,MetLife,29,56,15,100,0.150000
2025-09-27,Meta Platforms,37,56,13,106,0.122642
2025-09-27,Mettler-Toledo International,26,71,3,100,0.030000
2025-09-27,Microchip Technology,36,57,7,100,0.070000
2025-09-27,Micron Technology,34,56,10,100,0.100000
2025-09-27,Microsoft,15,46,39,100,0.390000
2025-09-27,Middleby,20,73,7,100,0.070000
2025-09-27,MillerKnoll,28,62,10,100,0.100000
2025-09-27,Moderna,36,45,19,100,0.190000
2025-09-27,ModivCare,27,50,23,100,0.230000
2025-09-27,Mohawk Industries,35,56,9,100,0.090000
2025-09-27,Molina Healthcare,29,52,19,100,0.190000
2025-09-27,Molson Coors Beverage,25,60,15,100,0.150000
2025-09-27,Mondelez,37,46,17,100,0.170000
2025-09-27,Monster Beverage,48,47,5,100,0.050000
2025-09-27,Moodys Corporation,3,11,2,16,0.125000
2025-09-27,Moog Inc,39,54,7,100,0.070000
2025-09-27,Morgan Stanley,18,77,7,102,0.068627
2025-09-27,Motorola Solutions,49,45,6,100,0.060000
2025-09-27,Mueller Industries,43,49,8,100,0.080000
2025-09-27,Murphy Oil,27,59,14,100,0.140000
2025-09-27,Murphy USA,32,58,10,100,0.100000
2025-09-27,Mutual of Omaha,43,50,7,100,0.070000
2025-09-27,NCR Atleos,39,57,4,100,0.040000
2025-09-27,NCR Voyix,29,61,10,100,0.100000
2025-09-27,NGL Energy Partners,83,10,7,100,0.070000
2025-09-27,NLV Financial,3,4,3,10,0.300000
2025-09-27,NOV,26,59,15,100,0.150000
2025-09-27,NRG Energy,81,11,8,100,0.080000
2025-09-27,NVR Inc,36,53,11,100,0.110000
2025-09-27,Nasdaq Inc,37,59,4,100,0.040000
2025-09-27,Nationwide Insurance,19,58,23,100,0.230000
2025-09-27,Navient,34,41,25,100,0.250000
2025-09-27,NetApp,31,63,6,100,0.060000
2025-09-27,Netflix,25,52,25,102,0.245098
2025-09-27,NeueHealth,56,40,4,100,0.040000
2025-09-27,New York Life Insurance,42,47,11,100,0.110000
2025-09-27,NewMarket Corporation,32,36,3,71,0.042254
2025-09-27,Newell Brands,32,55,13,100,0.130000
2025-09-27,Newmont,35,55,10,100,0.100000
2025-09-27,News Corp,16,64,20,100,0.200000
2025-09-27,Nexstar Media Group,12,66,14,92,0.152174
2025-09-27,NextEra Energy,83,14,3,100,0.030000
2025-09-27,NiSource,47,41,12,100,0.120000
2025-09-27,Nike,21,58,19,98,0.193878
2025-09-27,Nordson,38,58,4,100,0.040000
2025-09-27,Nordstrom,35,59,6,100,0.060000
2025-09-27,Norfolk Southern,36,55,9,100,0.090000
2025-09-27,Northern Trust,93,5,2,100,0.020000
2025-09-27,Northrop Grumman,31,61,8,100,0.080000
2025-09-27,Northwestern Mutual,31,50,19,100,0.190000
2025-09-27,Nucor,29,52,19,100,0.190000
2025-09-27,Nvidia,27,60,13,100,0.130000
2025-09-27,O'Reilly Automotive,63,35,2,100,0.020000
2025-09-27,O-I Glass,36,51,13,100,0.130000
2025-09-27,ODP Business Solutions,20,49,1,70,0.014286
2025-09-27,OGE Energy,90,6,4,100,0.040000
2025-09-27,ON Semiconductor,22,62,16,100,0.160000
2025-09-27,Occidental Petroleum,33,47,20,100,0.200000
2025-09-27,Old Dominion Freight Line,35,42,23,100,0.230000
2025-09-27,Old National Bancorp,27,73,0,100,0.000000
2025-09-27,Old Republic International,46,48,6,100,0.060000
2025-09-27,Olin,20,60,20,100,0.200000
2025-09-27,Omnicom Group,38,46,16,100,0.160000
2025-09-27,OneMain,49,49,2,100,0.020000
2025-09-27,Oneok,44,52,4,100,0.040000
2025-09-27,Opendoor Technologies,22,49,29,100,0.290000
2025-09-27,Option Care Health,95,5,0,100,0.000000
2025-09-27,Oracle,30,60,14,104,0.134615
2025-09-27,Organon,30,54,16,100,0.160000
2025-09-27,Oscar Health,25,62,13,100,0.130000
2025-09-27,Oshkosh Corporation,38,51,11,100,0.110000
2025-09-27,Otis Worldwide,31,55,14,100,0.140000
2025-09-27,Ovintiv,39,54,7,100,0.070000
2025-09-27,Owens & Minor,25,49,26,100,0.260000
2025-09-27,Owens Corning,23,75,2,100,0.020000
2025-09-27,PACS Group,21,49,30,100,0.300000
2025-09-27,PBF Energy,79,8,13,100,0.130000
2025-09-27,PC Connection Inc,42,33,4,79,0.050633
2025-09-27,PENN Entertainment,90,10,0,100,0.000000
2025-09-27,PG&E,40,42,18,100,0.180000
2025-09-27,PNC Financial Services,45,51,4,100,0.040000
2025-09-27,PPG Industries,28,61,11,100,0.110000
2025-09-27,PPL Corporation,40,50,10,100,0.100000
2025-09-27,PVH,29,43,28,100,0.280000
2025-09-27,Paccar,41,44,15,100,0.150000
2025-09-27,Pacific Life,39,54,7,100,0.070000
2025-09-27,Packaging Corp of America,16,66,18,100,0.180000
2025-09-27,Palo Alto Networks,34,53,13,100,0.130000
2025-09-27,Par Pacific,30,62,8,100,0.080000
2025-09-27,Paramount Global,28,56,16,100,0.160000
2025-09-27,Park Hotels & Resorts,29,58,13,100,0.130000
2025-09-27,Parker-Hannifin,57,42,1,100,0.010000
2025-09-27,Parsons Corporation,43,44,13,100,0.130000
2025-09-27,Patrick Industries,36,58,6,100,0.060000
2025-09-27,Patterson Companies Inc,12,44,4,60,0.066667
2025-09-27,Patterson-UTI Energy,60,27,13,100,0.130000
2025-09-27,PayPal,38,50,12,100,0.120000
2025-09-27,Paychex,31,48,21,100,0.210000
2025-09-27,Peabody Energy,71,21,8,100,0.080000
2025-09-27,Peloton Interactive,33,55,12,100,0.120000
2025-09-27,Penn Mutual Life Insurance,35,60,5,100,0.050000
2025-09-27,PennyMac Financial Services,32,62,6,100,0.060000
2025-09-27,Penske Automotive,33,62,5,100,0.050000
2025-09-27,PepsiCo,48,44,8,100,0.080000
2025-09-27,Performance Food,36,59,5,100,0.050000
2025-09-27,Permian Resources,38,56,6,100,0.060000
2025-09-27,Petco Health and Wellness,75,19,6,100,0.060000
2025-09-27,Peter Kiewit Sons',9,22,11,42,0.261905
2025-09-27,Pfizer,20,58,22,100,0.220000
2025-09-27,Philip Morris International,55,35,10,100,0.100000
2025-09-27,Phillips 66,44,48,8,100,0.080000
2025-09-27,Pinnacle West Capital,31,47,22,100,0.220000
2025-09-27,Pinterest,32,59,9,100,0.090000
2025-09-27,Pioneer Natural Resources,50,33,17,100,0.170000
2025-09-27,Pitney Bowes,31,61,8,100,0.080000
2025-09-27,Plains GP,32,47,21,100,0.210000
2025-09-27,Playtika Holding,26,51,23,100,0.230000
2025-09-27,Plexus Corp,37,57,6,100,0.060000
2025-09-27,Polaris Inc,42,51,7,100,0.070000
2025-09-27,Pool Corporation,31,55,14,100,0.140000
2025-09-27,Popular Inc,95,3,2,100,0.020000
2025-09-27,Portland General Electric,32,54,14,100,0.140000
2025-09-27,Post Holdings,23,68,9,100,0.090000
2025-09-27,PrIncipal Financial,43,51,6,100,0.060000
2025-09-27,PriceSmart,32,61,7,100,0.070000
2025-09-27,Primerica,38,56,6,100,0.060000
2025-09-27,ProFrac Holding,30,52,18,100,0.180000
2025-09-27,Procter & Gamble,35,47,18,100,0.180000
2025-09-27,Progressive Insurance,29,55,16,100,0.160000
2025-09-27,Prologis,39,58,3,100,0.030000
2025-09-27,Prudential Financial,40,51,9,100,0.090000
2025-09-27,Public Service Enterprise Group,44,48,8,100,0.080000
2025-09-27,Public Storage,41,43,16,100,0.160000
2025-09-27,Publix Super Markets,38,55,7,100,0.070000
2025-09-27,Puget Sound Energy,56,28,16,100,0.160000
2025-09-27,PulteGroup,24,68,8,100,0.080000
2025-09-27,Pure Storage,39,56,5,100,0.050000
2025-09-27,QVC Group,23,64,13,100,0.130000
2025-09-27,QXO Building Products,0,8,2,10,0.200000
2025-09-27,Qorvo,47,45,8,100,0.080000
2025-09-27,Qualcomm,27,66,8,101,0.079208
2025-09-27,Quanta Services,39,58,3,100,0.030000
2025-09-27,Quest Diagnostics,33,59,8,100,0.080000
2025-09-27,QuidelOrtho,32,57,11,100,0.110000
2025-09-27,REV Group,47,44,9,100,0.090000
2025-09-27,RPM International,26,62,12,100,0.120000
2025-09-27,RTX,32,52,16,100,0.160000
2025-09-27,RXO Inc,32,51,17,100,0.170000
2025-09-27,Rackspace Technology,25,59,16,100,0.160000
2025-09-27,Radius Recycling,14,55,31,100,0.310000
2025-09-27,Ralph Lauren,27,65,8,100,0.080000
2025-09-27,Range Resources,45,47,8,100,0.080000
2025-09-27,Raymond James Financial,34,60,6,100,0.060000
2025-09-27,Realty Income,42,41,17,100,0.170000
2025-09-27,Regal Rexnord,30,61,9,100,0.090000
2025-09-27,Regeneron Pharmaceuticals,48,46,6,100,0.060000
2025-09-27,Regions Financial,47,46,7,100,0.070000
2025-09-27,Reinsurance Group of America,34,60,6,100,0.060000
2025-09-27,Reliance Inc,41,48,11,100,0.110000
2025-09-27,Republic Services,33,23,44,100,0.440000
2025-09-27,ResMed,25,70,5,100,0.050000
2025-09-27,Resideo Technologies,38,55,7,100,0.070000
2025-09-27,Restoration Hardware,25,55,20,100,0.200000
2025-09-27,Revvity,29,53,18,100,0.180000
2025-09-27,Rithm Capital,19,76,5,100,0.050000
2025-09-27,Rivian Automotive,33,60,9,102,0.088235
2025-09-27,Robert Half,34,50,16,100,0.160000
2025-09-27,Roblox,28,37,35,100,0.350000
2025-09-27,Rocket Companies,20,73,7,100,0.070000
2025-09-27,Rockwell Automation,36,57,7,100,0.070000
2025-09-27,Roku,57,38,7,102,0.068627
2025-09-27,Rollins Inc,27,68,5,100,0.050000
2025-09-27,Roper Technologies,31,63,6,100,0.060000
2025-09-27,Ross Stores,24,64,12,100,0.120000
2025-09-27,Rush Enterprises,34,53,13,100,0.130000
2025-09-27,Ryder System,44,52,4,100,0.040000
2025-09-27,Ryerson Holding,20,71,8,99,0.080808
2025-09-27,S&P Global,21,71,8,100,0.080000
2025-09-27,SBA Communications,42,45,13,100,0.130000
2025-09-27,SS&C Technologies,42,55,3,100,0.030000
2025-09-27,Sabre Corporation,25,62,13,100,0.130000
2025-09-27,Saia Inc,48,47,5,100,0.050000
2025-09-27,Salesforce,14,41,46,101,0.455446
2025-09-27,Sallie Mae,30,58,12,100,0.120000
2025-09-27,Sally Beauty,94,5,1,100,0.010000
2025-09-27,Sanmina,25,71,4,100,0.040000
2025-09-27,ScanSource,35,56,9,100,0.090000
2025-09-27,Schneider National,30,56,14,100,0.140000
2025-09-27,Science Applications International,30,52,18,100,0.180000
2025-09-27,Scotts Miracle-Gro,37,42,21,100,0.210000
2025-09-27,Seaboard,27,51,22,100,0.220000
2025-09-27,Sealed Air Corporation,23,67,10,100,0.100000
2025-09-27,Securian Financial,27,65,8,100,0.080000
2025-09-27,Select Medical Holdings,28,58,14,100,0.140000
2025-09-27,Selective Insurance Group,21,50,29,100,0.290000
2025-09-27,Sempra,34,61,5,100,0.050000
2025-09-27,Sentry Insurance Group,4,6,0,10,0.000000
2025-09-27,Service Corp International,5,13,6,24,0.250000
2025-09-27,ServiceNow,24,61,15,100,0.150000
2025-09-27,Sherwin-Williams,18,63,18,99,0.181818
2025-09-27,Shift4 Payments,23,62,15,100,0.150000
2025-09-27,Silgan,17,53,30,100,0.300000
2025-09-27,Simon Property Group,42,50,8,100,0.080000
2025-09-27,Sinclair,8,60,24,92,0.260870
2025-09-27,Sirius XM,25,71,4,100,0.040000
2025-09-27,SiteOne Landscape Supply,27,60,13,100,0.130000
2025-09-27,Skechers USA,24,69,7,100,0.070000
2025-09-27,SkyWest,16,53,31,100,0.310000
2025-09-27,Skyline Champion,44,12,2,58,0.034483
2025-09-27,Skyworks Solutions,28,63,9,100,0.090000
2025-09-27,Smurfit Westrock,18,65,17,100,0.170000
2025-09-27,Snap Inc,33,40,27,100,0.270000
2025-09-27,Snap-on,23,61,16,100,0.160000
2025-09-27,Snowflake Inc,53,47,0,100,0.000000
2025-09-27,Solventum,32,64,4,100,0.040000
2025-09-27,Sonic Automotive,16,76,8,100,0.080000
2025-09-27,Sonoco Products,22,67,11,100,0.110000
2025-09-27,Southern Company,43,49,8,100,0.080000
2025-09-27,Southwest Airlines,21,53,27,101,0.267327
2025-09-27,Southwest Gas Holdings,38,54,8,100,0.080000
2025-09-27,SpartanNash,22,75,3,100,0.030000
2025-09-27,Spectrum Brands,26,51,23,100,0.230000
2025-09-27,Spire Inc,53,38,9,100,0.090000
2025-09-27,Spirit AeroSystems,35,42,23,100,0.230000
2025-09-27,Spirit Airlines,13,52,27,92,0.293478
2025-09-27,Splunk,40,45,15,100,0.150000
2025-09-27,Sprouts Farmers Market,27,69,4,100,0.040000
2025-09-27,Stagwell,31,57,12,100,0.120000
2025-09-27,Stanley Black & Decker,23,61,16,100,0.160000
2025-09-27,Starbucks,3,82,7,92,0.076087
2025-09-27,State Farm Insurance,19,55,26,100,0.260000
2025-09-27,State Street,31,57,12,100,0.120000
2025-09-27,Steel Dynamics,85,10,5,100,0.050000
2025-09-27,Steelcase,24,73,3,100,0.030000
2025-09-27,Stericycle,11,31,58,100,0.580000
2025-09-27,Stifel Financial,32,62,6,100,0.060000
2025-09-27,StoneX Group,35,62,3,100,0.030000
2025-09-27,Stryker,23,62,15,100,0.150000
2025-09-27,Summit Materials,23,67,10,100,0.100000
2025-09-27,Sun Communities,44,44,12,100,0.120000
2025-09-27,Super Micro Computer,88,8,4,100,0.040000
2025-09-27,Surgery Partners,28,58,14,100,0.140000
2025-09-27,Sylvamo,24,55,21,100,0.210000
2025-09-27,Synchrony Financial,55,43,2,100,0.020000
2025-09-27,Synopsys,28,50,22,100,0.220000
2025-09-27,Synovus Financial,38,55,7,100,0.070000
2025-09-27,Sysco,48,42,10,100,0.100000
2025-09-27,T Rowe Price,48,49,3,100,0.030000
2025-09-27,TD Synnex,36,59,5,100,0.050000
2025-09-27,TEGNA,23,65,12,100,0.120000
2025-09-27,THOR Industries,25,66,9,100,0.090000
2025-09-27,TIAA,26,62,12,100,0.120000
2025-09-27,TJX,57,35,8,100,0.080000
2025-09-27,Take-Two Interactive Software,37,58,5,100,0.050000
2025-09-27,Talen Energy,86,13,1,100,0.010000
2025-09-27,Tapestry,27,61,12,100,0.120000
2025-09-27,Targa Resources,49,39,12,100,0.120000
2025-09-27,Target Corporation,48,46,6,100,0.060000
2025-09-27,Taylor Morrison Home,29,62,9,100,0.090000
2025-09-27,Teladoc Health,36,52,12,100,0.120000
2025-09-27,Teledyne Technologies,31,65,4,100,0.040000
2025-09-27,Teleflex,22,67,11,100,0.110000
2025-09-27,Telephone & Data Systems,8,14,2,24,0.083333
2025-09-27,TelevisaUnivision,28,54,18,100,0.180000
2025-09-27,Tempur Sealy International,31,53,16,100,0.160000
2025-09-27,Tenet Healthcare,35,52,13,100,0.130000
2025-09-27,Teradyne,33,63,4,100,0.040000
2025-09-27,Terex,17,74,9,100,0.090000
2025-09-27,Tesla,22,43,34,99,0.343434
2025-09-27,Tetra Tech,46,43,11,100,0.110000
2025-09-27,Texas Instruments,26,58,16,100,0.160000
2025-09-27,Texas Roadhouse,36,53,11,100,0.110000
2025-09-27,Textron,30,59,11,100,0.110000
2025-09-27,The Andersons Inc,29,67,4,100,0.040000
2025-09-27,The Coca-Cola Company,30,59,11,100,0.110000
2025-09-27,The Greenbrier Companies,24,66,10,100,0.100000
2025-09-27,The Hartford,26,42,32,100,0.320000
2025-09-27,The Mosaic Company,29,55,16,100,0.160000
2025-09-27,Thermo Fisher Scientific,42,50,8,100,0.080000
2025-09-27,Thrivent Financial for Lutherans,32,57,8,97,0.082474
2025-09-27,Timken,24,63,13,100,0.130000
2025-09-27,Titan Machinery,18,68,14,100,0.140000
2025-09-27,Toast Inc,29,58,13,100,0.130000
2025-09-27,Toll Brothers,13,84,3,100,0.030000
2025-09-27,TopBuild,22,78,0,100,0.000000
2025-09-27,Topgolf Callaway Brands,20,59,21,100,0.210000
2025-09-27,Toro Company,27,64,9,100,0.090000
2025-09-27,Tractor Supply,27,66,7,100,0.070000
2025-09-27,TransDigm,40,45,15,100,0.150000
2025-09-27,TransUnion,34,43,23,100,0.230000
2025-09-27,Travelers Insurance,36,38,26,100,0.260000
2025-09-27,TreeHouse Foods,17,54,29,100,0.290000
2025-09-27,Tri Pointe Homes,26,67,7,100,0.070000
2025-09-27,TriNet Group,26,63,11,100,0.110000
2025-09-27,Trimble Inc,37,54,9,100,0.090000
2025-09-27,Trinity Industries,28,53,19,100,0.190000
2025-09-27,TruStage,50,40,10,100,0.100000
2025-09-27,Truist Financial,39,51,10,100,0.100000
2025-09-27,Tutor Perini Corporation,58,36,6,100,0.060000
2025-09-27,Twilio,37,55,8,100,0.080000
2025-09-27,Tyson Foods,25,60,15,100,0.150000
2025-09-27,U-Haul,8,35,57,100,0.570000
2025-09-27,UFP Industries,26,61,13,100,0.130000
2025-09-27,UGI Utilities Inc,26,32,18,76,0.236842
2025-09-27,UL Solutions,42,50,8,100,0.080000
2025-09-27,UPS,17,51,32,100,0.320000
2025-09-27,US Bancorp,39,55,6,100,0.060000
2025-09-27,US Foods,53,43,4,100,0.040000
2025-09-27,USAA,28,49,23,100,0.230000
2025-09-27,Uber,21,58,23,102,0.225490
2025-09-27,Ulta Beauty,82,12,6,100,0.060000
2025-09-27,Under Armour,25,65,10,100,0.100000
2025-09-27,Union Pacific,45,47,8,100,0.080000
2025-09-27,United Airlines,80,14,7,101,0.069307
2025-09-27,United Natural Foods,85,12,3,100,0.030000
2025-09-27,United Rentals,94,4,2,100,0.020000
2025-09-27,United States Steel,51,42,7,100,0.070000
2025-09-27,UnitedHealth,41,43,16,100,0.160000
2025-09-27,Universal Corporation,34,58,8,100,0.080000
2025-09-27,Universal Health Services,33,55,12,100,0.120000
2025-09-27,Unum Group,39,49,12,100,0.120000
2025-09-27,Upbound Group,40,55,5,100,0.050000
2025-09-27,Urban Outfitters,40,53,7,100,0.070000
2025-09-27,V2X,45,50,5,100,0.050000
2025-09-27,VF Corporation,26,49,25,100,0.250000
2025-09-27,VICI Properties,36,58,6,100,0.060000
2025-09-27,Vail Resorts,23,54,23,100,0.230000
2025-09-27,Valero Energy,84,8,8,100,0.080000
2025-09-27,Valley National Bancorp,23,70,7,100,0.070000
2025-09-27,Valmont Industries,39,51,10,100,0.100000
2025-09-27,Valvoline Inc,33,61,6,100,0.060000
2025-09-27,Ventas Inc,45,55,0,100,0.000000
2025-09-27,Verisk Analytics,37,48,15,100,0.150000
2025-09-27,Verizon,44,49,7,100,0.070000
2025-09-27,Vertex Pharmaceuticals,44,35,21,100,0.210000
2025-09-27,Vertiv,46,48,6,100,0.060000
2025-09-27,Viasat,39,53,8,100,0.080000
2025-09-27,Viatris,27,52,21,100,0.210000
2025-09-27,Victorias Secret,24,52,24,100,0.240000
2025-09-27,Visa Inc,66,28,6,100,0.060000
2025-09-27,Vishay Intertechnology,28,57,15,100,0.150000
2025-09-27,Vista Outdoor,18,64,18,100,0.180000
2025-09-27,Visteon,39,55,6,100,0.060000
2025-09-27,Vistra,43,47,10,100,0.100000
2025-09-27,Vontier,37,57,6,100,0.060000
2025-09-27,Voya Financial,36,58,6,100,0.060000
2025-09-27,Vulcan Materials,28,54,18,100,0.180000
2025-09-27,WEC Energy,82,13,5,100,0.050000
2025-09-27,WESCO International,36,56,8,100,0.080000
2025-09-27,WEX,41,53,6,100,0.060000
2025-09-27,WR Berkley,42,48,10,100,0.100000
2025-09-27,WW Grainger,31,56,13,100,0.130000
2025-09-27,Wabash National,22,51,27,100,0.270000
2025-09-27,Walmart,30,44,26,100,0.260000
2025-09-27,Walt Disney,42,47,11,100,0.110000
2025-09-27,Warner Bros Discovery,14,68,18,100,0.180000
2025-09-27,Warner Music Group,24,62,14,100,0.140000
2025-09-27,Waters Corporation,45,46,9,100,0.090000
2025-09-27,Watsco,27,49,24,100,0.240000
2025-09-27,Wayfair,32,61,7,100,0.070000
2025-09-27,Webster Financial,30,58,12,100,0.120000
2025-09-27,Weis Markets,23,63,14,100,0.140000
2025-09-27,Wells Fargo,83,9,8,100,0.080000
2025-09-27,Welltower,60,40,0,100,0.000000
2025-09-27,Werner Enterprises,31,48,21,100,0.210000
2025-09-27,West Pharmaceutical Services,38,47,15,100,0.150000
2025-09-27,Western & Southern Financial,30,66,4,100,0.040000
2025-09-27,Western Alliance Bancorp,19,44,25,88,0.284091
2025-09-27,Western Digital,28,59,13,100,0.130000
2025-09-27,Western Midstream Partners,35,57,8,100,0.080000
2025-09-27,Western Union,24,66,10,100,0.100000
2025-09-27,Westinghouse Air Brake Technologies,29,56,15,100,0.150000
2025-09-27,Weyerhaeuser,27,60,13,100,0.130000
2025-09-27,Whirlpool,25,57,18,100,0.180000
2025-09-27,Williams Companies,50,42,8,100,0.080000
2025-09-27,Williams-Sonoma,28,65,7,100,0.070000
2025-09-27,Winnebago Industries,20,64,16,100,0.160000
2025-09-27,Wintrust Financial,35,64,1,100,0.010000
2025-09-27,Woodward Inc,30,68,2,100,0.020000
2025-09-27,Workday,25,61,14,100,0.140000
2025-09-27,World Kinect,32,57,11,100,0.110000
2025-09-27,Worthington Enterprises,33,63,4,100,0.040000
2025-09-27,Wynn Resorts,21,59,20,100,0.200000
2025-09-27,XPO,23,62,15,100,0.150000
2025-09-27,Xcel Energy,51,22,27,100,0.270000
2025-09-27,Xerox,22,59,19,100,0.190000
2025-09-27,Xylem Inc,45,49,6,100,0.060000
2025-09-27,Yum Brands,30,55,15,100,0.150000
2025-09-27,Yum China,39,47,14,100,0.140000
2025-09-27,Zebra Technologies,34,55,11,100,0.110000
2025-09-27,Zimmer Biomet,38,58,4,100,0.040000
2025-09-27,Zions Bancorp,36,46,18,100,0.180000
2025-09-27,Zoetis,48,44,8,100,0.080000
2025-09-27,Zoom Video Communications,31,53,16,100,0.160000
2025-09-27,eXp World,31,61,8,100,0.080000
2025-09-27,iHeartMedia,26,64,10,100,0.100000
2025-09-28,3M,32,60,8,100,0.080000
2025-09-28,A O Smith,25,74,1,100,0.010000
2025-09-28,A-Mark Precious Metals,89,11,0,100,0.000000
2025-09-28,ABM Industries,27,53,20,100,0.200000
2025-09-28,ADT,34,45,21,100,0.210000
2025-09-28,AECOM,46,44,10,100,0.100000
2025-09-28,AES,40,45,15,100,0.150000
2025-09-28,AGCO,34,59,7,100,0.070000
2025-09-28,AGNC Investment,26,55,19,100,0.190000
2025-09-28,AIG,29,57,14,100,0.140000
2025-09-28,AMC Entertainment,79,15,6,100,0.060000
2025-09-28,AMC Networks,25,55,20,100,0.200000
2025-09-28,AMN Healthcare Services,20,59,21,100,0.210000
2025-09-28,APA,29,52,19,100,0.190000
2025-09-28,APi Group,34,54,12,100,0.120000
2025-09-28,ARKO,24,67,9,100,0.090000
2025-09-28,ASGN,27,58,15,100,0.150000
2025-09-28,AT&T,34,52,16,102,0.156863
2025-09-28,ATI Inc,32,64,4,100,0.040000
2025-09-28,AbbVie,45,42,13,100,0.130000
2025-09-28,Abbott Laboratories,56,31,13,100,0.130000
2025-09-28,Abercrombie & Fitch,29,59,12,100,0.120000
2025-09-28,Academy Sports and Outdoors,30,60,10,100,0.100000
2025-09-28,Acadia Healthcare,16,64,20,100,0.200000
2025-09-28,Ace Hardware,27,59,14,100,0.140000
2025-09-28,Acuity Inc,39,39,8,86,0.093023
2025-09-28,Adams Resources & Energy,19,5,1,25,0.040000
2025-09-28,AdaptHealth,36,51,13,100,0.130000
2025-09-28,Adobe,46,48,6,100,0.060000
2025-09-28,Advance Auto Parts,21,58,21,100,0.210000
2025-09-28,Advanced Drainage Systems,83,11,6,100,0.060000
2025-09-28,Advanced Micro Devices,80,6,14,100,0.140000
2025-09-28,Advantage Solutions,77,16,7,100,0.070000
2025-09-28,Aflac,38,34,28,100,0.280000
2025-09-28,Agilent Technologies,35,60,5,100,0.050000
2025-09-28,Agilon Health,26,56,18,100,0.180000
2025-09-28,Air Lease,29,63,8,100,0.080000
2025-09-28,Air Products & Chemicals,26,63,11,100,0.110000
2025-09-28,Airbnb,29,58,13,100,0.130000
2025-09-28,Akamai Technologies,41,45,14,100,0.140000
2025-09-28,Alaska Air,35,61,4,100,0.040000
2025-09-28,Albemarle Corporation,29,59,12,100,0.120000
2025-09-28,Albertsons,39,50,11,100,0.110000
2025-09-28,Alcoa Corporation,24,57,19,100,0.190000
2025-09-28,Alexandria Real Estate Equities,43,51,6,100,0.060000
2025-09-28,Alight Solutions,28,63,9,100,0.090000
2025-09-28,Align Technology,16,54,30,100,0.300000
2025-09-28,Allegiant Travel Company,20,72,8,100,0.080000
2025-09-28,Alliance Resource Partners,33,51,16,100,0.160000
2025-09-28,Alliant Energy,78,18,4,100,0.040000
2025-09-28,Allison Transmission,31,53,16,100,0.160000
2025-09-28,Allstate,57,30,13,100,0.130000
2025-09-28,Ally Financial,39,56,5,100,0.050000
2025-09-28,Alpha Metallurgical Resources,33,49,18,100,0.180000
2025-09-28,Alphabet,32,46,21,99,0.212121
2025-09-28,Altice USA,32,50,18,100,0.180000
2025-09-28,Altria,49,44,7,100,0.070000
2025-09-28,Amazon,25,63,12,100,0.120000
2025-09-28,Ameren,36,43,21,100,0.210000
2025-09-28,American Airlines,24,24,50,98,0.510204
2025-09-28,American Axle & Manufacturing,30,58,12,100,0.120000
2025-09-28,American Eagle Outfitters,30,51,19,100,0.190000
2025-09-28,American Electric Power,38,52,10,100,0.100000
2025-09-28,American Express,46,44,10,100,0.100000
2025-09-28,American Family Insurance,49,40,11,100,0.110000
2025-09-28,American Financial Group,30,59,11,100,0.110000
2025-09-28,American Tower,47,42,11,100,0.110000
2025-09-28,American Water Works,42,52,6,100,0.060000
2025-09-28,Americold Realty Trust,74,21,5,100,0.050000
2025-09-28,Ameriprise Financial,46,44,10,100,0.100000
2025-09-28,Ametek,30,62,8,100,0.080000
2025-09-28,Amgen,25,58,17,100,0.170000
2025-09-28,Amica Mutual Insurance,23,63,6,92,0.065217
2025-09-28,Amkor Technology,36,54,10,100,0.100000
2025-09-28,Amphenol,38,60,2,100,0.020000
2025-09-28,Analog Devices,33,61,6,100,0.060000
2025-09-28,Antero Resources,40,51,9,100,0.090000
2025-09-28,Anywhere Real Estate Inc,35,60,5,100,0.050000
2025-09-28,Apollo Global Management,27,67,6,100,0.060000
2025-09-28,AppLovin,29,65,8,102,0.078431
2025-09-28,Apple,38,55,11,104,0.105769
2025-09-28,Applied Industrial Technologies,29,69,2,100,0.020000
2025-09-28,Applied Materials,20,52,28,100,0.280000
2025-09-28,AptarGroup,30,63,7,100,0.070000
2025-09-28,Aramark,44,47,9,100,0.090000
2025-09-28,ArcBest,25,64,11,100,0.110000
2025-09-28,Arch Resources,63,25,12,100,0.120000
2025-09-28,Archer Daniels Midland,42,45,13,100,0.130000
2025-09-28,Ares Management,35,62,3,100,0.030000
2025-09-28,Arista Networks,34,57,9,100,0.090000
2025-09-28,Arrow Electronics,26,67,7,100,0.070000
2025-09-28,Arthur J Gallagher,36,59,5,100,0.050000
2025-09-28,Asbury Automotive Group,32,58,10,100,0.100000
2025-09-28,Assurant,40,49,11,100,0.110000
2025-09-28,Atkore,26,56,18,100,0.180000
2025-09-28,Atlassian,29,54,17,100,0.170000
2025-09-28,Atmos Energy,88,9,3,100,0.030000
2025-09-28,Auto-Owners Insurance,31,59,10,100,0.100000
2025-09-28,AutoNation,27,59,14,100,0.140000
2025-09-28,AutoZone,27,51,22,100,0.220000
2025-09-28,Autodesk,27,69,4,100,0.040000
2025-09-28,Autoliv,47,46,7,100,0.070000
2025-09-28,Automatic Data Processing,50,43,7,100,0.070000
2025-09-28,AvalonBay Communities,37,57,6,100,0.060000
2025-09-28,Avantor,30,52,18,100,0.180000
2025-09-28,Avery Dennison,28,67,5,100,0.050000
2025-09-28,Avient,30,60,10,100,0.100000
2025-09-28,Avis Budget,20,59,21,100,0.210000
2025-09-28,Avnet,19,70,11,100,0.110000
2025-09-28,BJ's Wholesale Club,30,55,15,100,0.150000
2025-09-28,BOK Financial,40,50,10,100,0.100000
2025-09-28,BWX Technologies,47,49,4,100,0.040000
2025-09-28,Baker Hughes,40,52,8,100,0.080000
2025-09-28,Ball Corporation,30,65,5,100,0.050000
2025-09-28,Bank of America,34,57,9,100,0.090000
2025-09-28,Bank of New York Mellon,51,44,5,100,0.050000
2025-09-28,Bath & Body Works,35,49,16,100,0.160000
2025-09-28,Baxter International,24,60,16,100,0.160000
2025-09-28,Becton Dickinson,38,50,12,100,0.120000
2025-09-28,Belden,30,58,12,100,0.120000
2025-09-28,Benchmark Electronics,21,70,9,100,0.090000
2025-09-28,Berkshire Hathaway,30,49,23,102,0.225490
2025-09-28,Berry Global,23,61,16,100,0.160000
2025-09-28,Best Buy,93,6,1,100,0.010000
2025-09-28,Bio-Rad Laboratories,24,64,12,100,0.120000
2025-09-28,Biogen,28,62,10,100,0.100000
2025-09-28,BlackRock,27,57,16,100,0.160000
2025-09-28,Blackstone,35,50,15,100,0.150000
2025-09-28,Bloomin Brands,12,70,18,100,0.180000
2025-09-28,BlueLinx,25,67,8,100,0.080000
2025-09-28,Boeing,29,59,16,104,0.153846
2025-09-28,Boise Cascade,15,47,38,100,0.380000
2025-09-28,Booking Holdings,29,55,16,100,0.160000
2025-09-28,Booz Allen Hamilton,24,59,17,100,0.170000
2025-09-28,BorgWarner,56,39,5,100,0.050000
2025-09-28,Boston Properties,20,71,9,100,0.090000
2025-09-28,Boston Scientific,45,46,9,100,0.090000
2025-09-28,Boyd Gaming,26,56,18,100,0.180000
2025-09-28,Bread Financial,44,53,3,100,0.030000
2025-09-28,BrightSpring Health Services,30,60,10,100,0.100000
2025-09-28,BrightView Holdings,23,67,10,100,0.100000
2025-09-28,Brighthouse Financial,32,60,8,100,0.080000
2025-09-28,Brinker International,44,50,6,100,0.060000
2025-09-28,Brinks Company,10,4,6,20,0.300000
2025-09-28,Bristol-Myers Squibb,29,53,18,100,0.180000
2025-09-28,Broadcom,37,58,7,102,0.068627
2025-09-28,Broadridge Financial Solutions,59,39,2,100,0.020000
2025-09-28,Brookdale Senior Living,32,51,17,100,0.170000
2025-09-28,Brown & Brown,30,54,16,100,0.160000
2025-09-28,Brown-Forman,18,62,20,100,0.200000
2025-09-28,Bruker,21,53,26,100,0.260000
2025-09-28,Brunswick Corporation,42,45,13,100,0.130000
2025-09-28,Builders FirstSource,36,56,8,100,0.080000
2025-09-28,Burlington Stores,31,62,7,100,0.070000
2025-09-28,CACI International,50,43,7,100,0.070000
2025-09-28,CBRE Group,29,69,2,100,0.020000
2025-09-28,CDW,40,53,7,100,0.070000
2025-09-28,CF Industries,32,61,7,100,0.070000
2025-09-28,CH Robinson Worldwide,36,53,11,100,0.110000
2025-09-28,CHS,38,51,11,100,0.110000
2025-09-28,CIncinnati Financial,36,55,9,100,0.090000
2025-09-28,CME Group,26,67,7,100,0.070000
2025-09-28,CMS Energy,89,8,3,100,0.030000
2025-09-28,CNO Financial Group,30,65,5,100,0.050000
2025-09-28,CNX Resources,40,53,7,100,0.070000
2025-09-28,CSX,36,51,13,100,0.130000
2025-09-28,CVS Health,43,42,15,100,0.150000
2025-09-28,Cabot Corporation,32,63,5,100,0.050000
2025-09-28,Cadence,25,55,20,100,0.200000
2025-09-28,Caesars Entertainment,79,16,5,100,0.050000
2025-09-28,Cal-Maine Foods,50,45,5,100,0.050000
2025-09-28,Caleres Inc,29,57,14,100,0.140000
2025-09-28,California Resources,42,51,7,100,0.070000
2025-09-28,Calumet Inc,32,42,14,88,0.159091
2025-09-28,Campbell Soup,28,54,18,100,0.180000
2025-09-28,Camping World,25,60,15,100,0.150000
2025-09-28,Capital One,32,48,20,100,0.200000
2025-09-28,CarMax,13,45,40,98,0.408163
2025-09-28,Cardinal Health,32,57,11,100,0.110000
2025-09-28,Carlisle Companies,33,52,15,100,0.150000
2025-09-28,Carlyle Group,32,61,7,100,0.070000
2025-09-28,Carpenter Technology,31,62,7,100,0.070000
2025-09-28,Carrier Global,32,51,17,100,0.170000
2025-09-28,Carters Inc,14,28,2,44,0.045455
2025-09-28,Carvana,37,53,10,100,0.100000
2025-09-28,Caseys General Stores,33,56,11,100,0.110000
2025-09-28,Catalent,22,67,11,100,0.110000
2025-09-28,Caterpillar,25,63,12,100,0.120000
2025-09-28,Cboe Global Markets,31,64,5,100,0.050000
2025-09-28,Celanese,22,49,29,100,0.290000
2025-09-28,Cencora,54,40,6,100,0.060000
2025-09-28,Centene,30,35,35,100,0.350000
2025-09-28,CenterPoint Energy,75,14,11,100,0.110000
2025-09-28,Central Garden & Pet,23,71,6,100,0.060000
2025-09-28,Century Communities,31,62,7,100,0.070000
2025-09-28,ChampionX,37,62,1,100,0.010000
2025-09-28,Charles River Laboratories International,23,62,15,100,0.150000
2025-09-28,Charles Schwab,43,50,7,100,0.070000
2025-09-28,Chart Industries,32,58,10,100,0.100000
2025-09-28,Charter Communications,20,58,22,100,0.220000
2025-09-28,Cheesecake Factory,23,61,16,100,0.160000
2025-09-28,Chefs Warehouse,37,55,8,100,0.080000
2025-09-28,Chemours,32,47,21,100,0.210000
2025-09-28,Cheniere Energy,87,11,2,100,0.020000
2025-09-28,Chevron,33,44,23,100,0.230000
2025-09-28,Chewy,41,45,14,100,0.140000
2025-09-28,Chipotle Mexican Grill,27,63,10,100,0.100000
2025-09-28,Chord Energy,91,4,5,100,0.050000
2025-09-28,Church & Dwight,33,56,11,100,0.110000
2025-09-28,Ciena,41,54,5,100,0.050000
2025-09-28,Cigna,41,46,13,100,0.130000
2025-09-28,Cinemark,27,56,17,100,0.170000
2025-09-28,Cintas,42,48,10,100,0.100000
2025-09-28,Cisco Systems,29,56,15,100,0.150000
2025-09-28,Citigroup,31,55,14,100,0.140000
2025-09-28,Citizens Financial Group,40,56,4,100,0.040000
2025-09-28,Civitas Resources,28,43,29,100,0.290000
2025-09-28,Clean Harbors,75,12,13,100,0.130000
2025-09-28,Clear Channel Outdoor Hldgs,8,2,0,10,0.000000
2025-09-28,Cleveland-Cliffs,22,54,24,100,0.240000
2025-09-28,Clorox,35,49,16,100,0.160000
2025-09-28,Cognizant Technology Solutions,46,45,9,100,0.090000
2025-09-28,Coherent,33,61,6,100,0.060000
2025-09-28,Coinbase Global,19,66,15,100,0.150000
2025-09-28,Colgate-Palmolive,39,48,13,100,0.130000
2025-09-28,Columbia Banking System,36,60,4,100,0.040000
2025-09-28,Columbia Sportswear,26,50,24,100,0.240000
2025-09-28,Comcast,34,42,24,100,0.240000
2025-09-28,Comerica,45,42,13,100,0.130000
2025-09-28,Comfort Systems USA,95,3,2,100,0.020000
2025-09-28,CommScope,21,76,3,100,0.030000
2025-09-28,Commercial Metals,29,56,15,100,0.150000
2025-09-28,Community Health Systems,25,54,21,100,0.210000
2025-09-28,Compass Group,29,52,19,100,0.190000
2025-09-28,Conagra Brands,28,53,19,100,0.190000
2025-09-28,Concentrix,24,55,21,100,0.210000
2025-09-28,Conduent,29,52,19,100,0.190000
2025-09-28,ConocoPhillips,40,44,16,100,0.160000
2025-09-28,Consol Energy,79,16,5,100,0.050000
2025-09-28,Consolidated Edison,34,52,14,100,0.140000
2025-09-28,Constellation Brands,16,45,39,100,0.390000
2025-09-28,Constellation Energy,84,10,6,100,0.060000
2025-09-28,Continental Resources,41,45,14,100,0.140000
2025-09-28,Cooper Cos,3,19,5,27,0.185185
2025-09-28,Cooper-Standard,29,63,8,100,0.080000
2025-09-28,Copart,46,41,13,100,0.130000
2025-09-28,Core & Main,25,55,20,100,0.200000
2025-09-28,Corebridge Financial,38,51,11,100,0.110000
2025-09-28,Cornerstone Building Brands,26,61,13,100,0.130000
2025-09-28,Corning,35,53,12,100,0.120000
2025-09-28,Corpay,27,70,3,100,0.030000
2025-09-28,Corteva,29,59,12,100,0.120000
2025-09-28,Costco,30,54,15,99,0.151515
2025-09-28,Coterra Energy,78,15,7,100,0.070000
2025-09-28,Coty,24,51,25,100,0.250000
2025-09-28,Country Financial,29,51,20,100,0.200000
2025-09-28,Coupang,39,50,11,100,0.110000
2025-09-28,Cracker Barrel Old Country Store,16,63,21,100,0.210000
2025-09-28,Crocs,32,59,9,100,0.090000
2025-09-28,CrossAmerica Partners,25,71,4,100,0.040000
2025-09-28,CrowdStrike,31,49,20,100,0.200000
2025-09-28,Crown Castle,37,57,6,100,0.060000
2025-09-28,Crown Holdings,30,62,8,100,0.080000
2025-09-28,Cullen Frost Bankers,46,48,6,100,0.060000
2025-09-28,Cummins Inc,57,39,4,100,0.040000
2025-09-28,Curtiss-Wright,45,53,2,100,0.020000
2025-09-28,DR Horton,27,62,11,100,0.110000
2025-09-28,DTE Energy,77,15,8,100,0.080000
2025-09-28,DXC Technology,31,66,3,100,0.030000
2025-09-28,DaVita,32,43,25,100,0.250000
2025-09-28,Dana Incorporated,36,55,9,100,0.090000
2025-09-28,Danaher,41,52,7,100,0.070000
2025-09-28,Darden Restaurants,34,41,25,100,0.250000
2025-09-28,Darling Ingredients,88,8,4,100,0.040000
2025-09-28,Deckers Outdoor,30,52,18,100,0.180000
2025-09-28,Deere,27,56,17,100,0.170000
2025-09-28,Delek US,41,46,13,100,0.130000
2025-09-28,Dell Technologies,39,55,6,100,0.060000
2025-09-28,Delta Air Lines,18,57,24,99,0.242424
2025-09-28,Dentsply Sirona,26,69,5,100,0.050000
2025-09-28,Designer Brands,20,65,15,100,0.150000
2025-09-28,Devon Energy,93,3,4,100,0.040000
2025-09-28,DexCom,19,65,16,100,0.160000
2025-09-28,Diamondback Energy,85,8,7,100,0.070000
2025-09-28,Dicks Sporting Goods,27,66,7,100,0.070000
2025-09-28,Diebold Nixdorf,33,65,2,100,0.020000
2025-09-28,Digital Realty Trust,80,19,1,100,0.010000
2025-09-28,Dillards,26,56,18,100,0.180000
2025-09-28,Discover Financial,32,53,15,100,0.150000
2025-09-28,DocuSign,45,42,13,100,0.130000
2025-09-28,Dollar General,17,59,24,100,0.240000
2025-09-28,Dollar Tree,36,52,12,100,0.120000
2025-09-28,Dominion Energy,69,22,9,100,0.090000
2025-09-28,Dominos Pizza Inc,17,21,7,45,0.155556
2025-09-28,Domtar,26,65,9,100,0.090000
2025-09-28,Donaldson Company,40,52,8,100,0.080000
2025-09-28,DoorDash,37,44,19,100,0.190000
2025-09-28,Dover Corporation,46,54,0,100,0.000000
2025-09-28,DraftKings,53,36,3,92,0.032609
2025-09-28,Dream Finders Homes,82,13,5,100,0.050000
2025-09-28,Dropbox,31,63,6,100,0.060000
2025-09-28,DuPont,30,59,11,100,0.110000
2025-09-28,Duke Energy,77,12,11,100,0.110000
2025-09-28,Dycom Industries,32,63,5,100,0.050000
2025-09-28,EMCOR Group,34,61,5,100,0.050000
2025-09-28,EOG Resources,42,48,10,100,0.100000
2025-09-28,EPAM Systems,36,56,8,100,0.080000
2025-09-28,EQT,37,55,8,100,0.080000
2025-09-28,ESAB,33,53,14,100,0.140000
2025-09-28,East West Bancorp,43,51,6,100,0.060000
2025-09-28,Eastman Chemical,23,48,29,100,0.290000
2025-09-28,Ebay,29,62,9,100,0.090000
2025-09-28,EchoStar,20,68,12,100,0.120000
2025-09-28,Ecolab,47,49,4,100,0.040000
2025-09-28,Edison International,29,47,24,100,0.240000
2025-09-28,Edward Jones,36,54,10,100,0.100000
2025-09-28,Edwards Lifesciences,41,38,21,100,0.210000
2025-09-28,Elanco Animal Health,37,58,5,100,0.050000
2025-09-28,Electronic Arts,17,72,3,92,0.032609
2025-09-28,Elevance Health,42,40,18,100,0.180000
2025-09-28,Eli Lilly,19,63,18,100,0.180000
2025-09-28,Emerson Electric,49,45,6,100,0.060000
2025-09-28,EnLink Midstream,42,51,7,100,0.070000
2025-09-28,Encompass Health,26,66,8,100,0.080000
2025-09-28,Endeavor Group,17,72,11,100,0.110000
2025-09-28,Endeavor Group Holdings,19,70,11,100,0.110000
2025-09-28,EnerSys,35,55,10,100,0.100000
2025-09-28,Energizer Holdings,87,9,4,100,0.040000
2025-09-28,Energy Transfer,85,6,9,100,0.090000
2025-09-28,Ensign Group,46,49,5,100,0.050000
2025-09-28,Entegris,33,49,18,100,0.180000
2025-09-28,Entergy,39,52,9,100,0.090000
2025-09-28,Enterprise Products Partners,45,39,16,100,0.160000
2025-09-28,Envista,22,64,14,100,0.140000
2025-09-28,Equifax,44,40,16,100,0.160000
2025-09-28,Equinix,43,52,5,100,0.050000
2025-09-28,Equitable Holdings,38,47,15,100,0.150000
2025-09-28,Equity Residential,34,58,8,100,0.080000
2025-09-28,Erie Insurance,27,55,18,100,0.180000
2025-09-28,Estée Lauder,30,56,14,100,0.140000
2025-09-28,Etsy,26,44,30,100,0.300000
2025-09-28,Euronet Worldwide,27,63,10,100,0.100000
2025-09-28,Evergy,51,35,6,92,0.065217
2025-09-28,Eversource Energy,72,15,13,100,0.130000
2025-09-28,Exact Sciences,28,44,28,100,0.280000
2025-09-28,Exelon,39,51,10,100,0.100000
2025-09-28,Expand Energy Corporation,96,2,2,100,0.020000
2025-09-28,Expedia,49,41,10,100,0.100000
2025-09-28,Expeditors International of Washington,31,63,6,100,0.060000
2025-09-28,Extra Space Storage,18,67,15,100,0.150000
2025-09-28,Exxon Mobil,46,49,5,100,0.050000
2025-09-28,F5,40,50,10,100,0.100000
2025-09-28,FM Global,33,42,25,100,0.250000
2025-09-28,FMC Corporation,41,44,15,100,0.150000
2025-09-28,FTI Consulting,33,53,14,100,0.140000
2025-09-28,Fannie Mae,16,65,19,100,0.190000
2025-09-28,Farmers Insurance Exchange,20,49,31,100,0.310000
2025-09-28,Fastenal,64,34,2,100,0.020000
2025-09-28,FedEx,40,43,17,100,0.170000
2025-09-28,Federated Mutual Insurance,19,19,8,46,0.173913
2025-09-28,Ferguson Enterprises,33,59,8,100,0.080000
2025-09-28,Fidelity National Financial,35,53,12,100,0.120000
2025-09-28,Fidelity National Information Services,41,42,17,100,0.170000
2025-09-28,Fifth Third Bancorp,47,46,7,100,0.070000
2025-09-28,First American Financial,28,55,17,100,0.170000
2025-09-28,First Citizens BancShares,40,54,6,100,0.060000
2025-09-28,First Horizon,42,57,1,100,0.010000
2025-09-28,First National of Nebraska,15,37,2,54,0.037037
2025-09-28,First Solar,33,60,7,100,0.070000
2025-09-28,FirstCash,29,55,16,100,0.160000
2025-09-28,FirstEnergy,47,34,19,100,0.190000
2025-09-28,Fiserv,38,52,10,100,0.100000
2025-09-28,Five Below,30,55,15,100,0.150000
2025-09-28,Flagstar Financial,26,58,16,100,0.160000
2025-09-28,Floor & Decor,35,55,10,100,0.100000
2025-09-28,Flowers Foods,21,58,21,100,0.210000
2025-09-28,Flowserve,26,71,3,100,0.030000
2025-09-28,Fluor,35,45,20,100,0.200000
2025-09-28,Foot Locker,12,74,14,100,0.140000
2025-09-28,Ford Motor,27,55,18,100,0.180000
2025-09-28,Fortinet,27,36,37,100,0.370000
2025-09-28,Fortive,19,60,21,100,0.210000
2025-09-28,Fortune Brands Innovations,27,61,12,100,0.120000
2025-09-28,Franklin Resources,34,55,11,100,0.110000
2025-09-28,Freddie Mac,23,65,12,100,0.120000
2025-09-28,Freeport-McMoRan,14,52,34,100,0.340000
2025-09-28,Frontier Airlines,27,56,17,100,0.170000
2025-09-28,Frontier Communications,40,51,9,100,0.090000
2025-09-28,G-III Apparel Group,29,56,15,100,0.150000
2025-09-28,GE HealthCare Technologies,32,60,8,100,0.080000
2025-09-28,GE Vernova,49,46,5,100,0.050000
2025-09-28,GMS,21,71,8,100,0.080000
2025-09-28,GXO Logistics,31,60,9,100,0.090000
2025-09-28,GameStop,22,58,20,100,0.200000
2025-09-28,Gannett,27,58,15,100,0.150000
2025-09-28,Garrett Motion Inc,35,60,5,100,0.050000
2025-09-28,Gartner,23,66,11,100,0.110000
2025-09-28,Gen Digital,44,49,7,100,0.070000
2025-09-28,Generac,29,54,17,100,0.170000
2025-09-28,General Dynamics,91,5,4,100,0.040000
2025-09-28,General Mills,35,50,15,100,0.150000
2025-09-28,General Motors,33,54,13,100,0.130000
2025-09-28,Genesis Energy,80,16,4,100,0.040000
2025-09-28,Genuine Parts,41,56,3,100,0.030000
2025-09-28,Genworth Financial,47,46,7,100,0.070000
2025-09-28,Gilead Sciences,37,54,9,100,0.090000
2025-09-28,Global Partners,41,43,16,100,0.160000
2025-09-28,Global Payments,37,57,6,100,0.060000
2025-09-28,Globe Life,37,54,9,100,0.090000
2025-09-28,GoDaddy,40,52,8,100,0.080000
2025-09-28,Goldman Sachs,25,61,14,100,0.140000
2025-09-28,Goodyear Tire & Rubber,22,67,11,100,0.110000
2025-09-28,Graham Holdings Company,30,64,6,100,0.060000
2025-09-28,Granite Construction,42,54,4,100,0.040000
2025-09-28,Graphic Packaging,17,67,16,100,0.160000
2025-09-28,Gray Television,24,61,15,100,0.150000
2025-09-28,Graybar Electric,13,28,5,46,0.108696
2025-09-28,Green Plains Inc,33,52,15,100,0.150000
2025-09-28,Greif,22,73,5,100,0.050000
2025-09-28,Griffon Corporation,36,57,7,100,0.070000
2025-09-28,Grocery Outlet Holding,31,60,9,100,0.090000
2025-09-28,Group 1 Automotive,22,70,8,100,0.080000
2025-09-28,Guardian Life insurance,48,50,2,100,0.020000
2025-09-28,Guess Inc,30,61,9,100,0.090000
2025-09-28,GuideWell Mutual,20,25,0,45,0.000000
2025-09-28,HB Fuller,24,68,8,100,0.080000
2025-09-28,HCA Healthcare,46,49,5,100,0.050000
2025-09-28,HEICO,35,53,12,100,0.120000
2025-09-28,HF SInclair,23,60,17,100,0.170000
2025-09-28,HP,28,60,12,100,0.120000
2025-09-28,Halliburton,19,53,28,100,0.280000
2025-09-28,Hanesbrands,23,68,9,100,0.090000
2025-09-28,Hanover Insurance Group,41,47,12,100,0.120000
2025-09-28,Harley-Davidson,20,62,18,100,0.180000
2025-09-28,Hasbro,34,47,19,100,0.190000
2025-09-28,Hawaiian Airlines Inc,36,61,3,100,0.030000
2025-09-28,Hawaiian Electric Industries,32,55,13,100,0.130000
2025-09-28,Helmerich & Payne,19,63,18,100,0.180000
2025-09-28,Henry Schein,27,64,9,100,0.090000
2025-09-28,Herc Rentals,32,56,12,100,0.120000
2025-09-28,Hershey,37,43,12,92,0.130435
2025-09-28,Hertz,16,64,20,100,0.200000
2025-09-28,Hewlett Packard Enterprise,22,76,2,100,0.020000
2025-09-28,Hillenbrand,25,68,7,100,0.070000
2025-09-28,Hilton Grand Vacations,90,9,1,100,0.010000
2025-09-28,Hilton Worldwide,40,52,8,100,0.080000
2025-09-28,Hologic,26,65,9,100,0.090000
2025-09-28,Home Depot,29,51,20,100,0.200000
2025-09-28,Honeywell,48,44,8,100,0.080000
2025-09-28,Hormel Foods,28,63,9,100,0.090000
2025-09-28,Host Hotels & Resorts,22,70,8,100,0.080000
2025-09-28,Hovnanian Enterprises,35,50,15,100,0.150000
2025-09-28,Howmet Aerospace,36,58,6,100,0.060000
2025-09-28,Hub Group,22,55,23,100,0.230000
2025-09-28,Hubbell,22,61,17,100,0.170000
2025-09-28,Humana,55,29,16,100,0.160000
2025-09-28,Huntington Bancshares,38,58,4,100,0.040000
2025-09-28,Huntington Ingalls Industries,36,49,15,100,0.150000
2025-09-28,Huntsman,13,54,33,100,0.330000
2025-09-28,Hyatt Hotels,32,65,3,100,0.030000
2025-09-28,Hyster-Yale,26,66,8,100,0.080000
2025-09-28,IAC,34,54,12,100,0.120000
2025-09-28,IBM,36,56,7,99,0.070707
2025-09-28,IDEX,35,55,10,100,0.100000
2025-09-28,IDEXX Laboratories,56,37,7,100,0.070000
2025-09-28,IQVIA,55,37,8,100,0.080000
2025-09-28,ITT,44,48,8,100,0.080000
2025-09-28,Icahn Enterprises,29,50,21,100,0.210000
2025-09-28,Illinois Tool Works,35,56,9,100,0.090000
2025-09-28,Illumina Inc,20,64,16,100,0.160000
2025-09-28,Incyte,41,53,6,100,0.060000
2025-09-28,Ingersoll Rand,32,57,11,100,0.110000
2025-09-28,Ingles Markets,25,50,25,100,0.250000
2025-09-28,Ingram Micro,17,47,36,100,0.360000
2025-09-28,Ingredion,48,43,9,100,0.090000
2025-09-28,Insight Enterprises,28,55,17,100,0.170000
2025-09-28,Insperity,38,49,13,100,0.130000
2025-09-28,Instacart,32,57,11,100,0.110000
2025-09-28,Installed Building Products,19,69,12,100,0.120000
2025-09-28,Intel,22,63,15,100,0.150000
2025-09-28,Interactive Brokers,39,52,9,100,0.090000
2025-09-28,Intercontinental Exchange,45,53,2,100,0.020000
2025-09-28,International Flavors & Fragrances,31,52,17,100,0.170000
2025-09-28,International Paper,21,68,11,100,0.110000
2025-09-28,Interpublic Group,31,61,8,100,0.080000
2025-09-28,Intuit,47,47,6,100,0.060000
2025-09-28,Intuitive Surgical,37,47,16,100,0.160000
2025-09-28,Iron Mountain,27,56,17,100,0.170000
2025-09-28,JB Hunt Transport Services,21,62,17,100,0.170000
2025-09-28,JELD-WEN Holding,19,71,10,100,0.100000
2025-09-28,JM Smucker,36,53,11,100,0.110000
2025-09-28,JPMorgan Chase,41,49,10,100,0.100000
2025-09-28,Jabil,27,61,12,100,0.120000
2025-09-28,Jackson Financial,33,60,7,100,0.070000
2025-09-28,Jacobs Solutions,52,44,4,100,0.040000
2025-09-28,Jefferies Financial,28,61,11,100,0.110000
2025-09-28,JetBlue Airways,32,49,19,100,0.190000
2025-09-28,Johnson & Johnson,49,45,6,100,0.060000
2025-09-28,Jones Lang LaSalle,46,52,2,100,0.020000
2025-09-28,Juniper Networks,27,64,9,100,0.090000
2025-09-28,KB Home,34,57,9,100,0.090000
2025-09-28,KBR,48,42,10,100,0.100000
2025-09-28,KKR & Co,55,40,5,100,0.050000
2025-09-28,KLA,28,52,20,100,0.200000
2025-09-28,Kaiser Aluminum,26,61,13,100,0.130000
2025-09-28,Kellanova,28,58,14,100,0.140000
2025-09-28,Kelly Services Inc,27,64,9,100,0.090000
2025-09-28,Kemper Corporation,33,54,13,100,0.130000
2025-09-28,Kenvue,15,54,31,100,0.310000
2025-09-28,Keurig Dr Pepper,17,64,19,100,0.190000
2025-09-28,KeyCorp,39,51,10,100,0.100000
2025-09-28,Keysight Technologies,32,63,5,100,0.050000
2025-09-28,Kimberly-Clark,39,48,13,100,0.130000
2025-09-28,Kinder Morgan,95,3,2,100,0.020000
2025-09-28,Kirby Corporation,28,61,11,100,0.110000
2025-09-28,Knife River Corporation,24,48,8,80,0.100000
2025-09-28,Knight Swift Transportation,26,58,16,100,0.160000
2025-09-28,Kohl's,31,50,19,100,0.190000
2025-09-28,Kontoor Brands,35,58,7,100,0.070000
2025-09-28,Korn Ferry,53,34,13,100,0.130000
2025-09-28,Kraft Heinz,29,52,19,100,0.190000
2025-09-28,Kroger,43,43,14,100,0.140000
2025-09-28,Kyndryl,30,64,6,100,0.060000
2025-09-28,L3Harris Technologies,31,63,6,100,0.060000
2025-09-28,LCI Industries,30,63,7,100,0.070000
2025-09-28,LKQ,24,59,17,100,0.170000
2025-09-28,LPL Financial,65,32,3,100,0.030000
2025-09-28,Labcorp Holdings,42,52,6,100,0.060000
2025-09-28,Lam Research,39,53,8,100,0.080000
2025-09-28,Lamb Weston,25,63,12,100,0.120000
2025-09-28,Land O'Lakes,34,57,9,100,0.090000
2025-09-28,Landstar System,19,49,32,100,0.320000
2025-09-28,Las Vegas Sands,30,59,11,100,0.110000
2025-09-28,Lear Corporation,34,53,13,100,0.130000
2025-09-28,Leggett & Platt,18,71,11,100,0.110000
2025-09-28,Leidos,39,54,7,100,0.070000
2025-09-28,Lennar,17,66,17,100,0.170000
2025-09-28,Lennox International,33,60,7,100,0.070000
2025-09-28,Levi Strauss,24,73,3,100,0.030000
2025-09-28,Liberty Energy,87,10,3,100,0.030000
2025-09-28,Liberty Media,94,5,1,100,0.010000
2025-09-28,Liberty Mutual Insurance,81,9,10,100,0.100000
2025-09-28,Light & Wonder,22,64,14,100,0.140000
2025-09-28,Lincoln Electric,45,48,7,100,0.070000
2025-09-28,Lincoln National,32,52,16,100,0.160000
2025-09-28,Lithia Motors,35,61,4,100,0.040000
2025-09-28,Live Nation Entertainment,49,28,23,100,0.230000
2025-09-28,Lockheed Martin,44,47,9,100,0.090000
2025-09-28,Loews,36,58,6,100,0.060000
2025-09-28,Louisiana-Pacific Corporation,33,53,14,100,0.140000
2025-09-28,Lowe's,49,37,14,100,0.140000
2025-09-28,Lululemon athletica,21,51,28,100,0.280000
2025-09-28,Lumen Technologies,23,64,13,100,0.130000
2025-09-28,Lyft,13,57,30,100,0.300000
2025-09-28,M&T Bank,28,58,14,100,0.140000
2025-09-28,M/I Homes,28,64,8,100,0.080000
2025-09-28,MDU Resources Group,38,55,7,100,0.070000
2025-09-28,MGM Resorts International,29,60,11,100,0.110000
2025-09-28,MKS Instruments,39,50,11,100,0.110000
2025-09-28,MRC Global,34,61,5,100,0.050000
2025-09-28,MSC Industrial Direct,23,65,12,100,0.120000
2025-09-28,MSCI,24,67,9,100,0.090000
2025-09-28,MYR Group,34,52,14,100,0.140000
2025-09-28,Macys,27,64,9,100,0.090000
2025-09-28,ManpowerGroup,24,55,21,100,0.210000
2025-09-28,Marathon Oil,27,57,16,100,0.160000
2025-09-28,Marathon Petroleum,46,47,7,100,0.070000
2025-09-28,Markel Group,42,46,12,100,0.120000
2025-09-28,Marriott International,35,59,6,100,0.060000
2025-09-28,Marriott Vacations Worldwide,36,52,12,100,0.120000
2025-09-28,Marsh & McLennan,52,38,10,100,0.100000
2025-09-28,Martin Marietta Materials,30,51,19,100,0.190000
2025-09-28,Marvell Technology,36,53,11,100,0.110000
2025-09-28,MasTec,40,58,2,100,0.020000
2025-09-28,Masco,29,59,12,100,0.120000
2025-09-28,Mass Mutual,22,50,6,78,0.076923
2025-09-28,MasterBrand,32,62,6,100,0.060000
2025-09-28,Mastercard,42,50,8,100,0.080000
2025-09-28,Matador Resources,32,60,8,100,0.080000
2025-09-28,Match Group,20,44,36,100,0.360000
2025-09-28,Mativ,24,66,10,100,0.100000
2025-09-28,Matson Inc,36,50,14,100,0.140000
2025-09-28,Mattel,31,52,17,100,0.170000
2025-09-28,Maximus,31,60,9,100,0.090000
2025-09-28,McCormick & Company,37,46,17,100,0.170000
2025-09-28,McDonalds,26,48,26,100,0.260000
2025-09-28,McKesson,44,51,5,100,0.050000
2025-09-28,Medical Mutual of Ohio,27,59,14,100,0.140000
2025-09-28,Merck,38,47,16,101,0.158416
2025-09-28,Mercury General,22,55,23,100,0.230000
2025-09-28,Meritage Homes,24,60,16,100,0.160000
2025-09-28,MetLife,27,61,12,100,0.120000
2025-09-28,Meta Platforms,34,53,15,102,0.147059
2025-09-28,Mettler-Toledo International,33,64,3,100,0.030000
2025-09-28,Microchip Technology,33,59,8,100,0.080000
2025-09-28,Micron Technology,32,58,10,100,0.100000
2025-09-28,Microsoft,26,46,28,100,0.280000
2025-09-28,Middleby,18,74,8,100,0.080000
2025-09-28,MillerKnoll,27,63,10,100,0.100000
2025-09-28,Moderna,36,43,21,100,0.210000
2025-09-28,ModivCare,25,51,24,100,0.240000
2025-09-28,Mohawk Industries,33,58,9,100,0.090000
2025-09-28,Molina Healthcare,26,52,22,100,0.220000
2025-09-28,Molson Coors Beverage,24,61,15,100,0.150000
2025-09-28,Mondelez,34,51,15,100,0.150000
2025-09-28,Monster Beverage,46,48,6,100,0.060000
2025-09-28,Moodys Corporation,3,11,2,16,0.125000
2025-09-28,Moog Inc,39,53,8,100,0.080000
2025-09-28,Morgan Stanley,24,72,6,102,0.058824
2025-09-28,Motorola Solutions,54,41,5,100,0.050000
2025-09-28,Mueller Industries,46,48,6,100,0.060000
2025-09-28,Murphy Oil,29,59,12,100,0.120000
2025-09-28,Murphy USA,31,59,10,100,0.100000
2025-09-28,Mutual of Omaha,43,50,7,100,0.070000
2025-09-28,NCR Atleos,39,59,2,100,0.020000
2025-09-28,NCR Voyix,28,62,10,100,0.100000
2025-09-28,NGL Energy Partners,82,8,10,100,0.100000
2025-09-28,NLV Financial,3,4,3,10,0.300000
2025-09-28,NOV,34,52,14,100,0.140000
2025-09-28,NRG Energy,80,12,8,100,0.080000
2025-09-28,NVR Inc,34,55,11,100,0.110000
2025-09-28,Nasdaq Inc,33,62,5,100,0.050000
2025-09-28,Nationwide Insurance,16,58,26,100,0.260000
2025-09-28,Navient,34,43,23,100,0.230000
2025-09-28,NetApp,34,62,4,100,0.040000
2025-09-28,Netflix,28,48,24,100,0.240000
2025-09-28,NeueHealth,54,42,4,100,0.040000
2025-09-28,New York Life Insurance,39,53,8,100,0.080000
2025-09-28,NewMarket Corporation,24,27,5,56,0.089286
2025-09-28,Newell Brands,29,57,14,100,0.140000
2025-09-28,Newmont,35,57,8,100,0.080000
2025-09-28,News Corp,16,63,21,100,0.210000
2025-09-28,Nexstar Media Group,10,68,14,92,0.152174
2025-09-28,NextEra Energy,77,19,4,100,0.040000
2025-09-28,NiSource,46,42,12,100,0.120000
2025-09-28,Nike,22,57,22,101,0.217822
2025-09-28,Nordson,37,59,4,100,0.040000
2025-09-28,Nordstrom,35,61,5,101,0.049505
2025-09-28,Norfolk Southern,37,56,7,100,0.070000
2025-09-28,Northern Trust,93,5,2,100,0.020000
2025-09-28,Northrop Grumman,32,59,9,100,0.090000
2025-09-28,Northwestern Mutual,30,51,19,100,0.190000
2025-09-28,Nucor,27,53,20,100,0.200000
2025-09-28,Nvidia,30,59,14,103,0.135922
2025-09-28,O'Reilly Automotive,57,37,6,100,0.060000
2025-09-28,O-I Glass,38,47,15,100,0.150000
2025-09-28,ODP Business Solutions,19,45,1,65,0.015385
2025-09-28,OGE Energy,88,7,5,100,0.050000
2025-09-28,ON Semiconductor,24,59,17,100,0.170000
2025-09-28,Occidental Petroleum,37,45,18,100,0.180000
2025-09-28,Old Dominion Freight Line,34,42,24,100,0.240000
2025-09-28,Old National Bancorp,31,68,1,100,0.010000
2025-09-28,Old Republic International,48,47,5,100,0.050000
2025-09-28,Olin,20,59,21,100,0.210000
2025-09-28,Omnicom Group,39,45,16,100,0.160000
2025-09-28,OneMain,45,53,2,100,0.020000
2025-09-28,Oneok,44,51,5,100,0.050000
2025-09-28,Opendoor Technologies,19,48,33,100,0.330000
2025-09-28,Option Care Health,94,6,0,100,0.000000
2025-09-28,Oracle,26,58,15,99,0.151515
2025-09-28,Organon,26,59,15,100,0.150000
2025-09-28,Oscar Health,25,60,15,100,0.150000
2025-09-28,Oshkosh Corporation,38,50,12,100,0.120000
2025-09-28,Otis Worldwide,32,51,17,100,0.170000
2025-09-28,Ovintiv,40,53,7,100,0.070000
2025-09-28,Owens & Minor,25,49,26,100,0.260000
2025-09-28,Owens Corning,22,76,2,100,0.020000
2025-09-28,PACS Group,27,44,27,98,0.275510
2025-09-28,PBF Energy,80,7,13,100,0.130000
2025-09-28,PC Connection Inc,39,29,3,71,0.042254
2025-09-28,PENN Entertainment,83,17,0,100,0.000000
2025-09-28,PG&E,48,34,18,100,0.180000
2025-09-28,PNC Financial Services,42,52,6,100,0.060000
2025-09-28,PPG Industries,27,60,13,100,0.130000
2025-09-28,PPL Corporation,41,51,8,100,0.080000
2025-09-28,PVH,29,45,26,100,0.260000
2025-09-28,Paccar,39,47,14,100,0.140000
2025-09-28,Pacific Life,39,52,9,100,0.090000
2025-09-28,Packaging Corp of America,15,66,19,100,0.190000
2025-09-28,Palo Alto Networks,32,53,15,100,0.150000
2025-09-28,Par Pacific,29,64,7,100,0.070000
2025-09-28,Paramount Global,27,60,13,100,0.130000
2025-09-28,Park Hotels & Resorts,29,58,13,100,0.130000
2025-09-28,Parker-Hannifin,55,43,2,100,0.020000
2025-09-28,Parsons Corporation,42,43,15,100,0.150000
2025-09-28,Patrick Industries,36,58,6,100,0.060000
2025-09-28,Patterson Companies Inc,11,46,4,61,0.065574
2025-09-28,Patterson-UTI Energy,60,25,15,100,0.150000
2025-09-28,PayPal,34,51,15,100,0.150000
2025-09-28,Paychex,29,54,17,100,0.170000
2025-09-28,Peabody Energy,70,22,8,100,0.080000
2025-09-28,Peloton Interactive,33,55,12,100,0.120000
2025-09-28,Penn Mutual Life Insurance,35,59,6,100,0.060000
2025-09-28,PennyMac Financial Services,32,59,9,100,0.090000
2025-09-28,Penske Automotive,34,62,4,100,0.040000
2025-09-28,PepsiCo,41,49,10,100,0.100000
2025-09-28,Performance Food,36,58,6,100,0.060000
2025-09-28,Permian Resources,40,54,6,100,0.060000
2025-09-28,Petco Health and Wellness,78,18,4,100,0.040000
2025-09-28,Peter Kiewit Sons',8,25,11,44,0.250000
2025-09-28,Pfizer,22,53,25,100,0.250000
2025-09-28,Philip Morris International,57,34,9,100,0.090000
2025-09-28,Phillips 66,39,51,10,100,0.100000
2025-09-28,Pinnacle West Capital,32,46,22,100,0.220000
2025-09-28,Pinterest,31,61,8,100,0.080000
2025-09-28,Pioneer Natural Resources,48,36,16,100,0.160000
2025-09-28,Pitney Bowes,32,62,6,100,0.060000
2025-09-28,Plains GP,35,44,21,100,0.210000
2025-09-28,Playtika Holding,27,50,23,100,0.230000
2025-09-28,Plexus Corp,34,59,7,100,0.070000
2025-09-28,Polaris Inc,45,50,5,100,0.050000
2025-09-28,Pool Corporation,29,57,14,100,0.140000
2025-09-28,Popular Inc,93,4,3,100,0.030000
2025-09-28,Portland General Electric,33,53,14,100,0.140000
2025-09-28,Post Holdings,23,68,9,100,0.090000
2025-09-28,PrIncipal Financial,40,53,7,100,0.070000
2025-09-28,PriceSmart,34,60,6,100,0.060000
2025-09-28,Primerica,38,56,6,100,0.060000
2025-09-28,Primoris Services,43,55,2,100,0.020000
2025-09-28,ProFrac Holding,30,53,17,100,0.170000
2025-09-28,Procter & Gamble,37,46,17,100,0.170000
2025-09-28,Progressive Insurance,29,57,14,100,0.140000
2025-09-28,Prologis,39,58,3,100,0.030000
2025-09-28,Prudential Financial,40,52,8,100,0.080000
2025-09-28,Public Service Enterprise Group,42,48,10,100,0.100000
2025-09-28,Public Storage,39,44,17,100,0.170000
2025-09-28,Publix Super Markets,42,52,6,100,0.060000
2025-09-28,Puget Sound Energy,55,30,15,100,0.150000
2025-09-28,PulteGroup,28,64,8,100,0.080000
2025-09-28,Pure Storage,38,57,5,100,0.050000
2025-09-28,QVC Group,23,64,13,100,0.130000
2025-09-28,QXO Building Products,0,9,1,10,0.100000
2025-09-28,Qorvo,47,44,9,100,0.090000
2025-09-28,Qualcomm,29,60,11,100,0.110000
2025-09-28,Quanta Services,41,56,3,100,0.030000
2025-09-28,Quest Diagnostics,28,62,10,100,0.100000
2025-09-28,QuidelOrtho,30,57,13,100,0.130000
2025-09-28,REV Group,44,47,9,100,0.090000
2025-09-28,RPM International,26,61,13,100,0.130000
2025-09-28,RTX,37,48,15,100,0.150000
2025-09-28,RXO Inc,35,49,16,100,0.160000
2025-09-28,Rackspace Technology,24,57,19,100,0.190000
2025-09-28,Radius Recycling,13,55,32,100,0.320000
2025-09-28,Ralph Lauren,28,58,6,92,0.065217
2025-09-28,Range Resources,44,49,7,100,0.070000
2025-09-28,Raymond James Financial,36,59,5,100,0.050000
2025-09-28,Realty Income,36,44,20,100,0.200000
2025-09-28,Regal Rexnord,30,61,9,100,0.090000
2025-09-28,Regeneron Pharmaceuticals,46,49,5,100,0.050000
2025-09-28,Regions Financial,43,49,8,100,0.080000
2025-09-28,Reinsurance Group of America,36,58,6,100,0.060000
2025-09-28,Reliance Inc,42,46,12,100,0.120000
2025-09-28,Republic Services,32,22,46,100,0.460000
2025-09-28,ResMed,25,71,4,100,0.040000
2025-09-28,Resideo Technologies,38,53,9,100,0.090000
2025-09-28,Restoration Hardware,28,55,17,100,0.170000
2025-09-28,Revvity,32,52,16,100,0.160000
2025-09-28,Rithm Capital,19,75,6,100,0.060000
2025-09-28,Rivian Automotive,30,59,11,100,0.110000
2025-09-28,Robert Half,34,48,18,100,0.180000
2025-09-28,Roblox,29,35,36,100,0.360000
2025-09-28,Rocket Companies,16,75,9,100,0.090000
2025-09-28,Rockwell Automation,38,59,3,100,0.030000
2025-09-28,Roku,51,40,9,100,0.090000
2025-09-28,Rollins Inc,26,69,5,100,0.050000
2025-09-28,Roper Technologies,30,63,7,100,0.070000
2025-09-28,Ross Stores,37,53,10,100,0.100000
2025-09-28,Rush Enterprises,34,54,12,100,0.120000
2025-09-28,Ryder System,45,51,4,100,0.040000
2025-09-28,Ryerson Holding,23,70,7,100,0.070000
2025-09-28,S&P Global,22,72,6,100,0.060000
2025-09-28,SBA Communications,40,47,13,100,0.130000
2025-09-28,SS&C Technologies,43,53,4,100,0.040000
2025-09-28,Sabre Corporation,26,60,14,100,0.140000
2025-09-28,Saia Inc,44,50,6,100,0.060000
2025-09-28,Salesforce,9,46,45,100,0.450000
2025-09-28,Sallie Mae,31,59,10,100,0.100000
2025-09-28,Sally Beauty,96,4,0,100,0.000000
2025-09-28,Sanmina,26,70,4,100,0.040000
2025-09-28,ScanSource,38,53,9,100,0.090000
2025-09-28,Schneider National,32,53,15,100,0.150000
2025-09-28,Science Applications International,29,53,18,100,0.180000
2025-09-28,Scotts Miracle-Gro,38,42,20,100,0.200000
2025-09-28,Seaboard,24,54,22,100,0.220000
2025-09-28,Sealed Air Corporation,26,65,9,100,0.090000
2025-09-28,Securian Financial,30,63,7,100,0.070000
2025-09-28,Select Medical Holdings,29,59,12,100,0.120000
2025-09-28,Selective Insurance Group,27,43,30,100,0.300000
2025-09-28,Sempra,38,57,5,100,0.050000
2025-09-28,Sentry Insurance Group,4,6,0,10,0.000000
2025-09-28,Service Corp International,5,14,6,25,0.240000
2025-09-28,ServiceNow,27,58,15,100,0.150000
2025-09-28,Sherwin-Williams,21,62,17,100,0.170000
2025-09-28,Shift4 Payments,24,62,14,100,0.140000
2025-09-28,Silgan,18,50,32,100,0.320000
2025-09-28,Simon Property Group,42,49,9,100,0.090000
2025-09-28,Sinclair,13,53,26,92,0.282609
2025-09-28,Sirius XM,21,73,6,100,0.060000
2025-09-28,SiteOne Landscape Supply,29,58,13,100,0.130000
2025-09-28,Skechers USA,25,64,11,100,0.110000
2025-09-28,SkyWest,15,54,31,100,0.310000
2025-09-28,Skyline Champion,44,12,1,57,0.017544
2025-09-28,Skyworks Solutions,33,58,9,100,0.090000
2025-09-28,Smurfit Westrock,18,66,16,100,0.160000
2025-09-28,Snap Inc,29,40,31,100,0.310000
2025-09-28,Snap-on,18,66,16,100,0.160000
2025-09-28,Snowflake Inc,54,46,0,100,0.000000
2025-09-28,Solventum,31,64,5,100,0.050000
2025-09-28,Sonic Automotive,16,76,8,100,0.080000
2025-09-28,Sonoco Products,22,65,13,100,0.130000
2025-09-28,Southern Company,46,46,8,100,0.080000
2025-09-28,Southwest Airlines,21,50,29,100,0.290000
2025-09-28,Southwest Gas Holdings,40,51,9,100,0.090000
2025-09-28,SpartanNash,21,75,4,100,0.040000
2025-09-28,Spectrum Brands,24,53,23,100,0.230000
2025-09-28,Spire Inc,53,39,8,100,0.080000
2025-09-28,Spirit AeroSystems,37,40,23,100,0.230000
2025-09-28,Spirit Airlines,14,55,23,92,0.250000
2025-09-28,Splunk,39,46,15,100,0.150000
2025-09-28,Sprouts Farmers Market,28,68,4,100,0.040000
2025-09-28,Stagwell,30,58,12,100,0.120000
2025-09-28,Stanley Black & Decker,29,56,15,100,0.150000
2025-09-28,Starbucks,6,73,13,92,0.141304
2025-09-28,State Farm Insurance,20,56,24,100,0.240000
2025-09-28,State Street,33,52,15,100,0.150000
2025-09-28,Steel Dynamics,86,11,3,100,0.030000
2025-09-28,Steelcase,28,69,3,100,0.030000
2025-09-28,Stericycle,10,33,57,100,0.570000
2025-09-28,Stifel Financial,31,63,6,100,0.060000
2025-09-28,StoneX Group,34,63,3,100,0.030000
2025-09-28,Stryker,25,61,14,100,0.140000
2025-09-28,Summit Materials,22,68,10,100,0.100000
2025-09-28,Sun Communities,42,45,13,100,0.130000
2025-09-28,Super Micro Computer,88,8,4,100,0.040000
2025-09-28,Surgery Partners,30,58,12,100,0.120000
2025-09-28,Sylvamo,24,55,21,100,0.210000
2025-09-28,Synchrony Financial,54,44,2,100,0.020000
2025-09-28,Synopsys,26,60,14,100,0.140000
2025-09-28,Synovus Financial,40,53,7,100,0.070000
2025-09-28,Sysco,40,46,14,100,0.140000
2025-09-28,T Rowe Price,46,49,5,100,0.050000
2025-09-28,TD Synnex,35,61,4,100,0.040000
2025-09-28,TEGNA,20,67,13,100,0.130000
2025-09-28,THOR Industries,25,66,9,100,0.090000
2025-09-28,TIAA,25,61,14,100,0.140000
2025-09-28,TJX,58,35,7,100,0.070000
2025-09-28,Take-Two Interactive Software,39,57,4,100,0.040000
2025-09-28,Talen Energy,87,12,1,100,0.010000
2025-09-28,Tapestry,28,59,13,100,0.130000
2025-09-28,Targa Resources,50,39,11,100,0.110000
2025-09-28,Target Corporation,46,46,8,100,0.080000
2025-09-28,Taylor Morrison Home,31,61,8,100,0.080000
2025-09-28,Teladoc Health,39,51,10,100,0.100000
2025-09-28,Teledyne Technologies,33,64,3,100,0.030000
2025-09-28,Teleflex,24,65,11,100,0.110000
2025-09-28,Telephone & Data Systems,6,15,2,23,0.086957
2025-09-28,TelevisaUnivision,30,55,15,100,0.150000
2025-09-28,Tempur Sealy International,30,52,18,100,0.180000
2025-09-28,Tenet Healthcare,34,53,13,100,0.130000
2025-09-28,Teradyne,34,62,4,100,0.040000
2025-09-28,Terex,19,72,9,100,0.090000
2025-09-28,Tesla,20,45,36,101,0.356436
2025-09-28,Tetra Tech,45,43,12,100,0.120000
2025-09-28,Texas Instruments,28,57,15,100,0.150000
2025-09-28,Texas Roadhouse,35,56,9,100,0.090000
2025-09-28,Textron,37,50,13,100,0.130000
2025-09-28,The Andersons Inc,29,67,4,100,0.040000
2025-09-28,The Coca-Cola Company,30,59,11,100,0.110000
2025-09-28,The Greenbrier Companies,24,66,10,100,0.100000
2025-09-28,The Hartford,25,38,37,100,0.370000
2025-09-28,The Mosaic Company,30,53,17,100,0.170000
2025-09-28,Thermo Fisher Scientific,44,49,7,100,0.070000
2025-09-28,Thrivent Financial for Lutherans,31,55,9,95,0.094737
2025-09-28,Timken,25,61,14,100,0.140000
2025-09-28,Titan Machinery,19,66,15,100,0.150000
2025-09-28,Toast Inc,33,56,11,100,0.110000
2025-09-28,Toll Brothers,12,85,3,100,0.030000
2025-09-28,TopBuild,24,76,0,100,0.000000
2025-09-28,Topgolf Callaway Brands,21,58,21,100,0.210000
2025-09-28,Toro Company,25,65,10,100,0.100000
2025-09-28,Tractor Supply,27,65,8,100,0.080000
2025-09-28,TransDigm,41,45,14,100,0.140000
2025-09-28,TransUnion,29,43,28,100,0.280000
2025-09-28,Travelers Insurance,37,40,23,100,0.230000
2025-09-28,TreeHouse Foods,20,49,31,100,0.310000
2025-09-28,Tri Pointe Homes,25,69,6,100,0.060000
2025-09-28,TriNet Group,31,60,9,100,0.090000
2025-09-28,Trimble Inc,37,54,9,100,0.090000
2025-09-28,Trinity Industries,26,53,21,100,0.210000
2025-09-28,TruStage,52,40,8,100,0.080000
2025-09-28,Truist Financial,38,51,11,100,0.110000
2025-09-28,Tutor Perini Corporation,59,36,5,100,0.050000
2025-09-28,Twilio,37,52,11,100,0.110000
2025-09-28,Tyson Foods,24,61,15,100,0.150000
2025-09-28,U-Haul,9,32,59,100,0.590000
2025-09-28,UFP Industries,25,61,14,100,0.140000
2025-09-28,UGI Utilities Inc,26,36,17,79,0.215190
2025-09-28,UL Solutions,44,48,8,100,0.080000
2025-09-28,UPS,25,55,20,100,0.200000
2025-09-28,US Bancorp,32,61,7,100,0.070000
2025-09-28,US Foods,50,44,6,100,0.060000
2025-09-28,USAA,29,51,20,100,0.200000
2025-09-28,Uber,19,60,21,100,0.210000
2025-09-28,Ulta Beauty,83,12,5,100,0.050000
2025-09-28,Under Armour,26,65,9,100,0.090000
2025-09-28,Union Pacific,40,50,10,100,0.100000
2025-09-28,United Airlines,81,14,8,103,0.077670
2025-09-28,United Natural Foods,84,12,4,100,0.040000
2025-09-28,United Rentals,94,5,1,100,0.010000
2025-09-28,United States Steel,53,41,6,100,0.060000
2025-09-28,UnitedHealth,38,45,17,100,0.170000
2025-09-28,Universal Corporation,36,57,7,100,0.070000
2025-09-28,Universal Health Services,33,55,12,100,0.120000
2025-09-28,Unum Group,43,47,10,100,0.100000
2025-09-28,Upbound Group,42,54,4,100,0.040000
2025-09-28,Urban Outfitters,40,54,6,100,0.060000
2025-09-28,V2X,45,44,11,100,0.110000
2025-09-28,VF Corporation,26,52,22,100,0.220000
2025-09-28,VICI Properties,35,57,8,100,0.080000
2025-09-28,Vail Resorts,26,48,26,100,0.260000
2025-09-28,Valero Energy,81,11,8,100,0.080000
2025-09-28,Valley National Bancorp,24,68,8,100,0.080000
2025-09-28,Valmont Industries,32,58,10,100,0.100000
2025-09-28,Valvoline Inc,34,60,6,100,0.060000
2025-09-28,Ventas Inc,46,54,0,100,0.000000
2025-09-28,Verisk Analytics,36,49,15,100,0.150000
2025-09-28,Verizon,48,44,8,100,0.080000
2025-09-28,Vertex Pharmaceuticals,45,35,20,100,0.200000
2025-09-28,Vertiv,45,49,6,100,0.060000
2025-09-28,Viasat,37,55,8,100,0.080000
2025-09-28,Viatris,26,53,21,100,0.210000
2025-09-28,Victorias Secret,26,50,24,100,0.240000
2025-09-28,Visa Inc,64,30,6,100,0.060000
2025-09-28,Vishay Intertechnology,29,56,15,100,0.150000
2025-09-28,Vista Outdoor,21,60,19,100,0.190000
2025-09-28,Visteon,40,53,7,100,0.070000
2025-09-28,Vistra,40,49,11,100,0.110000
2025-09-28,Vontier,37,59,4,100,0.040000
2025-09-28,Voya Financial,35,59,6,100,0.060000
2025-09-28,Vulcan Materials,30,52,18,100,0.180000
2025-09-28,WEC Energy,86,9,5,100,0.050000
2025-09-28,WESCO International,35,57,8,100,0.080000
2025-09-28,WEX,38,57,5,100,0.050000
2025-09-28,WR Berkley,43,46,11,100,0.110000
2025-09-28,WW Grainger,33,52,15,100,0.150000
2025-09-28,Wabash National,21,53,26,100,0.260000
2025-09-28,Walmart,31,44,25,100,0.250000
2025-09-28,Walt Disney,47,45,8,100,0.080000
2025-09-28,Warner Bros Discovery,16,66,18,100,0.180000
2025-09-28,Warner Music Group,28,58,14,100,0.140000
2025-09-28,Waters Corporation,44,47,9,100,0.090000
2025-09-28,Watsco,30,47,23,100,0.230000
2025-09-28,Wayfair,33,63,4,100,0.040000
2025-09-28,Webster Financial,32,56,12,100,0.120000
2025-09-28,Weis Markets,24,59,17,100,0.170000
2025-09-28,Wells Fargo,81,9,10,100,0.100000
2025-09-28,Welltower,59,40,1,100,0.010000
2025-09-28,Werner Enterprises,33,46,21,100,0.210000
2025-09-28,West Pharmaceutical Services,39,46,15,100,0.150000
2025-09-28,Western & Southern Financial,29,66,5,100,0.050000
2025-09-28,Western Alliance Bancorp,20,46,26,92,0.282609
2025-09-28,Western Digital,29,60,11,100,0.110000
2025-09-28,Western Midstream Partners,35,57,8,100,0.080000
2025-09-28,Western Union,24,64,12,100,0.120000
2025-09-28,Westinghouse Air Brake Technologies,27,57,16,100,0.160000
2025-09-28,Weyerhaeuser,30,59,11,100,0.110000
2025-09-28,Whirlpool,25,55,20,100,0.200000
2025-09-28,Williams Companies,48,46,6,100,0.060000
2025-09-28,Williams-Sonoma,27,65,8,100,0.080000
2025-09-28,Winnebago Industries,19,67,14,100,0.140000
2025-09-28,Wintrust Financial,33,67,0,100,0.000000
2025-09-28,Woodward Inc,32,67,1,100,0.010000
2025-09-28,Workday,24,61,15,100,0.150000
2025-09-28,World Kinect,34,55,11,100,0.110000
2025-09-28,Worthington Enterprises,33,62,5,100,0.050000
2025-09-28,Wynn Resorts,22,58,20,100,0.200000
2025-09-28,XPO,22,64,14,100,0.140000
2025-09-28,Xcel Energy,54,21,25,100,0.250000
2025-09-28,Xerox,22,63,15,100,0.150000
2025-09-28,Xylem Inc,46,48,6,100,0.060000
2025-09-28,Yum Brands,28,58,14,100,0.140000
2025-09-28,Yum China,36,49,15,100,0.150000
2025-09-28,Zebra Technologies,40,49,11,100,0.110000
2025-09-28,Zimmer Biomet,41,56,3,100,0.030000
2025-09-28,Zions Bancorp,36,48,16,100,0.160000
2025-09-28,Zoetis,46,46,8,100,0.080000
2025-09-28,Zoom Video Communications,31,53,16,100,0.160000
2025-09-28,eXp World,30,61,9,100,0.090000
2025-09-28,iHeartMedia,26,65,9,100,0.090000
2025-09-29,3M Company,39,51,10,100,0.100000
2025-09-29,A O Smith,26,73,1,100,0.010000
2025-09-29,A-Mark Precious Metals,88,12,0,100,0.000000
2025-09-29,ABM Industries,24,56,20,100,0.200000
2025-09-29,ADT,37,43,20,100,0.200000
2025-09-29,AECOM,47,44,9,100,0.090000
2025-09-29,AES,39,45,16,100,0.160000
2025-09-29,AGCO,34,58,8,100,0.080000
2025-09-29,AGNC Investment,30,48,22,100,0.220000
2025-09-29,AIG,27,58,15,100,0.150000
2025-09-29,AMC Entertainment,82,13,5,100,0.050000
2025-09-29,AMC Networks,29,52,19,100,0.190000
2025-09-29,AMN Healthcare Services,19,59,22,100,0.220000
2025-09-29,APA,36,47,17,100,0.170000
2025-09-29,APi Group,36,53,11,100,0.110000
2025-09-29,ARKO,25,66,9,100,0.090000
2025-09-29,ASGN,29,56,15,100,0.150000
2025-09-29,AT&T,28,60,12,100,0.120000
2025-09-29,ATI Inc,33,62,5,100,0.050000
2025-09-29,AbbVie,47,43,10,100,0.100000
2025-09-29,Abbott Laboratories,55,35,10,100,0.100000
2025-09-29,Abercrombie & Fitch,32,58,10,100,0.100000
2025-09-29,Academy Sports and Outdoors,32,58,10,100,0.100000
2025-09-29,Acadia Healthcare,18,62,20,100,0.200000
2025-09-29,Ace Hardware,27,59,14,100,0.140000
2025-09-29,Acuity Inc,46,42,10,98,0.102041
2025-09-29,Adams Resources & Energy,21,5,1,27,0.037037
2025-09-29,AdaptHealth,35,52,13,100,0.130000
2025-09-29,Adobe,46,45,9,100,0.090000
2025-09-29,Advance Auto Parts,25,53,22,100,0.220000
2025-09-29,Advanced Drainage Systems,82,12,6,100,0.060000
2025-09-29,Advanced Micro Devices,81,4,15,100,0.150000
2025-09-29,Advantage Solutions,78,15,7,100,0.070000
2025-09-29,Aflac,38,34,28,100,0.280000
2025-09-29,Agilent Technologies,42,51,7,100,0.070000
2025-09-29,Agilon Health,26,53,21,100,0.210000
2025-09-29,Air Lease,26,65,9,100,0.090000
2025-09-29,Air Products & Chemicals,25,65,10,100,0.100000
2025-09-29,Airbnb,30,52,18,100,0.180000
2025-09-29,Akamai Technologies,44,47,9,100,0.090000
2025-09-29,Alaska Air,33,60,7,100,0.070000
2025-09-29,Albemarle Corporation,31,58,11,100,0.110000
2025-09-29,Albertsons,33,54,13,100,0.130000
2025-09-29,Alcoa Corporation,24,59,17,100,0.170000
2025-09-29,Alexandria Real Estate Equities,43,51,6,100,0.060000
2025-09-29,Alight Solutions,29,62,9,100,0.090000
2025-09-29,Align Technology,15,57,28,100,0.280000
2025-09-29,Allegiant Travel Company,21,73,6,100,0.060000
2025-09-29,Alliance Resource Partners,32,52,16,100,0.160000
2025-09-29,Alliant Energy,77,19,4,100,0.040000
2025-09-29,Allison Transmission,30,56,14,100,0.140000
2025-09-29,Allstate,63,28,9,100,0.090000
2025-09-29,Ally Financial,38,56,6,100,0.060000
2025-09-29,Alpha Metallurgical Resources,36,47,17,100,0.170000
2025-09-29,Alphabet,55,33,12,100,0.120000
2025-09-29,Altice USA,30,54,16,100,0.160000
2025-09-29,Altria,48,41,11,100,0.110000
2025-09-29,Amazon,31,51,17,99,0.171717
2025-09-29,Ameren,35,48,17,100,0.170000
2025-09-29,American Airlines,22,20,50,92,0.543478
2025-09-29,American Axle & Manufacturing,28,59,13,100,0.130000
2025-09-29,American Eagle Outfitters,35,50,15,100,0.150000
2025-09-29,American Electric Power,48,41,11,100,0.110000
2025-09-29,American Express,48,46,6,100,0.060000
2025-09-29,American Family Insurance,48,41,11,100,0.110000
2025-09-29,American Financial Group,30,59,11,100,0.110000
2025-09-29,American Tower,47,43,10,100,0.100000
2025-09-29,American Water Works,38,56,6,100,0.060000
2025-09-29,Americold Realty Trust,76,18,6,100,0.060000
2025-09-29,Ameriprise Financial,47,44,9,100,0.090000
2025-09-29,Ametek,34,61,5,100,0.050000
2025-09-29,Amgen,27,56,17,100,0.170000
2025-09-29,Amica Mutual Insurance,24,66,6,96,0.062500
2025-09-29,Amkor Technology,38,54,8,100,0.080000
2025-09-29,Amphenol,46,50,4,100,0.040000
2025-09-29,Analog Devices,40,55,5,100,0.050000
2025-09-29,Antero Resources,38,51,11,100,0.110000
2025-09-29,Anywhere Real Estate Inc,38,57,5,100,0.050000
2025-09-29,Apollo Global Management,33,62,5,100,0.050000
2025-09-29,AppLovin,39,54,7,100,0.070000
2025-09-29,Apple,29,60,14,103,0.135922
2025-09-29,Applied Industrial Technologies,30,66,4,100,0.040000
2025-09-29,Applied Materials,21,55,24,100,0.240000
2025-09-29,AptarGroup,30,63,7,100,0.070000
2025-09-29,Aramark,45,46,9,100,0.090000
2025-09-29,ArcBest,26,64,10,100,0.100000
2025-09-29,Arch Resources,62,25,13,100,0.130000
2025-09-29,Archer Daniels Midland,40,47,13,100,0.130000
2025-09-29,Ares Management,35,63,2,100,0.020000
2025-09-29,Arista Networks,32,58,10,100,0.100000
2025-09-29,Arrow Electronics,24,67,9,100,0.090000
2025-09-29,Arthur J Gallagher,36,59,5,100,0.050000
2025-09-29,Asbury Automotive Group,32,58,10,100,0.100000
2025-09-29,Assurant,38,50,12,100,0.120000
2025-09-29,Atkore,22,64,14,100,0.140000
2025-09-29,Atlassian,25,53,22,100,0.220000
2025-09-29,Atmos Energy,88,9,3,100,0.030000
2025-09-29,Auto-Owners Insurance,33,57,10,100,0.100000
2025-09-29,AutoNation,29,59,12,100,0.120000
2025-09-29,AutoZone,23,58,19,100,0.190000
2025-09-29,Autodesk,31,66,3,100,0.030000
2025-09-29,Autoliv,43,51,6,100,0.060000
2025-09-29,Automatic Data Processing,61,33,6,100,0.060000
2025-09-29,AvalonBay Communities,34,61,5,100,0.050000
2025-09-29,Avantor,31,51,18,100,0.180000
2025-09-29,Avery Dennison,29,64,7,100,0.070000
2025-09-29,Avient,29,61,10,100,0.100000
2025-09-29,Avis Budget,23,59,18,100,0.180000
2025-09-29,Avnet,21,71,8,100,0.080000
2025-09-29,BJ's Wholesale Club,32,54,14,100,0.140000
2025-09-29,BOK Financial,40,50,10,100,0.100000
2025-09-29,BWX Technologies,52,44,4,100,0.040000
2025-09-29,Baker Hughes,39,53,8,100,0.080000
2025-09-29,Ball Corporation,35,59,6,100,0.060000
2025-09-29,Bank of America,37,54,9,100,0.090000
2025-09-29,Bank of New York Mellon,51,46,3,100,0.030000
2025-09-29,Bath & Body Works,32,57,11,100,0.110000
2025-09-29,Baxter International,26,57,17,100,0.170000
2025-09-29,Becton Dickinson,52,39,9,100,0.090000
2025-09-29,Belden,32,56,12,100,0.120000
2025-09-29,Benchmark Electronics,20,72,8,100,0.080000
2025-09-29,Berkshire Hathaway,28,48,24,100,0.240000
2025-09-29,Berry Global,24,62,14,100,0.140000
2025-09-29,Best Buy,94,5,1,100,0.010000
2025-09-29,Bio-Rad Laboratories,25,64,11,100,0.110000
2025-09-29,Biogen,30,61,9,100,0.090000
2025-09-29,BlackRock,33,54,13,100,0.130000
2025-09-29,Blackstone,35,52,13,100,0.130000
2025-09-29,Bloomin Brands,13,68,19,100,0.190000
2025-09-29,BlueLinx,25,66,9,100,0.090000
2025-09-29,Boeing,32,57,10,99,0.101010
2025-09-29,Boise Cascade,15,47,38,100,0.380000
2025-09-29,Booking Holdings,54,41,5,100,0.050000
2025-09-29,Booz Allen Hamilton,28,54,18,100,0.180000
2025-09-29,BorgWarner,57,37,6,100,0.060000
2025-09-29,Boston Properties,19,74,7,100,0.070000
2025-09-29,Boston Scientific,45,45,10,100,0.100000
2025-09-29,Boyd Gaming,23,51,26,100,0.260000
2025-09-29,Bread Financial,44,53,3,100,0.030000
2025-09-29,BrightSpring Health Services,30,60,10,100,0.100000
2025-09-29,BrightView Holdings,22,68,10,100,0.100000
2025-09-29,Brighthouse Financial,29,62,9,100,0.090000
2025-09-29,Brinker International,44,51,5,100,0.050000
2025-09-29,Brinks Company,10,2,6,18,0.333333
2025-09-29,Bristol-Myers Squibb,30,49,21,100,0.210000
2025-09-29,Broadcom,40,53,7,100,0.070000
2025-09-29,Broadridge Financial Solutions,63,35,2,100,0.020000
2025-09-29,Brookdale Senior Living,32,52,16,100,0.160000
2025-09-29,Brown & Brown,28,54,18,100,0.180000
2025-09-29,Brown-Forman,17,62,21,100,0.210000
2025-09-29,Bruker,19,54,27,100,0.270000
2025-09-29,Brunswick Corporation,41,45,14,100,0.140000
2025-09-29,Builders FirstSource,36,54,10,100,0.100000
2025-09-29,Burlington Stores,27,68,5,100,0.050000
2025-09-29,CACI International,50,43,7,100,0.070000
2025-09-29,CBRE Group,39,60,1,100,0.010000
2025-09-29,CDW,38,56,6,100,0.060000
2025-09-29,CF Industries,35,59,6,100,0.060000
2025-09-29,CH Robinson Worldwide,38,51,11,100,0.110000
2025-09-29,CHS,43,47,10,100,0.100000
2025-09-29,CIncinnati Financial,36,54,10,100,0.100000
2025-09-29,CME Group,27,67,6,100,0.060000
2025-09-29,CMS Energy,91,7,2,100,0.020000
2025-09-29,CNO Financial Group,31,64,5,100,0.050000
2025-09-29,CNX Resources,43,51,6,100,0.060000
2025-09-29,CSX,35,51,14,100,0.140000
2025-09-29,CVS Health,44,44,12,100,0.120000
2025-09-29,Cabot Corporation,32,63,5,100,0.050000
2025-09-29,Cadence,21,58,21,100,0.210000
2025-09-29,Caesars Entertainment,76,20,4,100,0.040000
2025-09-29,Cal-Maine Foods,52,44,4,100,0.040000
2025-09-29,Caleres Inc,31,55,14,100,0.140000
2025-09-29,California Resources,41,49,10,100,0.100000
2025-09-29,Calumet Inc,31,42,16,89,0.179775
2025-09-29,Campbell Soup,31,52,17,100,0.170000
2025-09-29,Camping World,26,60,14,100,0.140000
2025-09-29,Capital One,33,50,17,100,0.170000
2025-09-29,CarMax,13,40,47,100,0.470000
2025-09-29,Cardinal Health,29,57,14,100,0.140000
2025-09-29,Carlisle Companies,31,55,14,100,0.140000
2025-09-29,Carlyle Group,34,57,9,100,0.090000
2025-09-29,Carpenter Technology,31,63,6,100,0.060000
2025-09-29,Carrier Global,40,44,16,100,0.160000
2025-09-29,Carters Inc,15,25,2,42,0.047619
2025-09-29,Carvana,34,55,11,100,0.110000
2025-09-29,Caseys General Stores,32,59,9,100,0.090000
2025-09-29,Catalent,21,66,13,100,0.130000
2025-09-29,Caterpillar,26,66,8,100,0.080000
2025-09-29,Cboe Global Markets,28,67,5,100,0.050000
2025-09-29,Celanese,25,44,31,100,0.310000
2025-09-29,Cencora,54,40,6,100,0.060000
2025-09-29,Centene,31,35,34,100,0.340000
2025-09-29,CenterPoint Energy,77,13,10,100,0.100000
2025-09-29,Central Garden & Pet,20,75,5,100,0.050000
2025-09-29,Century Communities,34,58,8,100,0.080000
2025-09-29,ChampionX,39,59,2,100,0.020000
2025-09-29,Charles River Laboratories International,21,65,14,100,0.140000
2025-09-29,Charles Schwab,50,46,4,100,0.040000
2025-09-29,Chart Industries,35,56,9,100,0.090000
2025-09-29,Charter Communications,25,50,25,100,0.250000
2025-09-29,Cheesecake Factory,25,55,20,100,0.200000
2025-09-29,Chefs Warehouse,39,53,8,100,0.080000
2025-09-29,Chemours,33,46,21,100,0.210000
2025-09-29,Cheniere Energy,89,10,1,100,0.010000
2025-09-29,Chevron,36,42,22,100,0.220000
2025-09-29,Chewy,36,42,22,100,0.220000
2025-09-29,Chipotle Mexican Grill,23,64,13,100,0.130000
2025-09-29,Chord Energy,92,4,4,100,0.040000
2025-09-29,Church & Dwight,32,57,11,100,0.110000
2025-09-29,Ciena,43,52,5,100,0.050000
2025-09-29,Cigna,40,46,14,100,0.140000
2025-09-29,Cinemark,28,56,16,100,0.160000
2025-09-29,Cintas,36,54,10,100,0.100000
2025-09-29,Cisco Systems,36,50,14,100,0.140000
2025-09-29,Citigroup,36,52,12,100,0.120000
2025-09-29,Citizens Financial Group,38,57,5,100,0.050000
2025-09-29,Civitas Resources,28,39,33,100,0.330000
2025-09-29,Clean Harbors,74,13,13,100,0.130000
2025-09-29,Clear Channel Outdoor Hldgs,8,2,0,10,0.000000
2025-09-29,Cleveland-Cliffs,23,52,25,100,0.250000
2025-09-29,Clorox,32,47,21,100,0.210000
2025-09-29,Cognizant Technology Solutions,43,48,9,100,0.090000
2025-09-29,Coherent,26,66,8,100,0.080000
2025-09-29,Coinbase Global,21,64,15,100,0.150000
2025-09-29,Colgate-Palmolive,41,44,15,100,0.150000
2025-09-29,Columbia Banking System,38,58,4,100,0.040000
2025-09-29,Columbia Sportswear,28,49,23,100,0.230000
2025-09-29,Comcast,38,40,22,100,0.220000
2025-09-29,Comerica,45,43,12,100,0.120000
2025-09-29,Comfort Systems USA,96,3,1,100,0.010000
2025-09-29,CommScope,22,75,3,100,0.030000
2025-09-29,Commercial Metals,30,56,14,100,0.140000
2025-09-29,Community Health Systems,25,54,21,100,0.210000
2025-09-29,Compass Group,31,50,19,100,0.190000
2025-09-29,Conagra Brands,28,54,18,100,0.180000
2025-09-29,Concentrix,22,56,22,100,0.220000
2025-09-29,Conduent,29,51,20,100,0.200000
2025-09-29,ConocoPhillips,42,43,15,100,0.150000
2025-09-29,Consol Energy,78,17,5,100,0.050000
2025-09-29,Consolidated Edison,32,54,14,100,0.140000
2025-09-29,Constellation Brands,17,42,41,100,0.410000
2025-09-29,Constellation Energy,83,11,6,100,0.060000
2025-09-29,Continental Resources,38,48,14,100,0.140000
2025-09-29,Cooper Cos,3,21,4,28,0.142857
2025-09-29,Cooper-Standard,29,63,8,100,0.080000
2025-09-29,Copart,44,42,14,100,0.140000
2025-09-29,Core & Main,23,57,20,100,0.200000
2025-09-29,Corebridge Financial,37,55,8,100,0.080000
2025-09-29,Cornerstone Building Brands,25,65,10,100,0.100000
2025-09-29,Corning,36,52,12,100,0.120000
2025-09-29,Corpay,27,71,2,100,0.020000
2025-09-29,Corteva,29,61,10,100,0.100000
2025-09-29,Costco,31,48,23,102,0.225490
2025-09-29,Coterra Energy,78,14,8,100,0.080000
2025-09-29,Coty,26,50,24,100,0.240000
2025-09-29,Country Financial,26,56,18,100,0.180000
2025-09-29,Coupang,38,51,11,100,0.110000
2025-09-29,Cracker Barrel Old Country Store,15,62,23,100,0.230000
2025-09-29,Crocs,32,58,10,100,0.100000
2025-09-29,CrossAmerica Partners,24,72,4,100,0.040000
2025-09-29,CrowdStrike,31,46,23,100,0.230000
2025-09-29,Crown Castle,37,56,7,100,0.070000
2025-09-29,Crown Holdings,31,62,7,100,0.070000
2025-09-29,Cullen Frost Bankers,44,50,6,100,0.060000
2025-09-29,Cummins Inc,59,37,4,100,0.040000
2025-09-29,Curtiss-Wright,48,49,3,100,0.030000
2025-09-29,DR Horton,27,63,10,100,0.100000
2025-09-29,DTE Energy,69,16,15,100,0.150000
2025-09-29,DXC Technology,29,68,3,100,0.030000
2025-09-29,DaVita,32,45,23,100,0.230000
2025-09-29,Dana Incorporated,34,57,9,100,0.090000
2025-09-29,Danaher,44,46,10,100,0.100000
2025-09-29,Darden Restaurants,37,43,20,100,0.200000
2025-09-29,Darling Ingredients,88,9,3,100,0.030000
2025-09-29,Deckers Outdoor,37,49,14,100,0.140000
2025-09-29,Deere,28,54,18,100,0.180000
2025-09-29,Delek US,42,48,10,100,0.100000
2025-09-29,Dell Technologies,35,60,5,100,0.050000
2025-09-29,Delta Air Lines,20,58,24,102,0.235294
2025-09-29,Dentsply Sirona,26,69,5,100,0.050000
2025-09-29,Designer Brands,21,62,17,100,0.170000
2025-09-29,Devon Energy,93,3,4,100,0.040000
2025-09-29,DexCom,21,65,14,100,0.140000
2025-09-29,Diamondback Energy,85,8,7,100,0.070000
2025-09-29,Dicks Sporting Goods,26,68,6,100,0.060000
2025-09-29,Diebold Nixdorf,32,65,3,100,0.030000
2025-09-29,Digital Realty Trust,80,20,0,100,0.000000
2025-09-29,Dillards,26,56,18,100,0.180000
2025-09-29,Discover Financial,33,53,14,100,0.140000
2025-09-29,DocuSign,37,45,18,100,0.180000
2025-09-29,Dollar General,22,55,23,100,0.230000
2025-09-29,Dollar Tree,37,45,18,100,0.180000
2025-09-29,Dominion Energy,68,23,9,100,0.090000
2025-09-29,Dominos Pizza Inc,17,22,7,46,0.152174
2025-09-29,Domtar,23,65,12,100,0.120000
2025-09-29,Donaldson Company,41,52,7,100,0.070000
2025-09-29,DoorDash,36,41,23,100,0.230000
2025-09-29,Dover Corporation,48,52,0,100,0.000000
2025-09-29,DraftKings,60,34,6,100,0.060000
2025-09-29,Dream Finders Homes,83,13,4,100,0.040000
2025-09-29,Dropbox,31,63,6,100,0.060000
2025-09-29,DuPont,32,57,11,100,0.110000
2025-09-29,Duke Energy,78,10,12,100,0.120000
2025-09-29,Dycom Industries,34,61,5,100,0.050000
2025-09-29,EMCOR Group,32,61,7,100,0.070000
2025-09-29,EOG Resources,43,47,10,100,0.100000
2025-09-29,EPAM Systems,35,55,10,100,0.100000
2025-09-29,EQT,33,59,8,100,0.080000
2025-09-29,ESAB,33,53,14,100,0.140000
2025-09-29,East West Bancorp,40,55,5,100,0.050000
2025-09-29,Eastman Chemical,23,46,31,100,0.310000
2025-09-29,Ebay,33,59,8,100,0.080000
2025-09-29,EchoStar,17,69,14,100,0.140000
2025-09-29,Ecolab,49,46,5,100,0.050000
2025-09-29,Edison International,21,55,24,100,0.240000
2025-09-29,Edward Jones,27,61,12,100,0.120000
2025-09-29,Edwards Lifesciences,48,32,20,100,0.200000
2025-09-29,Elanco Animal Health,35,59,6,100,0.060000
2025-09-29,Electronic Arts,18,70,4,92,0.043478
2025-09-29,Elevance Health,40,39,21,100,0.210000
2025-09-29,Eli Lilly,25,51,24,100,0.240000
2025-09-29,Emerson Electric,47,44,9,100,0.090000
2025-09-29,EnLink Midstream,40,54,6,100,0.060000
2025-09-29,Encompass Health,29,63,8,100,0.080000
2025-09-29,Endeavor Group,17,72,11,100,0.110000
2025-09-29,Endeavor Group Holdings,19,71,10,100,0.100000
2025-09-29,EnerSys,36,54,10,100,0.100000
2025-09-29,Energizer Holdings,88,9,3,100,0.030000
2025-09-29,Energy Transfer,86,6,8,100,0.080000
2025-09-29,Ensign Group,40,54,6,100,0.060000
2025-09-29,Entegris,46,38,16,100,0.160000
2025-09-29,Entergy,44,49,7,100,0.070000
2025-09-29,Enterprise Products Partners,42,38,20,100,0.200000
2025-09-29,Envista,23,64,13,100,0.130000
2025-09-29,Equifax,43,40,17,100,0.170000
2025-09-29,Equinix,44,51,5,100,0.050000
2025-09-29,Equitable Holdings,37,46,17,100,0.170000
2025-09-29,Equity Residential,32,59,9,100,0.090000
2025-09-29,Erie Insurance,28,55,17,100,0.170000
2025-09-29,Estée Lauder,26,58,16,100,0.160000
2025-09-29,Etsy,25,48,27,100,0.270000
2025-09-29,Euronet Worldwide,28,63,9,100,0.090000
2025-09-29,Evergy,53,39,8,100,0.080000
2025-09-29,Eversource Energy,71,15,14,100,0.140000
2025-09-29,Exact Sciences,29,44,27,100,0.270000
2025-09-29,Exelon,41,51,8,100,0.080000
2025-09-29,Expand Energy Corporation,96,2,2,100,0.020000
2025-09-29,Expedia,39,49,12,100,0.120000
2025-09-29,Expeditors International of Washington,40,55,5,100,0.050000
2025-09-29,Extra Space Storage,24,62,14,100,0.140000
2025-09-29,Exxon Mobil,48,45,7,100,0.070000
2025-09-29,F5,41,49,10,100,0.100000
2025-09-29,FM Global,33,42,25,100,0.250000
2025-09-29,FMC Corporation,40,45,15,100,0.150000
2025-09-29,FTI Consulting,33,54,13,100,0.130000
2025-09-29,Fannie Mae,16,64,20,100,0.200000
2025-09-29,Farmers Insurance Exchange,20,51,29,100,0.290000
2025-09-29,Fastenal,65,33,2,100,0.020000
2025-09-29,FedEx,44,43,13,100,0.130000
2025-09-29,Federated Mutual Insurance,16,20,4,40,0.100000
2025-09-29,Ferguson Enterprises,34,59,7,100,0.070000
2025-09-29,Fidelity National Financial,38,50,12,100,0.120000
2025-09-29,Fidelity National Information Services,44,40,16,100,0.160000
2025-09-29,Fifth Third Bancorp,47,45,8,100,0.080000
2025-09-29,First American Financial,27,55,18,100,0.180000
2025-09-29,First Citizens BancShares,42,51,7,100,0.070000
2025-09-29,First Horizon,40,59,1,100,0.010000
2025-09-29,First National of Nebraska,14,38,2,54,0.037037
2025-09-29,First Solar,35,58,7,100,0.070000
2025-09-29,FirstCash,30,54,16,100,0.160000
2025-09-29,FirstEnergy,44,36,20,100,0.200000
2025-09-29,Fiserv,36,51,13,100,0.130000
2025-09-29,Five Below,30,61,9,100,0.090000
2025-09-29,Flagstar Financial,31,54,15,100,0.150000
2025-09-29,Floor & Decor,36,55,9,100,0.090000
2025-09-29,Flowers Foods,19,55,26,100,0.260000
2025-09-29,Flowserve,26,69,5,100,0.050000
2025-09-29,Fluor,37,41,22,100,0.220000
2025-09-29,Foot Locker,12,71,17,100,0.170000
2025-09-29,Ford Motor,32,57,11,100,0.110000
2025-09-29,Fortinet,30,35,35,100,0.350000
2025-09-29,Fortive,26,57,17,100,0.170000
2025-09-29,Fortune Brands Innovations,27,63,10,100,0.100000
2025-09-29,Franklin Resources,38,51,11,100,0.110000
2025-09-29,Freddie Mac,20,68,12,100,0.120000
2025-09-29,Freeport-McMoRan,15,50,35,100,0.350000
2025-09-29,Frontier Airlines,26,54,20,100,0.200000
2025-09-29,Frontier Communications,40,51,9,100,0.090000
2025-09-29,G-III Apparel Group,33,53,14,100,0.140000
2025-09-29,GE HealthCare Technologies,34,59,7,100,0.070000
2025-09-29,GE Vernova,51,42,7,100,0.070000
2025-09-29,GMS,21,71,8,100,0.080000
2025-09-29,GXO Logistics,32,58,10,100,0.100000
2025-09-29,GameStop,23,54,23,100,0.230000
2025-09-29,Gannett,27,57,16,100,0.160000
2025-09-29,Garrett Motion Inc,33,62,5,100,0.050000
2025-09-29,Gartner,22,68,10,100,0.100000
2025-09-29,Gen Digital,44,49,7,100,0.070000
2025-09-29,Generac,30,53,17,100,0.170000
2025-09-29,General Dynamics,89,6,5,100,0.050000
2025-09-29,General Mills,38,49,13,100,0.130000
2025-09-29,General Motors,35,55,10,100,0.100000
2025-09-29,Genesis Energy,80,17,3,100,0.030000
2025-09-29,Genuine Parts,37,61,2,100,0.020000
2025-09-29,Genworth Financial,46,47,7,100,0.070000
2025-09-29,Gilead Sciences,35,56,9,100,0.090000
2025-09-29,Global Partners,38,45,17,100,0.170000
2025-09-29,Global Payments,39,55,6,100,0.060000
2025-09-29,Globe Life,37,52,11,100,0.110000
2025-09-29,GoDaddy,38,54,8,100,0.080000
2025-09-29,Goldman Sachs,32,53,17,102,0.166667
2025-09-29,Goodyear Tire & Rubber,23,65,12,100,0.120000
2025-09-29,Graham Holdings Company,28,66,6,100,0.060000
2025-09-29,Granite Construction,43,53,4,100,0.040000
2025-09-29,Graphic Packaging,17,66,17,100,0.170000
2025-09-29,Gray Television,28,55,17,100,0.170000
2025-09-29,Graybar Electric,13,29,6,48,0.125000
2025-09-29,Green Plains Inc,31,54,15,100,0.150000
2025-09-29,Greif,22,73,5,100,0.050000
2025-09-29,Griffon Corporation,36,57,7,100,0.070000
2025-09-29,Grocery Outlet Holding,30,61,9,100,0.090000
2025-09-29,Group 1 Automotive,24,68,8,100,0.080000
2025-09-29,Guardian Life insurance,52,46,2,100,0.020000
2025-09-29,Guess Inc,30,62,8,100,0.080000
2025-09-29,GuideWell Mutual,20,25,0,45,0.000000
2025-09-29,HB Fuller,24,69,7,100,0.070000
2025-09-29,HCA Healthcare,50,43,7,100,0.070000
2025-09-29,HEICO,35,53,12,100,0.120000
2025-09-29,HF SInclair,28,58,14,100,0.140000
2025-09-29,HP,29,57,14,100,0.140000
2025-09-29,Halliburton,22,51,27,100,0.270000
2025-09-29,Hanesbrands,21,72,7,100,0.070000
2025-09-29,Hanover Insurance Group,39,48,13,100,0.130000
2025-09-29,Harley-Davidson,19,62,19,100,0.190000
2025-09-29,Hasbro,31,49,20,100,0.200000
2025-09-29,Hawaiian Airlines Inc,34,63,3,100,0.030000
2025-09-29,Hawaiian Electric Industries,31,57,12,100,0.120000
2025-09-29,Helmerich & Payne,20,63,17,100,0.170000
2025-09-29,Henry Schein,30,62,8,100,0.080000
2025-09-29,Herc Rentals,32,54,14,100,0.140000
2025-09-29,Hershey,37,51,12,100,0.120000
2025-09-29,Hertz,19,58,23,100,0.230000
2025-09-29,Hewlett Packard Enterprise,20,76,4,100,0.040000
2025-09-29,Hillenbrand,23,69,8,100,0.080000
2025-09-29,Hilton Grand Vacations,89,10,1,100,0.010000
2025-09-29,Hilton Worldwide,44,50,6,100,0.060000
2025-09-29,Hologic,26,63,11,100,0.110000
2025-09-29,Home Depot,40,38,22,100,0.220000
2025-09-29,Honeywell,54,35,11,100,0.110000
2025-09-29,Hormel Foods,30,61,9,100,0.090000
2025-09-29,Host Hotels & Resorts,21,70,9,100,0.090000
2025-09-29,Hovnanian Enterprises,34,51,15,100,0.150000
2025-09-29,Howmet Aerospace,35,58,7,100,0.070000
2025-09-29,Hub Group,19,60,21,100,0.210000
2025-09-29,Hubbell,25,64,11,100,0.110000
2025-09-29,Humana,57,29,14,100,0.140000
2025-09-29,Huntington Bancshares,34,61,5,100,0.050000
2025-09-29,Huntington Ingalls Industries,33,49,18,100,0.180000
2025-09-29,Huntsman,14,57,29,100,0.290000
2025-09-29,Hyatt Hotels,36,57,7,100,0.070000
2025-09-29,Hyster-Yale,26,66,8,100,0.080000
2025-09-29,IAC,32,55,13,100,0.130000
2025-09-29,IBM,32,58,10,100,0.100000
2025-09-29,IDEX,34,56,10,100,0.100000
2025-09-29,IDEXX Laboratories,58,35,7,100,0.070000
2025-09-29,IQVIA,51,40,9,100,0.090000
2025-09-29,ITT,42,50,8,100,0.080000
2025-09-29,Icahn Enterprises,27,52,21,100,0.210000
2025-09-29,Illinois Tool Works,46,49,5,100,0.050000
2025-09-29,Illumina Inc,22,68,10,100,0.100000
2025-09-29,Incyte,43,53,4,100,0.040000
2025-09-29,Ingersoll Rand,33,57,10,100,0.100000
2025-09-29,Ingles Markets,23,52,25,100,0.250000
2025-09-29,Ingram Micro,17,47,36,100,0.360000
2025-09-29,Ingredion,50,41,9,100,0.090000
2025-09-29,Insight Enterprises,30,54,16,100,0.160000
2025-09-29,Insperity,38,46,16,100,0.160000
2025-09-29,Instacart,30,60,10,100,0.100000
2025-09-29,Installed Building Products,21,66,13,100,0.130000
2025-09-29,Intel,22,56,21,99,0.212121
2025-09-29,Interactive Brokers,39,51,10,100,0.100000
2025-09-29,Intercontinental Exchange,42,56,2,100,0.020000
2025-09-29,International Flavors & Fragrances,33,51,16,100,0.160000
2025-09-29,International Paper,18,71,11,100,0.110000
2025-09-29,Interpublic Group,32,60,8,100,0.080000
2025-09-29,Intuit,42,50,8,100,0.080000
2025-09-29,Intuitive Surgical,33,49,18,100,0.180000
2025-09-29,Iron Mountain,25,55,20,100,0.200000
2025-09-29,JB Hunt Transport Services,26,60,14,100,0.140000
2025-09-29,JELD-WEN Holding,20,70,10,100,0.100000
2025-09-29,JM Smucker,31,54,15,100,0.150000
2025-09-29,JPMorgan Chase,45,43,12,100,0.120000
2025-09-29,Jabil,27,61,12,100,0.120000
2025-09-29,Jackson Financial,31,61,8,100,0.080000
2025-09-29,Jacobs Solutions,50,45,5,100,0.050000
2025-09-29,Jefferies Financial,27,61,12,100,0.120000
2025-09-29,JetBlue Airways,33,47,20,100,0.200000
2025-09-29,Johnson & Johnson,41,49,10,100,0.100000
2025-09-29,Jones Lang LaSalle,45,53,2,100,0.020000
2025-09-29,Juniper Networks,28,63,9,100,0.090000
2025-09-29,KB Home,26,63,11,100,0.110000
2025-09-29,KBR,49,39,12,100,0.120000
2025-09-29,KKR & Co,56,39,5,100,0.050000
2025-09-29,KLA,28,53,19,100,0.190000
2025-09-29,Kaiser Aluminum,28,59,13,100,0.130000
2025-09-29,Kellanova,28,55,17,100,0.170000
2025-09-29,Kelly Services Inc,32,59,9,100,0.090000
2025-09-29,Kemper Corporation,30,59,11,100,0.110000
2025-09-29,Kenvue,14,53,33,100,0.330000
2025-09-29,Keurig Dr Pepper,14,70,16,100,0.160000
2025-09-29,KeyCorp,40,52,8,100,0.080000
2025-09-29,Keysight Technologies,41,54,5,100,0.050000
2025-09-29,Kimberly-Clark,40,48,12,100,0.120000
2025-09-29,Kinder Morgan,94,3,3,100,0.030000
2025-09-29,Kirby Corporation,26,58,9,93,0.096774
2025-09-29,Knife River Corporation,23,52,8,83,0.096386
2025-09-29,Knight Swift Transportation,26,56,18,100,0.180000
2025-09-29,Kohl's,34,46,20,100,0.200000
2025-09-29,Kontoor Brands,32,60,8,100,0.080000
2025-09-29,Korn Ferry,53,33,14,100,0.140000
2025-09-29,Kraft Heinz,27,57,16,100,0.160000
2025-09-29,Kroger,40,46,14,100,0.140000
2025-09-29,Kyndryl,29,65,6,100,0.060000
2025-09-29,L3Harris Technologies,37,55,8,100,0.080000
2025-09-29,LCI Industries,32,58,10,100,0.100000
2025-09-29,LKQ,22,60,18,100,0.180000
2025-09-29,LPL Financial,63,34,3,100,0.030000
2025-09-29,Labcorp Holdings,44,50,6,100,0.060000
2025-09-29,Lam Research,39,52,9,100,0.090000
2025-09-29,Lamb Weston,24,64,12,100,0.120000
2025-09-29,Land O'Lakes,33,58,9,100,0.090000
2025-09-29,Landstar System,17,50,33,100,0.330000
2025-09-29,Las Vegas Sands,32,58,10,100,0.100000
2025-09-29,Lear Corporation,36,52,12,100,0.120000
2025-09-29,Leggett & Platt,17,71,12,100,0.120000
2025-09-29,Leidos,39,53,8,100,0.080000
2025-09-29,Lennar,14,67,19,100,0.190000
2025-09-29,Lennox International,34,55,11,100,0.110000
2025-09-29,Levi Strauss,25,71,4,100,0.040000
2025-09-29,Liberty Energy,88,9,3,100,0.030000
2025-09-29,Liberty Media,95,4,1,100,0.010000
2025-09-29,Liberty Mutual Insurance,80,9,11,100,0.110000
2025-09-29,Light & Wonder,24,61,15,100,0.150000
2025-09-29,Lincoln Electric,45,49,6,100,0.060000
2025-09-29,Lincoln National,29,54,17,100,0.170000
2025-09-29,Lithia Motors,33,63,4,100,0.040000
2025-09-29,Live Nation Entertainment,47,29,24,100,0.240000
2025-09-29,Lockheed Martin,40,51,9,100,0.090000
2025-09-29,Loews,35,58,7,100,0.070000
2025-09-29,Louisiana-Pacific Corporation,34,52,14,100,0.140000
2025-09-29,Lowe's,50,34,16,100,0.160000
2025-09-29,Lululemon athletica,20,52,28,100,0.280000
2025-09-29,Lumen Technologies,25,63,12,100,0.120000
2025-09-29,Lyft,14,55,31,100,0.310000
2025-09-29,M&T Bank,30,56,14,100,0.140000
2025-09-29,M/I Homes,29,63,8,100,0.080000
2025-09-29,MDU Resources Group,37,57,6,100,0.060000
2025-09-29,MGM Resorts International,30,59,11,100,0.110000
2025-09-29,MKS Instruments,39,51,10,100,0.100000
2025-09-29,MRC Global,35,62,3,100,0.030000
2025-09-29,MSC Industrial Direct,24,64,12,100,0.120000
2025-09-29,MSCI,21,69,10,100,0.100000
2025-09-29,MYR Group,34,52,14,100,0.140000
2025-09-29,Macys,25,67,8,100,0.080000
2025-09-29,ManpowerGroup,25,54,21,100,0.210000
2025-09-29,Marathon Oil,26,58,16,100,0.160000
2025-09-29,Marathon Petroleum,42,51,7,100,0.070000
2025-09-29,Markel Group,44,45,11,100,0.110000
2025-09-29,Marriott International,36,56,8,100,0.080000
2025-09-29,Marriott Vacations Worldwide,35,53,12,100,0.120000
2025-09-29,Marsh & McLennan,52,37,11,100,0.110000
2025-09-29,Martin Marietta Materials,31,50,19,100,0.190000
2025-09-29,Marvell Technology,47,47,6,100,0.060000
2025-09-29,MasTec,36,61,3,100,0.030000
2025-09-29,Masco,32,59,9,100,0.090000
2025-09-29,Mass Mutual,21,48,6,75,0.080000
2025-09-29,MasterBrand,32,62,6,100,0.060000
2025-09-29,Mastercard,42,49,9,100,0.090000
2025-09-29,Matador Resources,33,58,9,100,0.090000
2025-09-29,Match Group,18,44,38,100,0.380000
2025-09-29,Mativ,25,66,9,100,0.090000
2025-09-29,Matson Inc,32,53,15,100,0.150000
2025-09-29,Mattel,32,51,17,100,0.170000
2025-09-29,Maximus,26,68,6,100,0.060000
2025-09-29,McCormick & Company,37,48,15,100,0.150000
2025-09-29,McDonalds,25,54,23,102,0.225490
2025-09-29,McKesson,46,48,6,100,0.060000
2025-09-29,Medical Mutual of Ohio,24,61,15,100,0.150000
2025-09-29,Merck,39,47,14,100,0.140000
2025-09-29,Mercury General,21,58,21,100,0.210000
2025-09-29,Meritage Homes,24,60,16,100,0.160000
2025-09-29,MetLife,23,49,28,100,0.280000
2025-09-29,Meta Platforms,39,52,11,102,0.107843
2025-09-29,Mettler-Toledo International,36,60,4,100,0.040000
2025-09-29,Microchip Technology,36,56,8,100,0.080000
2025-09-29,Micron Technology,32,57,13,102,0.127451
2025-09-29,Microsoft,26,45,27,98,0.275510
2025-09-29,Middleby,21,71,8,100,0.080000
2025-09-29,MillerKnoll,25,63,12,100,0.120000
2025-09-29,Moderna,35,43,22,100,0.220000
2025-09-29,ModivCare,28,50,22,100,0.220000
2025-09-29,Mohawk Industries,36,55,9,100,0.090000
2025-09-29,Molina Healthcare,30,50,20,100,0.200000
2025-09-29,Molson Coors Beverage,27,57,16,100,0.160000
2025-09-29,Mondelez,32,50,18,100,0.180000
2025-09-29,Monster Beverage,47,49,4,100,0.040000
2025-09-29,Moodys Corporation,4,11,2,17,0.117647
2025-09-29,Moog Inc,38,55,7,100,0.070000
2025-09-29,Morgan Stanley,31,57,13,101,0.128713
2025-09-29,Motorola Solutions,49,46,5,100,0.050000
2025-09-29,Mueller Industries,43,53,4,100,0.040000
2025-09-29,Murphy Oil,28,58,14,100,0.140000
2025-09-29,Murphy USA,31,58,11,100,0.110000
2025-09-29,Mutual of Omaha,44,50,6,100,0.060000
2025-09-29,NCR Atleos,37,59,4,100,0.040000
2025-09-29,NCR Voyix,28,62,10,100,0.100000
2025-09-29,NGL Energy Partners,85,7,8,100,0.080000
2025-09-29,NLV Financial,3,3,3,9,0.333333
2025-09-29,NOV,27,58,15,100,0.150000
2025-09-29,NRG Energy,82,10,8,100,0.080000
2025-09-29,NVR Inc,35,54,11,100,0.110000
2025-09-29,Nasdaq Inc,32,60,8,100,0.080000
2025-09-29,Nationwide Insurance,17,59,24,100,0.240000
2025-09-29,Navient,34,44,22,100,0.220000
2025-09-29,NetApp,37,58,5,100,0.050000
2025-09-29,Netflix,28,58,21,107,0.196262
2025-09-29,NeueHealth,56,40,4,100,0.040000
2025-09-29,New York Life Insurance,40,52,8,100,0.080000
2025-09-29,NewMarket Corporation,31,30,7,68,0.102941
2025-09-29,Newell Brands,29,56,15,100,0.150000
2025-09-29,Newmont,38,53,9,100,0.090000
2025-09-29,News Corp,19,62,19,100,0.190000
2025-09-29,Nexstar Media Group,12,67,13,92,0.141304
2025-09-29,NextEra Energy,82,15,3,100,0.030000
2025-09-29,NiSource,47,42,11,100,0.110000
2025-09-29,Nike,21,61,19,101,0.188119
2025-09-29,Nordson,37,59,4,100,0.040000
2025-09-29,Nordstrom,29,64,7,100,0.070000
2025-09-29,Norfolk Southern,39,54,7,100,0.070000
2025-09-29,Northern Trust,93,6,1,100,0.010000
2025-09-29,Northrop Grumman,29,61,10,100,0.100000
2025-09-29,Northwestern Mutual,32,50,18,100,0.180000
2025-09-29,Nucor,33,48,19,100,0.190000
2025-09-29,Nvidia,31,56,15,102,0.147059
2025-09-29,O'Reilly Automotive,57,37,6,100,0.060000
2025-09-29,O-I Glass,37,49,14,100,0.140000
2025-09-29,ODP Business Solutions,19,50,2,71,0.028169
2025-09-29,OGE Energy,87,8,5,100,0.050000
2025-09-29,ON Semiconductor,27,58,15,100,0.150000
2025-09-29,Occidental Petroleum,25,56,19,100,0.190000
2025-09-29,Old Dominion Freight Line,32,42,26,100,0.260000
2025-09-29,Old National Bancorp,32,66,2,100,0.020000
2025-09-29,Old Republic International,49,46,5,100,0.050000
2025-09-29,Olin,20,59,21,100,0.210000
2025-09-29,Omnicom Group,38,46,16,100,0.160000
2025-09-29,OneMain,46,52,2,100,0.020000
2025-09-29,Oneok,45,49,6,100,0.060000
2025-09-29,Opendoor Technologies,19,46,35,100,0.350000
2025-09-29,Option Care Health,94,6,0,100,0.000000
2025-09-29,Oracle,34,54,11,99,0.111111
2025-09-29,Organon,25,58,17,100,0.170000
2025-09-29,Oscar Health,25,60,15,100,0.150000
2025-09-29,Oshkosh Corporation,35,53,12,100,0.120000
2025-09-29,Otis Worldwide,38,45,17,100,0.170000
2025-09-29,Ovintiv,43,44,13,100,0.130000
2025-09-29,Owens & Minor,24,49,27,100,0.270000
2025-09-29,Owens Corning,19,79,2,100,0.020000
2025-09-29,PACS Group,23,48,29,100,0.290000
2025-09-29,PBF Energy,83,6,11,100,0.110000
2025-09-29,PC Connection Inc,43,28,3,74,0.040541
2025-09-29,PENN Entertainment,85,15,0,100,0.000000
2025-09-29,PG&E,44,38,18,100,0.180000
2025-09-29,PNC Financial Services,40,51,9,100,0.090000
2025-09-29,PPG Industries,31,58,11,100,0.110000
2025-09-29,PPL Corporation,43,50,7,100,0.070000
2025-09-29,PVH,25,44,31,100,0.310000
2025-09-29,Paccar,35,53,12,100,0.120000
2025-09-29,Pacific Life,39,53,8,100,0.080000
2025-09-29,Packaging Corp of America,14,68,18,100,0.180000
2025-09-29,Palo Alto Networks,36,49,15,100,0.150000
2025-09-29,Par Pacific,29,63,8,100,0.080000
2025-09-29,Paramount Global,27,56,17,100,0.170000
2025-09-29,Park Hotels & Resorts,27,60,13,100,0.130000
2025-09-29,Parker-Hannifin,54,44,2,100,0.020000
2025-09-29,Parsons Corporation,43,42,15,100,0.150000
2025-09-29,Patrick Industries,37,57,6,100,0.060000
2025-09-29,Patterson Companies Inc,11,54,3,68,0.044118
2025-09-29,Patterson-UTI Energy,56,27,17,100,0.170000
2025-09-29,PayPal,36,51,13,100,0.130000
2025-09-29,Paychex,31,53,16,100,0.160000
2025-09-29,Peabody Energy,69,24,7,100,0.070000
2025-09-29,Peloton Interactive,36,54,10,100,0.100000
2025-09-29,Penn Mutual Life Insurance,37,57,6,100,0.060000
2025-09-29,PennyMac Financial Services,32,62,6,100,0.060000
2025-09-29,Penske Automotive,32,65,3,100,0.030000
2025-09-29,PepsiCo,40,49,11,100,0.110000
2025-09-29,Performance Food,38,55,7,100,0.070000
2025-09-29,Permian Resources,41,53,6,100,0.060000
2025-09-29,Petco Health and Wellness,68,25,7,100,0.070000
2025-09-29,Peter Kiewit Sons',9,25,11,45,0.244444
2025-09-29,Pfizer,21,57,22,100,0.220000
2025-09-29,Philip Morris International,57,35,8,100,0.080000
2025-09-29,Phillips 66,40,49,11,100,0.110000
2025-09-29,Pinnacle West Capital,37,43,20,100,0.200000
2025-09-29,Pinterest,31,62,7,100,0.070000
2025-09-29,Pioneer Natural Resources,47,35,18,100,0.180000
2025-09-29,Pitney Bowes,34,61,5,100,0.050000
2025-09-29,Plains GP,38,44,18,100,0.180000
2025-09-29,Playtika Holding,29,50,21,100,0.210000
2025-09-29,Plexus Corp,38,55,7,100,0.070000
2025-09-29,Polaris Inc,43,51,6,100,0.060000
2025-09-29,Pool Corporation,29,57,14,100,0.140000
2025-09-29,Popular Inc,92,5,3,100,0.030000
2025-09-29,Portland General Electric,34,53,13,100,0.130000
2025-09-29,Post Holdings,22,69,9,100,0.090000
2025-09-29,PrIncipal Financial,37,56,7,100,0.070000
2025-09-29,PriceSmart,35,57,8,100,0.080000
2025-09-29,Primerica,37,57,6,100,0.060000
2025-09-29,Primoris Services,42,56,2,100,0.020000
2025-09-29,ProFrac Holding,31,52,17,100,0.170000
2025-09-29,Procter & Gamble,44,38,18,100,0.180000
2025-09-29,Progressive Insurance,32,56,12,100,0.120000
2025-09-29,Prologis,40,56,4,100,0.040000
2025-09-29,Prudential Financial,39,54,7,100,0.070000
2025-09-29,Public Service Enterprise Group,44,45,11,100,0.110000
2025-09-29,Public Storage,38,45,17,100,0.170000
2025-09-29,Publix Super Markets,40,53,7,100,0.070000
2025-09-29,Puget Sound Energy,55,28,17,100,0.170000
2025-09-29,PulteGroup,39,55,6,100,0.060000
2025-09-29,Pure Storage,40,54,6,100,0.060000
2025-09-29,QVC Group,24,63,13,100,0.130000
2025-09-29,QXO Building Products,0,8,2,10,0.200000
2025-09-29,Qorvo,47,42,11,100,0.110000
2025-09-29,Qualcomm,22,61,9,92,0.097826
2025-09-29,Quanta Services,42,53,5,100,0.050000
2025-09-29,Quest Diagnostics,28,62,10,100,0.100000
2025-09-29,QuidelOrtho,30,57,13,100,0.130000
2025-09-29,REV Group,44,46,10,100,0.100000
2025-09-29,RPM International,27,59,14,100,0.140000
2025-09-29,RTX,42,45,13,100,0.130000
2025-09-29,RXO Inc,28,54,18,100,0.180000
2025-09-29,Rackspace Technology,27,55,18,100,0.180000
2025-09-29,Radius Recycling,15,56,29,100,0.290000
2025-09-29,Ralph Lauren,20,65,7,92,0.076087
2025-09-29,Range Resources,46,47,7,100,0.070000
2025-09-29,Raymond James Financial,35,56,9,100,0.090000
2025-09-29,Realty Income,35,43,22,100,0.220000
2025-09-29,Regal Rexnord,32,60,8,100,0.080000
2025-09-29,Regeneron Pharmaceuticals,45,50,5,100,0.050000
2025-09-29,Regions Financial,45,48,7,100,0.070000
2025-09-29,Reinsurance Group of America,36,57,7,100,0.070000
2025-09-29,Reliance Inc,47,44,9,100,0.090000
2025-09-29,Republic Services,27,28,45,100,0.450000
2025-09-29,ResMed,25,70,5,100,0.050000
2025-09-29,Resideo Technologies,41,51,8,100,0.080000
2025-09-29,Restoration Hardware,25,58,17,100,0.170000
2025-09-29,Revvity,31,54,15,100,0.150000
2025-09-29,Rithm Capital,19,76,5,100,0.050000
2025-09-29,Rivian Automotive,30,56,14,100,0.140000
2025-09-29,Robert Half,35,46,19,100,0.190000
2025-09-29,Roblox,31,36,33,100,0.330000
2025-09-29,Rocket Companies,18,73,9,100,0.090000
2025-09-29,Rockwell Automation,38,58,4,100,0.040000
2025-09-29,Roku,48,45,7,100,0.070000
2025-09-29,Rollins Inc,26,69,5,100,0.050000
2025-09-29,Roper Technologies,36,56,8,100,0.080000
2025-09-29,Ross Stores,39,54,7,100,0.070000
2025-09-29,Rush Enterprises,36,53,11,100,0.110000
2025-09-29,Ryder System,46,50,4,100,0.040000
2025-09-29,Ryerson Holding,29,63,8,100,0.080000
2025-09-29,S&P Global,27,70,3,100,0.030000
2025-09-29,SBA Communications,38,49,13,100,0.130000
2025-09-29,SS&C Technologies,41,55,4,100,0.040000
2025-09-29,Sabre Corporation,26,61,13,100,0.130000
2025-09-29,Saia Inc,43,49,8,100,0.080000
2025-09-29,Salesforce,15,46,39,100,0.390000
2025-09-29,Sallie Mae,31,58,11,100,0.110000
2025-09-29,Sally Beauty,93,6,1,100,0.010000
2025-09-29,Sanmina,24,73,3,100,0.030000
2025-09-29,ScanSource,38,53,9,100,0.090000
2025-09-29,Schneider National,33,51,16,100,0.160000
2025-09-29,Science Applications International,30,52,18,100,0.180000
2025-09-29,Scotts Miracle-Gro,42,37,21,100,0.210000
2025-09-29,Seaboard,27,51,22,100,0.220000
2025-09-29,Sealed Air Corporation,28,64,8,100,0.080000
2025-09-29,Securian Financial,25,67,8,100,0.080000
2025-09-29,Select Medical Holdings,29,57,14,100,0.140000
2025-09-29,Selective Insurance Group,26,42,32,100,0.320000
2025-09-29,Sempra,36,59,5,100,0.050000
2025-09-29,Sentry Insurance Group,3,6,0,9,0.000000
2025-09-29,Service Corp International,6,12,6,24,0.250000
2025-09-29,ServiceNow,36,53,11,100,0.110000
2025-09-29,Sherwin-Williams,24,58,18,100,0.180000
2025-09-29,Shift4 Payments,26,59,15,100,0.150000
2025-09-29,Silgan,17,52,31,100,0.310000
2025-09-29,Simon Property Group,45,47,8,100,0.080000
2025-09-29,Sinclair,9,63,28,100,0.280000
2025-09-29,Sirius XM,23,70,7,100,0.070000
2025-09-29,SiteOne Landscape Supply,26,62,12,100,0.120000
2025-09-29,Skechers USA,22,69,9,100,0.090000
2025-09-29,SkyWest,15,53,32,100,0.320000
2025-09-29,Skyline Champion,42,11,1,54,0.018519
2025-09-29,Skyworks Solutions,36,55,9,100,0.090000
2025-09-29,Smurfit Westrock,19,67,14,100,0.140000
2025-09-29,Snap Inc,30,45,25,100,0.250000
2025-09-29,Snap-on,17,64,19,100,0.190000
2025-09-29,Snowflake Inc,49,51,0,100,0.000000
2025-09-29,Solventum,32,64,4,100,0.040000
2025-09-29,Sonic Automotive,15,77,8,100,0.080000
2025-09-29,Sonoco Products,22,66,12,100,0.120000
2025-09-29,Southern Company,54,39,7,100,0.070000
2025-09-29,Southwest Airlines,22,51,27,100,0.270000
2025-09-29,Southwest Gas Holdings,39,53,8,100,0.080000
2025-09-29,SpartanNash,23,74,3,100,0.030000
2025-09-29,Spectrum Brands,21,56,23,100,0.230000
2025-09-29,Spire Inc,52,39,9,100,0.090000
2025-09-29,Spirit AeroSystems,40,39,21,100,0.210000
2025-09-29,Spirit Airlines,13,54,25,92,0.271739
2025-09-29,Splunk,37,48,15,100,0.150000
2025-09-29,Sprouts Farmers Market,29,67,4,100,0.040000
2025-09-29,Stagwell,31,57,12,100,0.120000
2025-09-29,Stanley Black & Decker,27,58,15,100,0.150000
2025-09-29,Starbucks,11,74,15,100,0.150000
2025-09-29,State Farm Insurance,17,58,25,100,0.250000
2025-09-29,State Street,26,57,17,100,0.170000
2025-09-29,Steel Dynamics,88,10,2,100,0.020000
2025-09-29,Steelcase,27,70,3,100,0.030000
2025-09-29,Stericycle,10,33,57,100,0.570000
2025-09-29,Stifel Financial,33,61,6,100,0.060000
2025-09-29,StoneX Group,34,62,4,100,0.040000
2025-09-29,Stryker,26,60,14,100,0.140000
2025-09-29,Summit Materials,20,69,11,100,0.110000
2025-09-29,Sun Communities,41,43,16,100,0.160000
2025-09-29,Super Micro Computer,91,7,2,100,0.020000
2025-09-29,Surgery Partners,31,56,13,100,0.130000
2025-09-29,Sylvamo,22,57,21,100,0.210000
2025-09-29,Synchrony Financial,52,44,4,100,0.040000
2025-09-29,Synopsys,22,58,20,100,0.200000
2025-09-29,Synovus Financial,39,55,6,100,0.060000
2025-09-29,Sysco,45,47,8,100,0.080000
2025-09-29,T Rowe Price,44,51,5,100,0.050000
2025-09-29,TD Synnex,38,57,5,100,0.050000
2025-09-29,TEGNA,21,66,13,100,0.130000
2025-09-29,THOR Industries,28,62,10,100,0.100000
2025-09-29,TIAA,25,61,14,100,0.140000
2025-09-29,TJX,52,43,5,100,0.050000
2025-09-29,Take-Two Interactive Software,39,57,4,100,0.040000
2025-09-29,Talen Energy,89,10,1,100,0.010000
2025-09-29,Tapestry,34,54,12,100,0.120000
2025-09-29,Targa Resources,52,39,9,100,0.090000
2025-09-29,Target Corporation,50,42,8,100,0.080000
2025-09-29,Taylor Morrison Home,32,60,8,100,0.080000
2025-09-29,Teladoc Health,36,54,10,100,0.100000
2025-09-29,Teledyne Technologies,33,64,3,100,0.030000
2025-09-29,Teleflex,22,68,10,100,0.100000
2025-09-29,Telephone & Data Systems,4,17,3,24,0.125000
2025-09-29,TelevisaUnivision,29,54,17,100,0.170000
2025-09-29,Tempur Sealy International,30,54,16,100,0.160000
2025-09-29,Tenet Healthcare,34,53,13,100,0.130000
2025-09-29,Teradyne,43,52,5,100,0.050000
2025-09-29,Terex,21,72,7,100,0.070000
2025-09-29,Tesla,25,53,26,104,0.250000
2025-09-29,Tetra Tech,46,43,11,100,0.110000
2025-09-29,Texas Instruments,24,57,19,100,0.190000
2025-09-29,Texas Roadhouse,35,55,10,100,0.100000
2025-09-29,Textron,34,55,11,100,0.110000
2025-09-29,The Andersons Inc,26,70,4,100,0.040000
2025-09-29,The Coca-Cola Company,32,59,9,100,0.090000
2025-09-29,The Greenbrier Companies,23,67,10,100,0.100000
2025-09-29,The Hartford,21,39,40,100,0.400000
2025-09-29,The Mosaic Company,36,49,15,100,0.150000
2025-09-29,Thermo Fisher Scientific,46,50,4,100,0.040000
2025-09-29,Thrivent Financial for Lutherans,29,55,9,93,0.096774
2025-09-29,Timken,26,61,13,100,0.130000
2025-09-29,Titan Machinery,20,66,14,100,0.140000
2025-09-29,Toast Inc,34,56,10,100,0.100000
2025-09-29,Toll Brothers,12,85,3,100,0.030000
2025-09-29,TopBuild,29,71,0,100,0.000000
2025-09-29,Topgolf Callaway Brands,24,54,22,100,0.220000
2025-09-29,Toro Company,27,62,11,100,0.110000
2025-09-29,Tractor Supply,25,66,9,100,0.090000
2025-09-29,TransDigm,42,44,14,100,0.140000
2025-09-29,TransUnion,34,41,25,100,0.250000
2025-09-29,Travelers Insurance,38,37,25,100,0.250000
2025-09-29,TreeHouse Foods,20,48,32,100,0.320000
2025-09-29,Tri Pointe Homes,26,67,7,100,0.070000
2025-09-29,TriNet Group,31,60,9,100,0.090000
2025-09-29,Trimble Inc,36,55,9,100,0.090000
2025-09-29,Trinity Industries,24,54,22,100,0.220000
2025-09-29,TruStage,51,42,7,100,0.070000
2025-09-29,Truist Financial,45,44,11,100,0.110000
2025-09-29,Tutor Perini Corporation,60,35,5,100,0.050000
2025-09-29,Twilio,41,51,8,100,0.080000
2025-09-29,Tyson Foods,25,55,20,100,0.200000
2025-09-29,U-Haul,8,36,56,100,0.560000
2025-09-29,UFP Industries,28,59,13,100,0.130000
2025-09-29,UGI Utilities Inc,24,39,17,80,0.212500
2025-09-29,UL Solutions,44,48,8,100,0.080000
2025-09-29,UPS,29,48,23,100,0.230000
2025-09-29,US Bancorp,32,59,9,100,0.090000
2025-09-29,US Foods,53,45,2,100,0.020000
2025-09-29,USAA,30,49,21,100,0.210000
2025-09-29,Uber,20,56,24,100,0.240000
2025-09-29,Ulta Beauty,81,15,4,100,0.040000
2025-09-29,Under Armour,23,67,10,100,0.100000
2025-09-29,Union Pacific,40,49,11,100,0.110000
2025-09-29,United Airlines,79,15,8,102,0.078431
2025-09-29,United Natural Foods,81,13,6,100,0.060000
2025-09-29,United Rentals,94,5,1,100,0.010000
2025-09-29,United States Steel,53,39,8,100,0.080000
2025-09-29,UnitedHealth,41,44,15,100,0.150000
2025-09-29,Universal Corporation,35,58,7,100,0.070000
2025-09-29,Universal Health Services,31,57,12,100,0.120000
2025-09-29,Unum Group,44,45,11,100,0.110000
2025-09-29,Upbound Group,40,57,3,100,0.030000
2025-09-29,Urban Outfitters,38,54,8,100,0.080000
2025-09-29,V2X,46,46,8,100,0.080000
2025-09-29,VF Corporation,25,49,26,100,0.260000
2025-09-29,VICI Properties,42,53,5,100,0.050000
2025-09-29,Vail Resorts,27,47,26,100,0.260000
2025-09-29,Valero Energy,82,9,9,100,0.090000
2025-09-29,Valley National Bancorp,22,71,7,100,0.070000
2025-09-29,Valmont Industries,35,56,9,100,0.090000
2025-09-29,Valvoline Inc,34,60,6,100,0.060000
2025-09-29,Ventas Inc,46,54,0,100,0.000000
2025-09-29,Verisk Analytics,36,49,15,100,0.150000
2025-09-29,Verizon,50,39,11,100,0.110000
2025-09-29,Vertex Pharmaceuticals,44,39,17,100,0.170000
2025-09-29,Vertiv,49,46,5,100,0.050000
2025-09-29,Viasat,35,56,9,100,0.090000
2025-09-29,Viatris,29,51,20,100,0.200000
2025-09-29,Victorias Secret,25,50,25,100,0.250000
2025-09-29,Visa Inc,61,32,7,100,0.070000
2025-09-29,Vishay Intertechnology,28,57,15,100,0.150000
2025-09-29,Vista Outdoor,19,62,19,100,0.190000
2025-09-29,Visteon,43,50,7,100,0.070000
2025-09-29,Vistra,43,46,11,100,0.110000
2025-09-29,Vontier,40,57,3,100,0.030000
2025-09-29,Voya Financial,39,55,6,100,0.060000
2025-09-29,Vulcan Materials,29,52,19,100,0.190000
2025-09-29,WEC Energy,87,9,4,100,0.040000
2025-09-29,WESCO International,40,52,8,100,0.080000
2025-09-29,WEX,36,58,6,100,0.060000
2025-09-29,WR Berkley,39,51,10,100,0.100000
2025-09-29,WW Grainger,41,44,15,100,0.150000
2025-09-29,Wabash National,20,53,27,100,0.270000
2025-09-29,Walmart,27,57,15,99,0.151515
2025-09-29,Walt Disney,48,47,5,100,0.050000
2025-09-29,Warner Bros Discovery,18,68,14,100,0.140000
2025-09-29,Warner Music Group,26,60,14,100,0.140000
2025-09-29,Waters Corporation,44,47,9,100,0.090000
2025-09-29,Watsco,31,50,19,100,0.190000
2025-09-29,Wayfair,33,62,5,100,0.050000
2025-09-29,Webster Financial,36,52,12,100,0.120000
2025-09-29,Weis Markets,22,66,12,100,0.120000
2025-09-29,Wells Fargo,84,7,9,100,0.090000
2025-09-29,Welltower,59,41,0,100,0.000000
2025-09-29,Werner Enterprises,33,48,19,100,0.190000
2025-09-29,West Pharmaceutical Services,42,43,15,100,0.150000
2025-09-29,Western & Southern Financial,29,67,4,100,0.040000
2025-09-29,Western Alliance Bancorp,20,50,27,97,0.278351
2025-09-29,Western Digital,30,53,17,100,0.170000
2025-09-29,Western Midstream Partners,36,56,8,100,0.080000
2025-09-29,Western Union,26,62,12,100,0.120000
2025-09-29,Westinghouse Air Brake Technologies,28,56,16,100,0.160000
2025-09-29,Weyerhaeuser,29,61,10,100,0.100000
2025-09-29,Whirlpool,31,50,19,100,0.190000
2025-09-29,Williams Companies,48,45,7,100,0.070000
2025-09-29,Williams-Sonoma,25,67,8,100,0.080000
2025-09-29,Winnebago Industries,19,67,14,100,0.140000
2025-09-29,Wintrust Financial,35,64,1,100,0.010000
2025-09-29,Woodward Inc,31,67,2,100,0.020000
2025-09-29,Workday,30,58,12,100,0.120000
2025-09-29,World Kinect,32,57,11,100,0.110000
2025-09-29,Worthington Enterprises,32,63,5,100,0.050000
2025-09-29,Wynn Resorts,21,58,21,100,0.210000
2025-09-29,XPO,25,62,13,100,0.130000
2025-09-29,Xcel Energy,53,20,27,100,0.270000
2025-09-29,Xerox,21,63,16,100,0.160000
2025-09-29,Xylem Inc,47,46,7,100,0.070000
2025-09-29,Yum Brands,26,58,16,100,0.160000
2025-09-29,Yum China,37,47,16,100,0.160000
2025-09-29,Zebra Technologies,39,51,10,100,0.100000
2025-09-29,Zimmer Biomet,36,61,3,100,0.030000
2025-09-29,Zions Bancorp,37,44,19,100,0.190000
2025-09-29,Zoetis,46,46,8,100,0.080000
2025-09-29,Zoom Video Communications,32,54,14,100,0.140000
2025-09-29,eXp World,26,65,9,100,0.090000
2025-09-29,iHeartMedia,24,66,10,100,0.100000
